word,x1,x2,x3,x4,x5,score,uni_len
bares,1555,4103,2201,3252,3767,14878,5
cares,1512,4103,2201,3252,3767,14835,5
tares,1264,4103,2201,3252,3767,14587,5
mares,1225,4103,2201,3252,3767,14548,5
pares,1184,4103,2201,3252,3767,14507,5
dares,1128,4103,2201,3252,3767,14451,5
banes,1555,4103,1757,3252,3767,14434,5
canes,1512,4103,1757,3252,3767,14391,5
lares,1046,4103,2201,3252,3767,14369,5
bales,1555,4103,1603,3252,3767,14280,5
fares,847,4103,2201,3252,3767,14170,5
hares,844,4103,2201,3252,3767,14167,5
manes,1225,4103,1757,3252,3767,14104,5
panes,1184,4103,1757,3252,3767,14063,5
danes,1128,4103,1757,3252,3767,14007,5
tales,1264,4103,1603,3252,3767,13989,5
nares,647,4103,2201,3252,3767,13970,5
males,1225,4103,1603,3252,3767,13950,5
lanes,1046,4103,1757,3252,3767,13925,5
wares,596,4103,2201,3252,3767,13919,5
pales,1184,4103,1603,3252,3767,13909,5
dales,1128,4103,1603,3252,3767,13853,5
bores,1555,3069,2201,3252,3767,13844,5
cores,1512,3069,2201,3252,3767,13801,5
fanes,847,4103,1757,3252,3767,13726,5
bates,1555,4103,1048,3252,3767,13725,5
gales,965,4103,1603,3252,3767,13690,5
cates,1512,4103,1048,3252,3767,13682,5
rales,948,4103,1603,3252,3767,13673,5
kanes,789,4103,1757,3252,3767,13668,5
baris,1555,4103,2201,1963,3767,13589,5
hales,844,4103,1603,3252,3767,13569,5
tores,1264,3069,2201,3252,3767,13553,5
cames,1512,4103,885,3252,3767,13519,5
kales,789,4103,1603,3252,3767,13514,5
mores,1225,3069,2201,3252,3767,13514,5
wanes,596,4103,1757,3252,3767,13475,5
pores,1184,3069,2201,3252,3767,13473,5
cades,1512,4103,774,3252,3767,13408,5
bones,1555,3069,1757,3252,3767,13400,5
mates,1225,4103,1048,3252,3767,13395,5
cones,1512,3069,1757,3252,3767,13357,5
pates,1184,4103,1048,3252,3767,13354,5
lores,1046,3069,2201,3252,3767,13335,5
janes,446,4103,1757,3252,3767,13325,5
wales,596,4103,1603,3252,3767,13321,5
dates,1128,4103,1048,3252,3767,13298,5
vanes,404,4103,1757,3252,3767,13283,5
tames,1264,4103,885,3252,3767,13271,5
maris,1225,4103,2201,1963,3767,13259,5
gores,965,3069,2201,3252,3767,13254,5
cages,1512,4103,616,3252,3767,13250,5
boles,1555,3069,1603,3252,3767,13246,5
paris,1184,4103,2201,1963,3767,13218,5
coles,1512,3069,1603,3252,3767,13203,5
capes,1512,4103,560,3252,3767,13194,5
carey,1512,4103,2201,3252,2116,13184,5
tades,1264,4103,774,3252,3767,13160,5
aires,1698,2239,2201,3252,3767,13157,5
fores,847,3069,2201,3252,3767,13136,5
dames,1128,4103,885,3252,3767,13135,5
gates,965,4103,1048,3252,3767,13135,5
vales,404,4103,1603,3252,3767,13129,5
rates,948,4103,1048,3252,3767,13118,5
tones,1264,3069,1757,3252,3767,13109,5
canis,1512,4103,1757,1963,3767,13102,5
taces,1264,4103,701,3252,3767,13087,5
bakes,1555,4103,406,3252,3767,13083,5
laris,1046,4103,2201,1963,3767,13080,5
lames,1046,4103,885,3252,3767,13053,5
caves,1512,4103,417,3252,3767,13051,5
tabes,1264,4103,664,3252,3767,13050,5
maces,1225,4103,701,3252,3767,13048,5
cakes,1512,4103,406,3252,3767,13040,5
pones,1184,3069,1757,3252,3767,13029,5
barns,1555,4103,2201,1391,3767,13017,5
fates,847,4103,1048,3252,3767,13017,5
cayes,1512,4103,381,3252,3767,13015,5
hates,844,4103,1048,3252,3767,13014,5
mabes,1225,4103,664,3252,3767,13011,5
paces,1184,4103,701,3252,3767,13007,5
carns,1512,4103,2201,1391,3767,12974,5
games,965,4103,885,3252,3767,12972,5
cires,1512,2239,2201,3252,3767,12971,5
carts,1512,4103,2201,1385,3767,12968,5
mages,1225,4103,616,3252,3767,12963,5
toles,1264,3069,1603,3252,3767,12955,5
daces,1128,4103,701,3252,3767,12951,5
tapes,1264,4103,560,3252,3767,12946,5
lades,1046,4103,774,3252,3767,12942,5
pages,1184,4103,616,3252,3767,12922,5
moles,1225,3069,1603,3252,3767,12916,5
mapes,1225,4103,560,3252,3767,12907,5
cafes,1512,4103,271,3252,3767,12905,5
zales,176,4103,1603,3252,3767,12901,5
carls,1512,4103,2201,1295,3767,12878,5
poles,1184,3069,1603,3252,3767,12875,5
laces,1046,4103,701,3252,3767,12869,5
gades,965,4103,774,3252,3767,12861,5
fames,847,4103,885,3252,3767,12854,5
tanis,1264,4103,1757,1963,3767,12854,5
hames,844,4103,885,3252,3767,12851,5
aotes,1698,3069,1048,3252,3767,12834,5
doles,1128,3069,1603,3252,3767,12819,5
nates,647,4103,1048,3252,3767,12817,5
manis,1225,4103,1757,1963,3767,12815,5
boras,1555,3069,2201,2214,3767,12806,5
kames,789,4103,885,3252,3767,12796,5
takes,1264,4103,406,3252,3767,12792,5
races,948,4103,701,3252,3767,12771,5
makes,1225,4103,406,3252,3767,12753,5
gabes,965,4103,664,3252,3767,12751,5
fades,847,4103,774,3252,3767,12743,5
aures,1698,1824,2201,3252,3767,12742,5
caney,1512,4103,1757,3252,2116,12740,5
hades,844,4103,774,3252,3767,12740,5
mayes,1225,4103,381,3252,3767,12728,5
tarns,1264,4103,2201,1391,3767,12726,5
paves,1184,4103,417,3252,3767,12723,5
tires,1264,2239,2201,3252,3767,12723,5
oates,532,4103,1048,3252,3767,12702,5
talis,1264,4103,1603,1963,3767,12700,5
botes,1555,3069,1048,3252,3767,12691,5
hones,844,3069,1757,3252,3767,12689,5
rages,948,4103,616,3252,3767,12686,5
mires,1225,2239,2201,3252,3767,12684,5
marts,1225,4103,2201,1385,3767,12681,5
naris,647,4103,2201,1963,3767,12681,5
faces,847,4103,701,3252,3767,12670,5
goles,965,3069,1603,3252,3767,12656,5
names,647,4103,885,3252,3767,12654,5
cotes,1512,3069,1048,3252,3767,12648,5
gapes,965,4103,560,3252,3767,12647,5
parts,1184,4103,2201,1385,3767,12640,5
roles,948,3069,1603,3252,3767,12639,5
garey,965,4103,2201,3252,2116,12637,5
fabes,847,4103,664,3252,3767,12633,5
rapes,948,4103,560,3252,3767,12630,5
palis,1184,4103,1603,1963,3767,12620,5
taros,1264,4103,2201,1282,3767,12617,5
wames,596,4103,885,3252,3767,12603,5
dawes,1128,4103,349,3252,3767,12599,5
marls,1225,4103,2201,1295,3767,12591,5
caren,1512,4103,2201,3252,1522,12590,5
darns,1128,4103,2201,1391,3767,12590,5
laves,1046,4103,417,3252,3767,12585,5
darts,1128,4103,2201,1385,3767,12584,5
maros,1225,4103,2201,1282,3767,12578,5
lakes,1046,4103,406,3252,3767,12574,5
vates,404,4103,1048,3252,3767,12574,5
bines,1555,2239,1757,3252,3767,12570,5
dalis,1128,4103,1603,1963,3767,12564,5
mazes,1225,4103,217,3252,3767,12564,5
ceras,1512,2863,2201,2214,3767,12557,5
cures,1512,1824,2201,3252,3767,12556,5
taxes,1264,4103,170,3252,3767,12556,5
boris,1555,3069,2201,1963,3767,12555,5
ranis,948,4103,1757,1963,3767,12538,5
paros,1184,4103,2201,1282,3767,12537,5
holes,844,3069,1603,3252,3767,12535,5
cines,1512,2239,1757,3252,3767,12527,5
cants,1512,4103,1757,1385,3767,12524,5
lawes,1046,4103,349,3252,3767,12517,5
toras,1264,3069,2201,2214,3767,12515,5
yores,225,3069,2201,3252,3767,12514,5
saner,2206,4103,1757,3252,1190,12508,5
barie,1555,4103,2201,1963,2679,12501,5
solea,2206,3069,1603,3252,2362,12492,5
taney,1264,4103,1757,3252,2116,12492,5
wades,596,4103,774,3252,3767,12492,5
raves,948,4103,417,3252,3767,12487,5
comes,1512,3069,885,3252,3767,12485,5
bains,1555,4103,1668,1391,3767,12484,5
carus,1512,4103,2201,899,3767,12482,5
baits,1555,4103,1668,1385,3767,12478,5
moras,1225,3069,2201,2214,3767,12476,5
paxes,1184,4103,170,3252,3767,12476,5
rakes,948,4103,406,3252,3767,12476,5
dazes,1128,4103,217,3252,3767,12467,5
tajes,1264,4103,81,3252,3767,12467,5
carie,1512,4103,2201,1963,2679,12458,5
bards,1555,4103,2201,829,3767,12455,5
james,446,4103,885,3252,3767,12453,5
maney,1225,4103,1757,3252,2116,12453,5
salet,2206,4103,1603,3252,1284,12448,5
cains,1512,4103,1668,1391,3767,12441,5
batis,1555,4103,1048,1963,3767,12436,5
nabes,647,4103,664,3252,3767,12433,5
canos,1512,4103,1757,1282,3767,12421,5
bodes,1555,3069,774,3252,3767,12417,5
biles,1555,2239,1603,3252,3767,12416,5
cards,1512,4103,2201,829,3767,12412,5
corea,1512,3069,2201,3252,2362,12396,5
baret,1555,4103,2201,3252,1284,12395,5
yates,225,4103,1048,3252,3767,12395,5
catis,1512,4103,1048,1963,3767,12393,5
bails,1555,4103,1668,1295,3767,12388,5
lazes,1046,4103,217,3252,3767,12385,5
haves,844,4103,417,3252,3767,12383,5
fakes,847,4103,406,3252,3767,12375,5
codes,1512,3069,774,3252,3767,12374,5
hakes,844,4103,406,3252,3767,12372,5
motes,1225,3069,1048,3252,3767,12361,5
daney,1128,4103,1757,3252,2116,12356,5
caret,1512,4103,2201,3252,1284,12352,5
hayes,844,4103,381,3252,3767,12347,5
jades,446,4103,774,3252,3767,12342,5
wages,596,4103,616,3252,3767,12334,5
napes,647,4103,560,3252,3767,12329,5
teras,1264,2863,2201,2214,3767,12309,5
fires,847,2239,2201,3252,3767,12306,5
harns,844,4103,2201,1391,3767,12306,5
gazes,965,4103,217,3252,3767,12304,5
farts,847,4103,2201,1385,3767,12303,5
hires,844,2239,2201,3252,3767,12303,5
maren,1225,4103,2201,3252,1522,12303,5
moues,1225,3069,990,3252,3767,12303,5
harts,844,4103,2201,1385,3767,12300,5
kayes,789,4103,381,3252,3767,12292,5
jones,446,3069,1757,3252,3767,12291,5
razes,948,4103,217,3252,3767,12287,5
tines,1264,2239,1757,3252,3767,12279,5
laney,1046,4103,1757,3252,2116,12274,5
meras,1225,2863,2201,2214,3767,12270,5
mures,1225,1824,2201,3252,3767,12269,5
dotes,1128,3069,1048,3252,3767,12264,5
paren,1184,4103,2201,3252,1522,12262,5
paley,1184,4103,1603,3252,2116,12258,5
barks,1555,4103,2201,628,3767,12254,5
karns,789,4103,2201,1391,3767,12251,5
soren,2206,3069,2201,3252,1522,12250,5
karts,789,4103,2201,1385,3767,12245,5
mines,1225,2239,1757,3252,3767,12240,5
raxes,948,4103,170,3252,3767,12240,5
barms,1555,4103,2201,612,3767,12238,5
tomes,1264,3069,885,3252,3767,12237,5
saned,2206,4103,1757,3252,917,12235,5
camis,1512,4103,885,1963,3767,12230,5
kalis,789,4103,1603,1963,3767,12225,5
farls,847,4103,2201,1295,3767,12213,5
carks,1512,4103,2201,628,3767,12211,5
calrs,1512,4103,1603,1225,3767,12210,5
harls,844,4103,2201,1295,3767,12210,5
tarie,1264,4103,2201,1963,2679,12210,5
bolas,1555,3069,1603,2214,3767,12208,5
daren,1128,4103,2201,3252,1522,12206,5
daley,1128,4103,1603,3252,2116,12202,5
faros,847,4103,2201,1282,3767,12200,5
pines,1184,2239,1757,3252,3767,12199,5
pants,1184,4103,1757,1385,3767,12196,5
tains,1264,4103,1668,1391,3767,12193,5
fazes,847,4103,217,3252,3767,12186,5
naves,647,4103,417,3252,3767,12186,5
hazes,844,4103,217,3252,3767,12183,5
raney,948,4103,1757,3252,2116,12176,5
dures,1128,1824,2201,3252,3767,12172,5
marie,1225,4103,2201,1963,2679,12171,5
colas,1512,3069,1603,2214,3767,12165,5
copes,1512,3069,560,3252,3767,12160,5
pomes,1184,3069,885,3252,3767,12157,5
earns,693,4103,2201,1391,3767,12155,5
mains,1225,4103,1668,1391,3767,12154,5
parus,1184,4103,2201,899,3767,12154,5
rajes,948,4103,81,3252,3767,12151,5
corey,1512,3069,2201,3252,2116,12150,5
saied,2206,4103,1668,3252,917,12146,5
dines,1128,2239,1757,3252,3767,12143,5
karos,789,4103,2201,1282,3767,12142,5
faxes,847,4103,170,3252,3767,12139,5
joles,446,3069,1603,3252,3767,12137,5
waves,596,4103,417,3252,3767,12135,5
manos,1225,4103,1757,1282,3767,12134,5
doris,1128,3069,2201,1963,3767,12128,5
japes,446,4103,560,3252,3767,12128,5
tiles,1264,2239,1603,3252,3767,12125,5
wakes,596,4103,406,3252,3767,12124,5
cadis,1512,4103,774,1963,3767,12119,5
pains,1184,4103,1668,1391,3767,12113,5
bonis,1555,3069,1757,1963,3767,12111,5
carps,1512,4103,2201,526,3767,12109,5
morea,1225,3069,2201,3252,2362,12109,5
domes,1128,3069,885,3252,3767,12101,5
tails,1264,4103,1668,1295,3767,12097,5
horas,844,3069,2201,2214,3767,12095,5
voles,404,3069,1603,3252,3767,12095,5
savey,2206,4103,417,3252,2116,12094,5
panos,1184,4103,1757,1282,3767,12093,5
lures,1046,1824,2201,3252,3767,12090,5
bacis,1555,4103,701,1963,3767,12089,5
modes,1225,3069,774,3252,3767,12087,5
miles,1225,2239,1603,3252,3767,12086,5
pards,1184,4103,2201,829,3767,12084,5
rotes,948,3069,1048,3252,3767,12084,5
malts,1225,4103,1603,1385,3767,12083,5
banus,1555,4103,1757,899,3767,12081,5
braes,1555,1543,1959,3252,3767,12076,5
haney,844,4103,1757,3252,2116,12072,5
oaves,532,4103,417,3252,3767,12071,5
marcs,1225,4103,2201,770,3767,12066,5
lines,1046,2239,1757,3252,3767,12061,5
oakes,532,4103,406,3252,3767,12060,5
earls,693,4103,2201,1295,3767,12059,5
mails,1225,4103,1668,1295,3767,12058,5
warns,596,4103,2201,1391,3767,12058,5
wires,596,2239,2201,3252,3767,12055,5
warts,596,4103,2201,1385,3767,12052,5
hajes,844,4103,81,3252,3767,12047,5
loris,1046,3069,2201,1963,3767,12046,5
podes,1184,3069,774,3252,3767,12046,5
piles,1184,2239,1603,3252,3767,12045,5
saite,2206,4103,1668,1385,2679,12041,5
carel,1512,4103,2201,3252,971,12039,5
galey,965,4103,1603,3252,2116,12039,5
janis,446,4103,1757,1963,3767,12036,5
monas,1225,3069,1757,2214,3767,12032,5
bared,1555,4103,2201,3252,917,12028,5
roues,948,3069,990,3252,3767,12026,5
boyes,1555,3069,381,3252,3767,12024,5
zones,176,3069,1757,3252,3767,12021,5
meris,1225,2863,2201,1963,3767,12019,5
talos,1264,4103,1603,1282,3767,12019,5
coves,1512,3069,417,3252,3767,12017,5
pails,1184,4103,1668,1295,3767,12017,5
larus,1046,4103,2201,899,3767,12016,5
bands,1555,4103,1757,829,3767,12011,5
carbs,1512,4103,2201,423,3767,12006,5
cokes,1512,3069,406,3252,3767,12006,5
casey,1512,4103,1021,3252,2116,12004,5
satie,2206,4103,1048,1963,2679,11999,5
sarin,2206,4103,2201,1963,1522,11995,5
bowes,1555,3069,349,3252,3767,11992,5
calen,1512,4103,1603,3252,1522,11992,5
mairs,1225,4103,1668,1225,3767,11988,5
cared,1512,4103,2201,3252,917,11985,5
tamis,1264,4103,885,1963,3767,11982,5
peris,1184,2863,2201,1963,3767,11978,5
borts,1555,3069,2201,1385,3767,11977,5
jakes,446,4103,406,3252,3767,11974,5
samen,2206,4103,885,3252,1522,11968,5
rants,948,4103,1757,1385,3767,11960,5
bolis,1555,3069,1603,1963,3767,11957,5
bancs,1555,4103,1757,770,3767,11952,5
caius,1512,4103,1668,899,3767,11949,5
cowes,1512,3069,349,3252,3767,11949,5
pairs,1184,4103,1668,1225,3767,11947,5
lards,1046,4103,2201,829,3767,11946,5
corns,1512,3069,2201,1391,3767,11940,5
palos,1184,4103,1603,1282,3767,11939,5
donas,1128,3069,1757,2214,3767,11935,5
aries,1698,1543,1668,3252,3767,11928,5
latis,1046,4103,1048,1963,3767,11927,5
marks,1225,4103,2201,628,3767,11924,5
haley,844,4103,1603,3252,2116,11918,5
tolas,1264,3069,1603,2214,3767,11917,5
colis,1512,3069,1603,1963,3767,11914,5
topes,1264,3069,560,3252,3767,11912,5
lodes,1046,3069,774,3252,3767,11908,5
sarex,2206,4103,2201,3252,144,11906,5
benis,1555,2863,1757,1963,3767,11905,5
barfs,1555,4103,2201,278,3767,11904,5
torey,1264,3069,2201,3252,2116,11902,5
gains,965,4103,1668,1391,3767,11894,5
gaits,965,4103,1668,1385,3767,11888,5
waxes,596,4103,170,3252,3767,11888,5
carne,1512,4103,2201,1391,2679,11886,5
parks,1184,4103,2201,628,3767,11883,5
saire,2206,4103,1668,1225,2679,11881,5
carte,1512,4103,2201,1385,2679,11880,5
caids,1512,4103,1668,829,3767,11879,5
molas,1225,3069,1603,2214,3767,11878,5
rains,948,4103,1668,1391,3767,11877,5
mopes,1225,3069,560,3252,3767,11873,5
camey,1512,4103,885,3252,2116,11868,5
karen,789,4103,2201,3252,1522,11867,5
tunes,1264,1824,1757,3252,3767,11864,5
arles,1698,1543,1603,3252,3767,11863,5
morey,1225,3069,2201,3252,2116,11863,5
vires,404,2239,2201,3252,3767,11863,5
cenis,1512,2863,1757,1963,3767,11862,5
fines,847,2239,1757,3252,3767,11862,5
bites,1555,2239,1048,3252,3767,11861,5
tarps,1264,4103,2201,526,3767,11861,5
calie,1512,4103,1603,1963,2679,11860,5
hines,844,2239,1757,3252,3767,11859,5
balds,1555,4103,1603,829,3767,11857,5
hants,844,4103,1757,1385,3767,11856,5
ualis,420,4103,1603,1963,3767,11856,5
taels,1264,4103,1421,1295,3767,11850,5
doges,1128,3069,616,3252,3767,11832,5
darks,1128,4103,2201,628,3767,11827,5
giles,965,2239,1603,3252,3767,11826,5
waney,596,4103,1757,3252,2116,11824,5
fomes,847,3069,885,3252,3767,11820,5
cites,1512,2239,1048,3252,3767,11818,5
cozes,1512,3069,217,3252,3767,11817,5
homes,844,3069,885,3252,3767,11817,5
caner,1512,4103,1757,3252,1190,11814,5
boxes,1555,3069,170,3252,3767,11813,5
jarls,446,4103,2201,1295,3767,11812,5
banks,1555,4103,1757,628,3767,11810,5
lairs,1046,4103,1668,1225,3767,11809,5
riles,948,2239,1603,3252,3767,11809,5
saone,2206,4103,1426,1391,2679,11805,5
kines,789,2239,1757,3252,3767,11804,5
sarge,2206,4103,2201,612,2679,11801,5
lobes,1046,3069,664,3252,3767,11798,5
bangs,1555,4103,1757,612,3767,11794,5
padis,1184,4103,774,1963,3767,11791,5
carle,1512,4103,2201,1295,2679,11790,5
bries,1555,1543,1668,3252,3767,11785,5
notes,647,3069,1048,3252,3767,11783,5
rails,948,4103,1668,1295,3767,11781,5
berns,1555,2863,2201,1391,3767,11777,5
dopes,1128,3069,560,3252,3767,11776,5
fains,847,4103,1668,1391,3767,11776,5
coxes,1512,3069,170,3252,3767,11770,5
faits,847,4103,1668,1385,3767,11770,5
dorey,1128,3069,2201,3252,2116,11766,5
tabis,1264,4103,664,1963,3767,11761,5
tokes,1264,3069,406,3252,3767,11758,5
fanos,847,4103,1757,1282,3767,11756,5
belis,1555,2863,1603,1963,3767,11751,5
manus,1225,4103,1757,899,3767,11751,5
loges,1046,3069,616,3252,3767,11750,5
boney,1555,3069,1757,3252,2116,11749,5
fards,847,4103,2201,829,3767,11747,5
larks,1046,4103,2201,628,3767,11745,5
hards,844,4103,2201,829,3767,11744,5
matey,1225,4103,1048,3252,2116,11744,5
cries,1512,1543,1668,3252,3767,11742,5
sauer,2206,4103,990,3252,1190,11741,5
tared,1264,4103,2201,3252,917,11737,5
boats,1555,3069,1959,1385,3767,11735,5
karie,789,4103,2201,1963,2679,11735,5
aides,1698,2239,774,3252,3767,11730,5
moves,1225,3069,417,3252,3767,11730,5
dunes,1128,1824,1757,3252,3767,11728,5
manie,1225,4103,1757,1963,2679,11727,5
sadie,2206,4103,774,1963,2679,11725,5
mokes,1225,3069,406,3252,3767,11719,5
kains,789,4103,1668,1391,3767,11718,5
parel,1184,4103,2201,3252,971,11711,5
panus,1184,4103,1757,899,3767,11710,5
tules,1264,1824,1603,3252,3767,11710,5
files,847,2239,1603,3252,3767,11708,5
coney,1512,3069,1757,3252,2116,11706,5
baler,1555,4103,1603,3252,1190,11703,5
halts,844,4103,1603,1385,3767,11702,5
robes,948,3069,664,3252,3767,11700,5
sorel,2206,3069,2201,3252,971,11699,5
lopes,1046,3069,560,3252,3767,11694,5
coats,1512,3069,1959,1385,3767,11692,5
yarns,225,4103,2201,1391,3767,11687,5
donis,1128,3069,1757,1963,3767,11684,5
claes,1512,1193,1959,3252,3767,11683,5
goias,965,3069,1668,2214,3767,11683,5
mands,1225,4103,1757,829,3767,11681,5
fails,847,4103,1668,1295,3767,11680,5
pokes,1184,3069,406,3252,3767,11678,5
hails,844,4103,1668,1295,3767,11677,5
janey,446,4103,1757,3252,2116,11674,5
korea,789,3069,2201,3252,2362,11673,5
melas,1225,2863,1603,2214,3767,11672,5
mules,1225,1824,1603,3252,3767,11671,5
waley,596,4103,1603,3252,2116,11670,5
cauls,1512,4103,990,1295,3767,11667,5
maius,1225,4103,1668,899,3767,11662,5
pared,1184,4103,2201,3252,917,11657,5
tapis,1264,4103,560,1963,3767,11657,5
balks,1555,4103,1603,628,3767,11656,5
poeas,1184,3069,1421,2214,3767,11655,5
botas,1555,3069,1048,2214,3767,11653,5
morns,1225,3069,2201,1391,3767,11653,5
gaons,965,4103,1426,1391,3767,11652,5
solen,2206,3069,1603,3252,1522,11652,5
morts,1225,3069,2201,1385,3767,11647,5
lunes,1046,1824,1757,3252,3767,11646,5
balms,1555,4103,1603,612,3767,11640,5
tarne,1264,4103,2201,1391,2679,11638,5
samer,2206,4103,885,3252,1190,11636,5
talus,1264,4103,1603,899,3767,11636,5
doves,1128,3069,417,3252,3767,11633,5
danie,1128,4103,1757,1963,2679,11630,5
pules,1184,1824,1603,3252,3767,11630,5
ceros,1512,2863,2201,1282,3767,11625,5
darbs,1128,4103,2201,423,3767,11622,5
kails,789,4103,1668,1295,3767,11622,5
manet,1225,4103,1757,3252,1284,11621,5
nomes,647,3069,885,3252,3767,11620,5
calks,1512,4103,1603,628,3767,11613,5
porns,1184,3069,2201,1391,3767,11612,5
talie,1264,4103,1603,1963,2679,11612,5
wines,596,2239,1757,3252,3767,11611,5
fairs,847,4103,1668,1225,3767,11610,5
dalen,1128,4103,1603,3252,1522,11608,5
wants,596,4103,1757,1385,3767,11608,5
hairs,844,4103,1668,1225,3767,11607,5
ports,1184,3069,2201,1385,3767,11606,5
gorey,965,3069,2201,3252,2116,11603,5
coals,1512,3069,1959,1295,3767,11602,5
cagey,1512,4103,616,3252,2116,11599,5
halos,844,4103,1603,1282,3767,11599,5
marne,1225,4103,2201,1391,2679,11599,5
calms,1512,4103,1603,612,3767,11597,5
malus,1225,4103,1603,899,3767,11597,5
ropes,948,3069,560,3252,3767,11596,5
boley,1555,3069,1603,3252,2116,11595,5
canel,1512,4103,1757,3252,971,11595,5
marte,1225,4103,2201,1385,2679,11593,5
maids,1225,4103,1668,829,3767,11592,5
bides,1555,2239,774,3252,3767,11587,5
polis,1184,3069,1603,1963,3767,11586,5
baned,1555,4103,1757,3252,917,11584,5
lacis,1046,4103,701,1963,3767,11580,5
boars,1555,3069,1959,1225,3767,11575,5
menis,1225,2863,1757,1963,3767,11575,5
sande,2206,4103,1757,829,2679,11574,5
malie,1225,4103,1603,1963,2679,11573,5
gadis,965,4103,774,1963,3767,11572,5
salem,2206,4103,1603,3252,406,11570,5
sonet,2206,3069,1757,3252,1284,11568,5
marys,1225,4103,2201,271,3767,11567,5
santy,2206,4103,1757,1385,2116,11567,5
buras,1555,1824,2201,2214,3767,11561,5
gaols,965,4103,1426,1295,3767,11556,5
palus,1184,4103,1603,899,3767,11556,5
coley,1512,3069,1603,3252,2116,11552,5
parte,1184,4103,2201,1385,2679,11552,5
gaels,965,4103,1421,1295,3767,11551,5
loves,1046,3069,417,3252,3767,11551,5
dorts,1128,3069,2201,1385,3767,11550,5
baiel,1555,4103,1668,3252,971,11549,5
lanie,1046,4103,1757,1963,2679,11548,5
runes,948,1824,1757,3252,3767,11548,5
nards,647,4103,2201,829,3767,11547,5
harks,844,4103,2201,628,3767,11543,5
labis,1046,4103,664,1963,3767,11543,5
caned,1512,4103,1757,3252,917,11541,5
votes,404,3069,1048,3252,3767,11540,5
beans,1555,2863,1959,1391,3767,11535,5
penis,1184,2863,1757,1963,3767,11534,5
mites,1225,2239,1048,3252,3767,11531,5
farms,847,4103,2201,612,3767,11530,5
mozes,1225,3069,217,3252,3767,11530,5
beats,1555,2863,1959,1385,3767,11529,5
harms,844,4103,2201,612,3767,11527,5
sated,2206,4103,1048,3252,917,11526,5
wains,596,4103,1668,1391,3767,11525,5
haets,844,4103,1421,1385,3767,11520,5
tanks,1264,4103,1757,628,3767,11519,5
waits,596,4103,1668,1385,3767,11519,5
bices,1555,2239,701,3252,3767,11514,5
tavis,1264,4103,417,1963,3767,11514,5
nodes,647,3069,774,3252,3767,11509,5
niles,647,2239,1603,3252,3767,11508,5
kamis,789,4103,885,1963,3767,11507,5
talcs,1264,4103,1603,770,3767,11507,5
tangs,1264,4103,1757,612,3767,11503,5
lands,1046,4103,1757,829,3767,11502,5
wards,596,4103,2201,829,3767,11496,5
tries,1264,1543,1668,3252,3767,11494,5
hopes,844,3069,560,3252,3767,11492,5
salue,2206,4103,1603,899,2679,11490,5
narcs,647,4103,2201,770,3767,11488,5
terns,1264,2863,2201,1391,3767,11486,5
barse,1555,4103,2201,945,2679,11483,5
laius,1046,4103,1668,899,3767,11483,5
lowes,1046,3069,349,3252,3767,11483,5
baten,1555,4103,1048,3252,1522,11480,5
manks,1225,4103,1757,628,3767,11480,5
nails,647,4103,1668,1295,3767,11480,5
denis,1128,2863,1757,1963,3767,11478,5
kaons,789,4103,1426,1391,3767,11476,5
mavis,1225,4103,417,1963,3767,11475,5
mauts,1225,4103,990,1385,3767,11470,5
zaxes,176,4103,170,3252,3767,11468,5
liras,1046,2239,2201,2214,3767,11467,5
malet,1225,4103,1603,3252,1284,11467,5
parle,1184,4103,2201,1295,2679,11462,5
garbs,965,4103,2201,423,3767,11459,5
toney,1264,3069,1757,3252,2116,11458,5
wiles,596,2239,1603,3252,3767,11457,5
auris,1698,1824,2201,1963,3767,11453,5
roves,948,3069,417,3252,3767,11453,5
ranie,948,4103,1757,1963,2679,11450,5
salep,2206,4103,1603,3252,285,11449,5
betas,1555,2863,1048,2214,3767,11447,5
comas,1512,3069,885,2214,3767,11447,5
butes,1555,1824,1048,3252,3767,11446,5
joris,446,3069,2201,1963,3767,11446,5
galen,965,4103,1603,3252,1522,11445,5
lancs,1046,4103,1757,770,3767,11443,5
kolas,789,3069,1603,2214,3767,11442,5
poxes,1184,3069,170,3252,3767,11442,5
harps,844,4103,2201,526,3767,11441,5
carse,1512,4103,2201,945,2679,11440,5
beals,1555,2863,1959,1295,3767,11439,5
lapis,1046,4103,560,1963,3767,11439,5
cados,1512,4103,774,1282,3767,11438,5
maier,1225,4103,1668,3252,1190,11438,5
dites,1128,2239,1048,3252,3767,11434,5
pavis,1184,4103,417,1963,3767,11434,5
dozes,1128,3069,217,3252,3767,11433,5
baled,1555,4103,1603,3252,917,11430,5
wails,596,4103,1668,1295,3767,11429,5
korey,789,3069,2201,3252,2116,11427,5
palet,1184,4103,1603,3252,1284,11426,5
saice,2206,4103,1668,770,2679,11426,5
corie,1512,3069,2201,1963,2679,11424,5
balei,1555,4103,1603,3252,910,11423,5
pangs,1184,4103,1757,612,3767,11423,5
melis,1225,2863,1603,1963,3767,11421,5
siren,2206,2239,2201,3252,1522,11420,5
money,1225,3069,1757,3252,2116,11419,5
vines,404,2239,1757,3252,3767,11419,5
samel,2206,4103,885,3252,971,11417,5
saber,2206,4103,664,3252,1190,11415,5
pries,1184,1543,1668,3252,3767,11414,5
oatis,532,4103,1048,1963,3767,11413,5
salty,2206,4103,1603,1385,2116,11413,5
taler,1264,4103,1603,3252,1190,11412,5
gules,965,1824,1603,3252,3767,11411,5
moans,1225,3069,1959,1391,3767,11411,5
coins,1512,3069,1668,1391,3767,11407,5
times,1264,2239,885,3252,3767,11407,5
moats,1225,3069,1959,1385,3767,11405,5
rands,948,4103,1757,829,3767,11404,5
cutes,1512,1824,1048,3252,3767,11403,5
gaius,965,4103,1668,899,3767,11402,5
cavey,1512,4103,417,3252,2116,11400,5
macey,1225,4103,701,3252,2116,11397,5
ragis,948,4103,616,1963,3767,11397,5
kadis,789,4103,774,1963,3767,11396,5
lenis,1046,2863,1757,1963,3767,11396,5
rules,948,1824,1603,3252,3767,11394,5
sarid,2206,4103,2201,1963,917,11390,5
cakey,1512,4103,406,3252,2116,11389,5
morae,1225,3069,2201,2214,2679,11388,5
saily,2206,4103,1668,1295,2116,11388,5
mauls,1225,4103,990,1295,3767,11380,5
bolts,1555,3069,1603,1385,3767,11379,5
cords,1512,3069,2201,829,3767,11378,5
davis,1128,4103,417,1963,3767,11378,5
poney,1184,3069,1757,3252,2116,11378,5
ayres,1698,458,2201,3252,3767,11376,5
varus,404,4103,2201,899,3767,11374,5
dauts,1128,4103,990,1385,3767,11373,5
hanus,844,4103,1757,899,3767,11370,5
bears,1555,2863,1959,1225,3767,11369,5
barde,1555,4103,2201,829,2679,11367,5
dangs,1128,4103,1757,612,3767,11367,5
sager,2206,4103,616,3252,1190,11367,5
barny,1555,4103,2201,1391,2116,11366,5
talks,1264,4103,1603,628,3767,11365,5
saute,2206,4103,990,1385,2679,11363,5
barty,1555,4103,2201,1385,2116,11360,5
wairs,596,4103,1668,1225,3767,11359,5
dries,1128,1543,1668,3252,3767,11358,5
sonia,2206,3069,1757,1963,2362,11357,5
janos,446,4103,1757,1282,3767,11355,5
boils,1555,3069,1668,1295,3767,11354,5
laics,1046,4103,1668,770,3767,11354,5
safen,2206,4103,271,3252,1522,11354,5
caine,1512,4103,1668,1391,2679,11353,5
lites,1046,2239,1048,3252,3767,11352,5
merls,1225,2863,2201,1295,3767,11351,5
paiks,1184,4103,1668,628,3767,11350,5
caite,1512,4103,1668,1385,2679,11347,5
narks,647,4103,2201,628,3767,11346,5
hokes,844,3069,406,3252,3767,11338,5
meros,1225,2863,2201,1282,3767,11338,5
aloes,1698,1193,1426,3252,3767,11336,5
codas,1512,3069,774,2214,3767,11336,5
colts,1512,3069,1603,1385,3767,11336,5
canoe,1512,4103,1757,1282,2679,11333,5
paler,1184,4103,1603,3252,1190,11332,5
datos,1128,4103,1048,1282,3767,11328,5
bents,1555,2863,1757,1385,3767,11327,5
delis,1128,2863,1603,1963,3767,11324,5
carny,1512,4103,2201,1391,2116,11323,5
motas,1225,3069,1048,2214,3767,11323,5
doney,1128,3069,1757,3252,2116,11322,5
basie,1555,4103,1021,1963,2679,11321,5
gamey,965,4103,885,3252,2116,11321,5
fared,847,4103,2201,3252,917,11320,5
soler,2206,3069,1603,3252,1190,11320,5
sairy,2206,4103,1668,1225,2116,11318,5
carty,1512,4103,2201,1385,2116,11317,5
hared,844,4103,2201,3252,917,11317,5
karel,789,4103,2201,3252,971,11316,5
raids,948,4103,1668,829,3767,11315,5
saron,2206,4103,2201,1282,1522,11314,5
sanit,2206,4103,1757,1963,1284,11313,5
coils,1512,3069,1668,1295,3767,11311,5
barce,1555,4103,2201,770,2679,11308,5
doats,1128,3069,1959,1385,3767,11308,5
katey,789,4103,1048,3252,2116,11308,5
catie,1512,4103,1048,1963,2679,11305,5
loxes,1046,3069,170,3252,3767,11304,5
ramey,948,4103,885,3252,2116,11304,5
soane,2206,3069,1959,1391,2679,11304,5
carin,1512,4103,2201,1963,1522,11301,5
baile,1555,4103,1668,1295,2679,11300,5
dacey,1128,4103,701,3252,2116,11300,5
hands,844,4103,1757,829,3767,11300,5
sazen,2206,4103,217,3252,1522,11300,5
airns,1698,2239,2201,1391,3767,11296,5
tides,1264,2239,774,3252,3767,11296,5
warks,596,4103,2201,628,3767,11295,5
helas,844,2863,1603,2214,3767,11291,5
airts,1698,2239,2201,1385,3767,11290,5
jaret,446,4103,2201,3252,1284,11286,5
bemas,1555,2863,885,2214,3767,11284,5
cents,1512,2863,1757,1385,3767,11284,5
marek,1225,4103,2201,3252,502,11283,5
howes,844,3069,349,3252,3767,11281,5
kasey,789,4103,1021,3252,2116,11281,5
jails,446,4103,1668,1295,3767,11279,5
warms,596,4103,2201,612,3767,11279,5
casie,1512,4103,1021,1963,2679,11278,5
daler,1128,4103,1603,3252,1190,11276,5
damns,1128,4103,885,1391,3767,11274,5
horns,844,3069,2201,1391,3767,11272,5
dimes,1128,2239,885,3252,3767,11271,5
barly,1555,4103,2201,1295,2116,11270,5
forts,847,3069,2201,1385,3767,11269,5
palms,1184,4103,1603,612,3767,11269,5
panel,1184,4103,1757,3252,971,11267,5
taxis,1264,4103,170,1963,3767,11267,5
calfs,1512,4103,1603,278,3767,11263,5
acres,1698,338,2201,3252,3767,11256,5
apres,1698,336,2201,3252,3767,11254,5
maned,1225,4103,1757,3252,917,11254,5
rites,948,2239,1048,3252,3767,11254,5
sarky,2206,4103,2201,628,2116,11254,5
jonas,446,3069,1757,2214,3767,11253,5
saxen,2206,4103,170,3252,1522,11253,5
manei,1225,4103,1757,3252,910,11247,5
sulea,2206,1824,1603,3252,2362,11247,5
bauds,1555,4103,990,829,3767,11244,5
garle,965,4103,2201,1295,2679,11243,5
coirs,1512,3069,1668,1225,3767,11241,5
jeris,446,2863,2201,1963,3767,11240,5
loney,1046,3069,1757,3252,2116,11240,5
vails,404,4103,1668,1295,3767,11237,5
byres,1555,458,2201,3252,3767,11233,5
loans,1046,3069,1959,1391,3767,11232,5
muras,1225,1824,2201,2214,3767,11231,5
maxis,1225,4103,170,1963,3767,11228,5
carly,1512,4103,2201,1295,2116,11227,5
loats,1046,3069,1959,1385,3767,11226,5
capos,1512,4103,560,1282,3767,11224,5
poley,1184,3069,1603,3252,2116,11224,5
vaios,404,4103,1668,1282,3767,11224,5
goxes,965,3069,170,3252,3767,11223,5
bikes,1555,2239,406,3252,3767,11219,5
falus,847,4103,1603,899,3767,11219,5
lacey,1046,4103,701,3252,2116,11218,5
korns,789,3069,2201,1391,3767,11217,5
paned,1184,4103,1757,3252,917,11213,5
carex,1512,4103,2201,3252,144,11212,5
harte,844,4103,2201,1385,2679,11212,5
solay,2206,3069,1603,2214,2116,11208,5
galet,965,4103,1603,3252,1284,11207,5
baden,1555,4103,774,3252,1522,11206,5
means,1225,2863,1959,1391,3767,11205,5
monts,1225,3069,1757,1385,3767,11203,5
ranks,948,4103,1757,628,3767,11203,5
wadis,596,4103,774,1963,3767,11203,5
minas,1225,2239,1757,2214,3767,11202,5
torus,1264,3069,2201,899,3767,11200,5
meats,1225,2863,1959,1385,3767,11199,5
tomas,1264,3069,885,2214,3767,11199,5
betis,1555,2863,1048,1963,3767,11196,5
voces,404,3069,701,3252,3767,11193,5
warps,596,4103,2201,526,3767,11193,5
halie,844,4103,1603,1963,2679,11192,5
tarse,1264,4103,2201,945,2679,11192,5
kolis,789,3069,1603,1963,3767,11191,5
carew,1512,4103,2201,3252,122,11190,5
limes,1046,2239,885,3252,3767,11189,5
rakis,948,4103,406,1963,3767,11187,5
siret,2206,2239,2201,3252,1284,11182,5
corks,1512,3069,2201,628,3767,11177,5
torie,1264,3069,2201,1963,2679,11176,5
zoris,176,3069,2201,1963,3767,11176,5
gareh,965,4103,2201,3252,654,11175,5
belts,1555,2863,1603,1385,3767,11173,5
doley,1128,3069,1603,3252,2116,11168,5
saver,2206,4103,417,3252,1190,11168,5
vairs,404,4103,1668,1225,3767,11167,5
camus,1512,4103,885,899,3767,11166,5
peans,1184,2863,1959,1391,3767,11164,5
corms,1512,3069,2201,612,3767,11161,5
morus,1225,3069,2201,899,3767,11161,5
pinas,1184,2239,1757,2214,3767,11161,5
goney,965,3069,1757,3252,2116,11159,5
leros,1046,2863,2201,1282,3767,11159,5
peats,1184,2863,1959,1385,3767,11158,5
saker,2206,4103,406,3252,1190,11157,5
marse,1225,4103,2201,945,2679,11153,5
tavey,1264,4103,417,3252,2116,11152,5
barge,1555,4103,2201,612,2679,11150,5
cloes,1512,1193,1426,3252,3767,11150,5
bater,1555,4103,1048,3252,1190,11148,5
ratos,948,4103,1048,1282,3767,11148,5
teals,1264,2863,1959,1295,3767,11148,5
aeons,1698,2863,1426,1391,3767,11145,5
goats,965,3069,1959,1385,3767,11145,5
bahts,1555,4103,334,1385,3767,11144,5
lotas,1046,3069,1048,2214,3767,11144,5
nabis,647,4103,664,1963,3767,11144,5
sabed,2206,4103,664,3252,917,11142,5
pacts,1184,4103,701,1385,3767,11140,5
taled,1264,4103,1603,3252,917,11139,5
kalie,789,4103,1603,1963,2679,11137,5
morie,1225,3069,2201,1963,2679,11137,5
duras,1128,1824,2201,2214,3767,11134,5
roans,948,3069,1959,1391,3767,11134,5
sayer,2206,4103,381,3252,1190,11132,5
celts,1512,2863,1603,1385,3767,11130,5
farle,847,4103,2201,1295,2679,11125,5
yards,225,4103,2201,829,3767,11125,5
harle,844,4103,2201,1295,2679,11122,5
baser,1555,4103,1021,3252,1190,11121,5
gauls,965,4103,990,1295,3767,11120,5
porus,1184,3069,2201,899,3767,11120,5
metas,1225,2863,1048,2214,3767,11117,5
tacos,1264,4103,701,1282,3767,11117,5
mutes,1225,1824,1048,3252,3767,11116,5
noyes,647,3069,381,3252,3767,11116,5
galer,965,4103,1603,3252,1190,11113,5
coray,1512,3069,2201,2214,2116,11112,5
parse,1184,4103,2201,945,2679,11112,5
waers,596,4103,1421,1225,3767,11112,5
meals,1225,2863,1959,1295,3767,11109,5
paten,1184,4103,1048,3252,1522,11109,5
deans,1128,2863,1959,1391,3767,11108,5
carme,1512,4103,2201,612,2679,11107,5
coria,1512,3069,2201,1963,2362,11107,5
barit,1555,4103,2201,1963,1284,11106,5
cater,1512,4103,1048,3252,1190,11105,5
ceils,1512,2863,1668,1295,3767,11105,5
foxes,847,3069,170,3252,3767,11105,5
taine,1264,4103,1668,1391,2679,11105,5
gabey,965,4103,664,3252,2116,11100,5
sawer,2206,4103,349,3252,1190,11100,5
hanks,844,4103,1757,628,3767,11099,5
fauns,847,4103,990,1391,3767,11098,5
kites,789,2239,1048,3252,3767,11095,5
sinae,2206,2239,1757,2214,2679,11095,5
rimes,948,2239,885,3252,3767,11091,5
bauer,1555,4103,990,3252,1190,11090,5
loren,1046,3069,2201,3252,1522,11090,5
dices,1128,2239,701,3252,3767,11087,5
fangs,847,4103,1757,612,3767,11086,5
jorey,446,3069,2201,3252,2116,11084,5
hangs,844,4103,1757,612,3767,11083,5
caser,1512,4103,1021,3252,1190,11078,5
tears,1264,2863,1959,1225,3767,11078,5
fries,847,1543,1668,3252,3767,11077,5
tarde,1264,4103,2201,829,2679,11076,5
corps,1512,3069,2201,526,3767,11075,5
kolea,789,3069,1603,3252,2362,11075,5
cunas,1512,1824,1757,2214,3767,11074,5
motis,1225,3069,1048,1963,3767,11072,5
torcs,1264,3069,2201,770,3767,11071,5
bawls,1555,4103,349,1295,3767,11069,5
ferns,847,2863,2201,1391,3767,11069,5
nohes,647,3069,334,3252,3767,11069,5
wared,596,4103,2201,3252,917,11069,5
peals,1184,2863,1959,1295,3767,11068,5
herns,844,2863,2201,1391,3767,11066,5
maine,1225,4103,1668,1391,2679,11066,5
oacis,532,4103,701,1963,3767,11066,5
dorus,1128,3069,2201,899,3767,11064,5
plies,1184,1193,1668,3252,3767,11064,5
toils,1264,3069,1668,1295,3767,11063,5
herts,844,2863,2201,1385,3767,11060,5
maite,1225,4103,1668,1385,2679,11060,5
paled,1184,4103,1603,3252,917,11059,5
birls,1555,2239,2201,1295,3767,11057,5
cadus,1512,4103,774,899,3767,11055,5
goals,965,3069,1959,1295,3767,11055,5
tarin,1264,4103,2201,1963,1522,11053,5
dante,1128,4103,1757,1385,2679,11052,5
wands,596,4103,1757,829,3767,11052,5
gaurs,965,4103,990,1225,3767,11050,5
molts,1225,3069,1603,1385,3767,11049,5
borel,1555,3069,2201,3252,971,11048,5
bonus,1555,3069,1757,899,3767,11047,5
soled,2206,3069,1603,3252,917,11047,5
rotas,948,3069,1048,2214,3767,11046,5
cayos,1512,4103,381,1282,3767,11045,5
beaus,1555,2863,1959,899,3767,11043,5
felis,847,2863,1603,1963,3767,11043,5
dorie,1128,3069,2201,1963,2679,11040,5
maleo,1225,4103,1603,3252,857,11040,5
solei,2206,3069,1603,3252,910,11040,5
mears,1225,2863,1959,1225,3767,11039,5
honey,844,3069,1757,3252,2116,11038,5
boers,1555,3069,1421,1225,3767,11037,5
pacos,1184,4103,701,1282,3767,11037,5
bemis,1555,2863,885,1963,3767,11033,5
cadie,1512,4103,774,1963,2679,11031,5
bizes,1555,2239,217,3252,3767,11030,5
marty,1225,4103,2201,1385,2116,11030,5
leans,1046,2863,1959,1391,3767,11026,5
paine,1184,4103,1668,1391,2679,11025,5
moils,1225,3069,1668,1295,3767,11024,5
garek,965,4103,2201,3252,502,11023,5
safer,2206,4103,271,3252,1190,11022,5
carpe,1512,4103,2201,526,2679,11021,5
cubes,1512,1824,664,3252,3767,11019,5
kries,789,1543,1668,3252,3767,11019,5
matie,1225,4103,1048,1963,2679,11018,5
worts,596,3069,2201,1385,3767,11018,5
doits,1128,3069,1668,1385,3767,11017,5
serta,2206,2863,2201,1385,2362,11017,5
davey,1128,4103,417,3252,2116,11016,5
satem,2206,4103,1048,3252,406,11015,5
berks,1555,2863,2201,628,3767,11014,5
marin,1225,4103,2201,1963,1522,11014,5
bosey,1555,3069,1021,3252,2116,11013,5
deals,1128,2863,1959,1295,3767,11012,5
kerns,789,2863,2201,1391,3767,11011,5
sandy,2206,4103,1757,829,2116,11011,5
vadis,404,4103,774,1963,3767,11011,5
haiks,844,4103,1668,628,3767,11010,5
goren,965,3069,2201,3252,1522,11009,5
talys,1264,4103,1603,271,3767,11008,5
horae,844,3069,2201,2214,2679,11007,5
corel,1512,3069,2201,3252,971,11005,5
oared,532,4103,2201,3252,917,11005,5
conus,1512,3069,1757,899,3767,11004,5
jonis,446,3069,1757,1963,3767,11002,5
bolen,1555,3069,1603,3252,1522,11001,5
hauls,844,4103,990,1295,3767,10999,5
ianus,473,4103,1757,899,3767,10999,5
bergs,1555,2863,2201,612,3767,10998,5
berms,1555,2863,2201,612,3767,10998,5
pears,1184,2863,1959,1225,3767,10998,5
selia,2206,2863,1603,1963,2362,10997,5
parde,1184,4103,2201,829,2679,10996,5
bored,1555,3069,2201,3252,917,10994,5
haler,844,4103,1603,3252,1190,10992,5
maneh,1225,4103,1757,3252,654,10991,5
poret,1184,3069,2201,3252,1284,10990,5
party,1184,4103,2201,1385,2116,10989,5
roley,948,3069,1603,3252,2116,10988,5
pareu,1184,4103,2201,3252,247,10987,5
ramos,948,4103,885,1282,3767,10985,5
lorus,1046,3069,2201,899,3767,10982,5
rides,948,2239,774,3252,3767,10980,5
ioves,473,3069,417,3252,3767,10978,5
bonds,1555,3069,1757,829,3767,10977,5
sorty,2206,3069,2201,1385,2116,10977,5
koans,789,3069,1959,1391,3767,10975,5
beads,1555,2863,1959,829,3767,10973,5
janus,446,4103,1757,899,3767,10972,5
laten,1046,4103,1048,3252,1522,10971,5
cosey,1512,3069,1021,3252,2116,10970,5
herls,844,2863,2201,1295,3767,10970,5
maile,1225,4103,1668,1295,2679,10970,5
warne,596,4103,2201,1391,2679,10970,5
mafey,1225,4103,271,3252,2116,10967,5
sotie,2206,3069,1048,1963,2679,10965,5
arces,1698,1543,701,3252,3767,10961,5
kacey,789,4103,701,3252,2116,10961,5
altes,1698,1193,1048,3252,3767,10958,5
colen,1512,3069,1603,3252,1522,10958,5
lorie,1046,3069,2201,1963,2679,10958,5
heros,844,2863,2201,1282,3767,10957,5
dolts,1128,3069,1603,1385,3767,10952,5
sancy,2206,4103,1757,770,2116,10952,5
cored,1512,3069,2201,3252,917,10951,5
beray,1555,2863,2201,2214,2116,10949,5
hafis,844,4103,271,1963,3767,10948,5
janie,446,4103,1757,1963,2679,10948,5
samek,2206,4103,885,3252,502,10948,5
sable,2206,4103,664,1295,2679,10947,5
beria,1555,2863,2201,1963,2362,10944,5
yamis,225,4103,885,1963,3767,10943,5
dears,1128,2863,1959,1225,3767,10942,5
tyres,1264,458,2201,3252,3767,10942,5
loins,1046,3069,1668,1391,3767,10941,5
jokes,446,3069,406,3252,3767,10940,5
marly,1225,4103,2201,1295,2116,10940,5
puris,1184,1824,2201,1963,3767,10939,5
jasey,446,4103,1021,3252,2116,10938,5
sakel,2206,4103,406,3252,971,10938,5
foals,847,3069,1959,1295,3767,10937,5
lutes,1046,1824,1048,3252,3767,10937,5
togas,1264,3069,616,2214,3767,10930,5
batel,1555,4103,1048,3252,971,10929,5
halms,844,4103,1603,612,3767,10929,5
larue,1046,4103,2201,899,2679,10928,5
tikes,1264,2239,406,3252,3767,10928,5
cadet,1512,4103,774,3252,1284,10925,5
sorce,2206,3069,2201,770,2679,10925,5
bande,1555,4103,1757,829,2679,10923,5
lakey,1046,4103,406,3252,2116,10923,5
jared,446,4103,2201,3252,917,10919,5
tamus,1264,4103,885,899,3767,10918,5
darin,1128,4103,2201,1963,1522,10917,5
bagie,1555,4103,616,1963,2679,10916,5
banty,1555,4103,1757,1385,2116,10916,5
mauds,1225,4103,990,829,3767,10914,5
sacre,2206,4103,701,1225,2679,10914,5
lords,1046,3069,2201,829,3767,10912,5
ailey,1698,2239,1603,3252,2116,10908,5
aegis,1698,2863,616,1963,3767,10907,5
rices,948,2239,701,3252,3767,10907,5
basel,1555,4103,1021,3252,971,10902,5
keros,789,2863,2201,1282,3767,10902,5
wites,596,2239,1048,3252,3767,10902,5
ceria,1512,2863,2201,1963,2362,10901,5
vabis,404,4103,664,1963,3767,10901,5
dents,1128,2863,1757,1385,3767,10900,5
maire,1225,4103,1668,1225,2679,10900,5
parly,1184,4103,2201,1295,2116,10899,5
sagle,2206,4103,616,1295,2679,10899,5
waner,596,4103,1757,3252,1190,10898,5
navis,647,4103,417,1963,3767,10897,5
baths,1555,4103,1048,423,3767,10896,5
dagos,1128,4103,616,1282,3767,10896,5
borne,1555,3069,2201,1391,2679,10895,5
saved,2206,4103,417,3252,917,10895,5
dasie,1128,4103,1021,1963,2679,10894,5
bolus,1555,3069,1603,899,3767,10893,5
garse,965,4103,2201,945,2679,10893,5
lotis,1046,3069,1048,1963,3767,10893,5
jules,446,1824,1603,3252,3767,10892,5
mikes,1225,2239,406,3252,3767,10889,5
toads,1264,3069,1959,829,3767,10888,5
foley,847,3069,1603,3252,2116,10887,5
gibes,965,2239,664,3252,3767,10887,5
laine,1046,4103,1668,1391,2679,10887,5
catel,1512,4103,1048,3252,971,10886,5
choes,1512,927,1426,3252,3767,10884,5
holey,844,3069,1603,3252,2116,10884,5
darce,1128,4103,2201,770,2679,10881,5
cedis,1512,2863,774,1963,3767,10879,5
fides,847,2239,774,3252,3767,10879,5
sabre,2206,4103,664,1225,2679,10877,5
arges,1698,1543,616,3252,3767,10876,5
hides,844,2239,774,3252,3767,10876,5
bated,1555,4103,1048,3252,917,10875,5
tinea,1264,2239,1757,3252,2362,10874,5
topas,1264,3069,560,2214,3767,10874,5
canty,1512,4103,1757,1385,2116,10873,5
daile,1128,4103,1668,1295,2679,10873,5
peins,1184,2863,1668,1391,3767,10873,5
sorex,2206,3069,2201,3252,144,10872,5
copis,1512,3069,560,1963,3767,10871,5
ribes,948,2239,664,3252,3767,10870,5
maxey,1225,4103,170,3252,2116,10866,5
metis,1225,2863,1048,1963,3767,10866,5
hoars,844,3069,1959,1225,3767,10864,5
latus,1046,4103,1048,899,3767,10863,5
nerts,647,2863,2201,1385,3767,10863,5
pyres,1184,458,2201,3252,3767,10862,5
lears,1046,2863,1959,1225,3767,10860,5
casel,1512,4103,1021,3252,971,10859,5
sayed,2206,4103,381,3252,917,10859,5
targe,1264,4103,2201,612,2679,10859,5
getas,965,2863,1048,2214,3767,10857,5
aulis,1698,1824,1603,1963,3767,10855,5
lahey,1046,4103,334,3252,2116,10851,5
ornes,532,1543,1757,3252,3767,10851,5
salve,2206,4103,1603,259,2679,10850,5
porks,1184,3069,2201,628,3767,10849,5
based,1555,4103,1021,3252,917,10848,5
pikes,1184,2239,406,3252,3767,10848,5
wauns,596,4103,990,1391,3767,10847,5
rasen,948,4103,1021,3252,1522,10846,5
melts,1225,2863,1603,1385,3767,10843,5
saple,2206,4103,560,1295,2679,10843,5
janet,446,4103,1757,3252,1284,10842,5
satin,2206,4103,1048,1963,1522,10842,5
baken,1555,4103,406,3252,1522,10838,5
froes,847,1543,1426,3252,3767,10835,5
larin,1046,4103,2201,1963,1522,10835,5
louis,1046,3069,990,1963,3767,10835,5
paden,1184,4103,774,3252,1522,10835,5
galei,965,4103,1603,3252,910,10833,5
koren,789,3069,2201,3252,1522,10833,5
reals,948,2863,1959,1295,3767,10832,5
cader,1512,4103,774,3252,1190,10831,5
tareq,1264,4103,2201,3252,9,10829,5
sawed,2206,4103,349,3252,917,10827,5
poets,1184,3069,1421,1385,3767,10826,5
tunas,1264,1824,1757,2214,3767,10826,5
wries,596,1543,1668,3252,3767,10826,5
fonts,847,3069,1757,1385,3767,10825,5
moray,1225,3069,2201,2214,2116,10825,5
boner,1555,3069,1757,3252,1190,10823,5
silen,2206,2239,1603,3252,1522,10822,5
feats,847,2863,1959,1385,3767,10821,5
marge,1225,4103,2201,612,2679,10820,5
moria,1225,3069,2201,1963,2362,10820,5
heats,844,2863,1959,1385,3767,10818,5
mater,1225,4103,1048,3252,1190,10818,5
dazey,1128,4103,217,3252,2116,10816,5
trues,1264,1543,990,3252,3767,10816,5
cabet,1512,4103,664,3252,1284,10815,5
sired,2206,2239,2201,3252,917,10815,5
lagos,1046,4103,616,1282,3767,10814,5
acnes,1698,338,1757,3252,3767,10812,5
barye,1555,4103,2201,271,2679,10809,5
fices,847,2239,701,3252,3767,10806,5
gaine,965,4103,1668,1391,2679,10806,5
harem,844,4103,2201,3252,406,10806,5
cased,1512,4103,1021,3252,917,10805,5
bardy,1555,4103,2201,829,2116,10804,5
dives,1128,2239,417,3252,3767,10803,5
facts,847,4103,701,1385,3767,10803,5
jamey,446,4103,885,3252,2116,10802,5
pelts,1184,2863,1603,1385,3767,10802,5
sauty,2206,4103,990,1385,2116,10800,5
phies,1184,927,1668,3252,3767,10798,5
almes,1698,1193,885,3252,3767,10795,5
parke,1184,4103,2201,628,2679,10795,5
pawns,1184,4103,349,1391,3767,10794,5
camps,1512,4103,885,526,3767,10793,5
dorks,1128,3069,2201,628,3767,10793,5
dikes,1128,2239,406,3252,3767,10792,5
maser,1225,4103,1021,3252,1190,10791,5
nimes,647,2239,885,3252,3767,10790,5
golts,965,3069,1603,1385,3767,10789,5
raine,948,4103,1668,1391,2679,10789,5
makos,1225,4103,406,1282,3767,10783,5
pirns,1184,2239,2201,1391,3767,10782,5
yonis,225,3069,1757,1963,3767,10781,5
colds,1512,3069,1603,829,3767,10780,5
coner,1512,3069,1757,3252,1190,10780,5
horus,844,3069,2201,899,3767,10780,5
gears,965,2863,1959,1225,3767,10779,5
parge,1184,4103,2201,612,2679,10779,5
poria,1184,3069,2201,1963,2362,10779,5
telos,1264,2863,1603,1282,3767,10779,5
dorms,1128,3069,2201,612,3767,10777,5
garde,965,4103,2201,829,2679,10777,5
pater,1184,4103,1048,3252,1190,10777,5
zenas,176,2863,1757,2214,3767,10777,5
bonks,1555,3069,1757,628,3767,10776,5
farse,847,4103,2201,945,2679,10775,5
fados,847,4103,774,1282,3767,10773,5
beaks,1555,2863,1959,628,3767,10772,5
bends,1555,2863,1757,829,3767,10771,5
fante,847,4103,1757,1385,2679,10771,5
tubes,1264,1824,664,3252,3767,10771,5
bouts,1555,3069,990,1385,3767,10766,5
kinas,789,2239,1757,2214,3767,10766,5
maben,1225,4103,664,3252,1522,10766,5
ripes,948,2239,560,3252,3767,10766,5
tirls,1264,2239,2201,1295,3767,10766,5
soter,2206,3069,1048,3252,1190,10765,5
keats,789,2863,1959,1385,3767,10763,5
cukes,1512,1824,406,3252,3767,10761,5
bongs,1555,3069,1757,612,3767,10760,5
mauer,1225,4103,990,3252,1190,10760,5
damie,1128,4103,885,1963,2679,10758,5
hajis,844,4103,81,1963,3767,10758,5
mayos,1225,4103,381,1282,3767,10758,5
sarip,2206,4103,2201,1963,285,10758,5
blues,1555,1193,990,3252,3767,10757,5
beams,1555,2863,1959,612,3767,10756,5
tonus,1264,3069,1757,899,3767,10756,5
serin,2206,2863,2201,1963,1522,10755,5
backs,1555,4103,701,628,3767,10754,5
carve,1512,4103,2201,259,2679,10754,5
garin,965,4103,2201,1963,1522,10754,5
tiros,1264,2239,2201,1282,3767,10753,5
sarto,2206,4103,2201,1385,857,10752,5
nafis,647,4103,271,1963,3767,10751,5
wauls,596,4103,990,1295,3767,10751,5
caril,1512,4103,2201,1963,971,10750,5
laroy,1046,4103,2201,1282,2116,10748,5
sauce,2206,4103,990,770,2679,10748,5
haems,844,4103,1421,612,3767,10747,5
roils,948,3069,1668,1295,3767,10747,5
punas,1184,1824,1757,2214,3767,10746,5
waler,596,4103,1603,3252,1190,10744,5
baste,1555,4103,1021,1385,2679,10743,5
foins,847,3069,1668,1391,3767,10742,5
hasen,844,4103,1021,3252,1522,10742,5
melos,1225,2863,1603,1282,3767,10740,5
barid,1555,4103,2201,1963,917,10739,5
fetas,847,2863,1048,2214,3767,10739,5
tizes,1264,2239,217,3252,3767,10739,5
burns,1555,1824,2201,1391,3767,10738,5
dawns,1128,4103,349,1391,3767,10738,5
dopas,1128,3069,560,2214,3767,10738,5
baily,1555,4103,1668,1295,2116,10737,5
gents,965,2863,1757,1385,3767,10737,5
lauds,1046,4103,990,829,3767,10735,5
nagey,647,4103,616,3252,2116,10734,5
conks,1512,3069,1757,628,3767,10733,5
dawts,1128,4103,349,1385,3767,10732,5
tonie,1264,3069,1757,1963,2679,10732,5
doray,1128,3069,2201,2214,2116,10728,5
heals,844,2863,1959,1295,3767,10728,5
puces,1184,1824,701,3252,3767,10728,5
flies,847,1193,1668,3252,3767,10727,5
padus,1184,4103,774,899,3767,10727,5
fakey,847,4103,406,3252,2116,10724,5
lyres,1046,458,2201,3252,3767,10724,5
acies,1698,338,1668,3252,3767,10723,5
camel,1512,4103,885,3252,971,10723,5
doria,1128,3069,2201,1963,2362,10723,5
caber,1512,4103,664,3252,1190,10721,5
dater,1128,4103,1048,3252,1190,10721,5
deils,1128,2863,1668,1295,3767,10721,5
lives,1046,2239,417,3252,3767,10721,5
todea,1264,3069,774,3252,2362,10721,5
colet,1512,3069,1603,3252,1284,10720,5
dirts,1128,2239,2201,1385,3767,10720,5
rents,948,2863,1757,1385,3767,10720,5
haled,844,4103,1603,3252,917,10719,5
yokes,225,3069,406,3252,3767,10719,5
garce,965,4103,2201,770,2679,10718,5
magen,1225,4103,616,3252,1522,10718,5
morel,1225,3069,2201,3252,971,10718,5
salon,2206,4103,1603,1282,1522,10716,5
kados,789,4103,774,1282,3767,10715,5
lenos,1046,2863,1757,1282,3767,10715,5
clues,1512,1193,990,3252,3767,10714,5
fords,847,3069,2201,829,3767,10713,5
amies,1698,327,1668,3252,3767,10712,5
capet,1512,4103,560,3252,1284,10711,5
kibes,789,2239,664,3252,3767,10711,5
gaile,965,4103,1668,1295,2679,10710,5
likes,1046,2239,406,3252,3767,10710,5
motey,1225,3069,1048,3252,2116,10710,5
sirte,2206,2239,2201,1385,2679,10710,5
manse,1225,4103,1757,945,2679,10709,5
sarod,2206,4103,2201,1282,917,10709,5
cunea,1512,1824,1757,3252,2362,10707,5
terms,1264,2863,2201,612,3767,10707,5
bakie,1555,4103,406,1963,2679,10706,5
bange,1555,4103,1757,612,2679,10706,5
saimy,2206,4103,1668,612,2116,10705,5
bints,1555,2239,1757,1385,3767,10703,5
calin,1512,4103,1603,1963,1522,10703,5
tored,1264,3069,2201,3252,917,10703,5
korie,789,3069,2201,1963,2679,10701,5
tapen,1264,4103,560,3252,1522,10701,5
caste,1512,4103,1021,1385,2679,10700,5
lamus,1046,4103,885,899,3767,10700,5
cavus,1512,4103,417,899,3767,10698,5
pawls,1184,4103,349,1295,3767,10698,5
davos,1128,4103,417,1282,3767,10697,5
laden,1046,4103,774,3252,1522,10697,5
nazis,647,4103,217,1963,3767,10697,5
orles,532,1543,1603,3252,3767,10697,5
tabus,1264,4103,664,899,3767,10697,5
walks,596,4103,1603,628,3767,10697,5
carid,1512,4103,2201,1963,917,10696,5
somet,2206,3069,885,3252,1284,10696,5
curns,1512,1824,2201,1391,3767,10695,5
tamer,1264,4103,885,3252,1190,10694,5
monie,1225,3069,1757,1963,2679,10693,5
tahrs,1264,4103,334,1225,3767,10693,5
dorps,1128,3069,2201,526,3767,10691,5
pubes,1184,1824,664,3252,3767,10691,5
cambs,1512,4103,885,423,3767,10690,5
jalet,446,4103,1603,3252,1284,10688,5
belus,1555,2863,1603,899,3767,10687,5
haine,844,4103,1668,1391,2679,10685,5
malek,1225,4103,1603,3252,502,10685,5
merks,1225,2863,2201,628,3767,10684,5
mosey,1225,3069,1021,3252,2116,10683,5
mokas,1225,3069,406,2214,3767,10681,5
nides,647,2239,774,3252,3767,10679,5
cavie,1512,4103,417,1963,2679,10674,5
yagis,225,4103,616,1963,3767,10674,5
cager,1512,4103,616,3252,1190,10673,5
duces,1128,1824,701,3252,3767,10672,5
yules,225,1824,1603,3252,3767,10671,5
loads,1046,3069,1959,829,3767,10670,5
pahos,1184,4103,334,1282,3767,10670,5
coeus,1512,3069,1421,899,3767,10668,5
holts,844,3069,1603,1385,3767,10668,5
panse,1184,4103,1757,945,2679,10668,5
tepas,1264,2863,560,2214,3767,10668,5
sorda,2206,3069,2201,829,2362,10667,5
baron,1555,4103,2201,1282,1522,10663,5
conia,1512,3069,1757,1963,2362,10663,5
ludes,1046,1824,774,3252,3767,10663,5
manue,1225,4103,1757,899,2679,10663,5
yowes,225,3069,349,3252,3767,10662,5
fears,847,2863,1959,1225,3767,10661,5
soral,2206,3069,2201,2214,971,10661,5
bimas,1555,2239,885,2214,3767,10660,5
farde,847,4103,2201,829,2679,10659,5
taise,1264,4103,1668,945,2679,10659,5
farny,847,4103,2201,1391,2116,10658,5
hears,844,2863,1959,1225,3767,10658,5
lawns,1046,4103,349,1391,3767,10656,5
linea,1046,2239,1757,3252,2362,10656,5
forcs,847,3069,2201,770,3767,10654,5
gauds,965,4103,990,829,3767,10654,5
basle,1555,4103,1021,1295,2679,10653,5
foret,847,3069,2201,3252,1284,10653,5
mixes,1225,2239,170,3252,3767,10653,5
teria,1264,2863,2201,1963,2362,10653,5
fahey,847,4103,334,3252,2116,10652,5
saint,2206,4103,1668,1391,1284,10652,5
harty,844,4103,2201,1385,2116,10649,5
tagus,1264,4103,616,899,3767,10649,5
zared,176,4103,2201,3252,917,10649,5
zoeas,176,3069,1421,2214,3767,10647,5
foils,847,3069,1668,1295,3767,10646,5
jatos,446,4103,1048,1282,3767,10646,5
valet,404,4103,1603,3252,1284,10646,5
delos,1128,2863,1603,1282,3767,10643,5
gyres,965,458,2201,3252,3767,10643,5
meads,1225,2863,1959,829,3767,10643,5
perks,1184,2863,2201,628,3767,10643,5
vangs,404,4103,1757,612,3767,10643,5
burls,1555,1824,2201,1295,3767,10642,5
posey,1184,3069,1021,3252,2116,10642,5
large,1046,4103,2201,612,2679,10641,5
loria,1046,3069,2201,1963,2362,10641,5
gives,965,2239,417,3252,3767,10640,5
pilea,1184,2239,1603,3252,2362,10640,5
saury,2206,4103,990,1225,2116,10640,5
later,1046,4103,1048,3252,1190,10639,5
reins,948,2863,1668,1391,3767,10637,5
genos,965,2863,1757,1282,3767,10634,5
mabie,1225,4103,664,1963,2679,10634,5
vries,404,1543,1668,3252,3767,10634,5
peons,1184,2863,1426,1391,3767,10631,5
dirls,1128,2239,2201,1295,3767,10630,5
kaine,789,4103,1668,1391,2679,10630,5
wides,596,2239,774,3252,3767,10628,5
dahls,1128,4103,334,1295,3767,10627,5
perms,1184,2863,2201,612,3767,10627,5
waned,596,4103,1757,3252,917,10625,5
pored,1184,3069,2201,3252,917,10623,5
rives,948,2239,417,3252,3767,10623,5
sapek,2206,4103,560,3252,502,10623,5
topis,1264,3069,560,1963,3767,10623,5
neats,647,2863,1959,1385,3767,10621,5
caron,1512,4103,2201,1282,1522,10620,5
donus,1128,3069,1757,899,3767,10620,5
maise,1225,4103,1668,945,2679,10620,5
verts,404,2863,2201,1385,3767,10620,5
jacey,446,4103,701,3252,2116,10618,5
sarif,2206,4103,2201,1963,145,10618,5
caper,1512,4103,560,3252,1190,10617,5
hents,844,2863,1757,1385,3767,10616,5
calef,1512,4103,1603,3252,145,10615,5
cerys,1512,2863,2201,271,3767,10614,5
halte,844,4103,1603,1385,2679,10614,5
solan,2206,3069,1603,2214,1522,10614,5
agnes,1698,139,1757,3252,3767,10613,5
cadel,1512,4103,774,3252,971,10612,5
laser,1046,4103,1021,3252,1190,10612,5
pixes,1184,2239,170,3252,3767,10612,5
alces,1698,1193,701,3252,3767,10611,5
doers,1128,3069,1421,1225,3767,10610,5
magus,1225,4103,616,899,3767,10610,5
cameo,1512,4103,885,3252,857,10609,5
bogey,1555,3069,616,3252,2116,10608,5
lunas,1046,1824,1757,2214,3767,10608,5
ponds,1184,3069,1757,829,3767,10606,5
kaifs,789,4103,1668,278,3767,10605,5
barky,1555,4103,2201,628,2116,10603,5
bawds,1555,4103,349,829,3767,10603,5
ramus,948,4103,885,899,3767,10602,5
tolus,1264,3069,1603,899,3767,10602,5
farce,847,4103,2201,770,2679,10600,5
caleb,1512,4103,1603,3252,129,10599,5
curls,1512,1824,2201,1295,3767,10599,5
coeds,1512,3069,1421,829,3767,10598,5
dacus,1128,4103,701,899,3767,10598,5
donie,1128,3069,1757,1963,2679,10596,5
sayre,2206,4103,381,1225,2679,10594,5
mande,1225,4103,1757,829,2679,10593,5
pulas,1184,1824,1603,2214,3767,10592,5
birds,1555,2239,2201,829,3767,10591,5
luces,1046,1824,701,3252,3767,10590,5
parhe,1184,4103,2201,423,2679,10590,5
goads,965,3069,1959,829,3767,10589,5
haile,844,4103,1668,1295,2679,10589,5
degas,1128,2863,616,2214,3767,10588,5
barmy,1555,4103,2201,612,2116,10587,5
monet,1225,3069,1757,3252,1284,10587,5
manty,1225,4103,1757,1385,2116,10586,5
gelts,965,2863,1603,1385,3767,10583,5
gudes,965,1824,774,3252,3767,10582,5
katie,789,4103,1048,1963,2679,10582,5
nomas,647,3069,885,2214,3767,10582,5
lauer,1046,4103,990,3252,1190,10581,5
borek,1555,3069,2201,3252,502,10579,5
paise,1184,4103,1668,945,2679,10579,5
karin,789,4103,2201,1963,1522,10578,5
ramie,948,4103,885,1963,2679,10578,5
purey,1184,1824,2201,3252,2116,10577,5
weans,596,2863,1959,1391,3767,10576,5
fumes,847,1824,885,3252,3767,10575,5
soary,2206,3069,1959,1225,2116,10575,5
tunis,1264,1824,1757,1963,3767,10575,5
arlis,1698,1543,1603,1963,3767,10574,5
dacie,1128,4103,701,1963,2679,10574,5
wonts,596,3069,1757,1385,3767,10574,5
peria,1184,2863,2201,1963,2362,10573,5
bohea,1555,3069,334,3252,2362,10572,5
roads,948,3069,1959,829,3767,10572,5
derms,1128,2863,2201,612,3767,10571,5
iotas,473,3069,1048,2214,3767,10571,5
pagus,1184,4103,616,899,3767,10569,5
maths,1225,4103,1048,423,3767,10566,5
bevis,1555,2863,417,1963,3767,10565,5
morne,1225,3069,2201,1391,2679,10565,5
cours,1512,3069,990,1225,3767,10563,5
girns,965,2239,2201,1391,3767,10563,5
molus,1225,3069,1603,899,3767,10563,5
farly,847,4103,2201,1295,2116,10562,5
boran,1555,3069,2201,2214,1522,10561,5
norie,647,3069,2201,1963,2679,10559,5
gater,965,4103,1048,3252,1190,10558,5
patel,1184,4103,1048,3252,971,10558,5
abies,1698,172,1668,3252,3767,10557,5
girts,965,2239,2201,1385,3767,10557,5
kagos,789,4103,616,1282,3767,10557,5
kaneh,789,4103,1757,3252,654,10555,5
lubes,1046,1824,664,3252,3767,10553,5
baure,1555,4103,990,1225,2679,10552,5
valer,404,4103,1603,3252,1190,10552,5
boned,1555,3069,1757,3252,917,10550,5
hosea,844,3069,1021,3252,2362,10548,5
piney,1184,2239,1757,3252,2116,10548,5
taken,1264,4103,406,3252,1522,10547,5
mated,1225,4103,1048,3252,917,10545,5
panty,1184,4103,1757,1385,2116,10545,5
tamps,1264,4103,885,526,3767,10545,5
jotas,446,3069,1048,2214,3767,10544,5
pians,1184,2239,1959,1391,3767,10540,5
sonde,2206,3069,1757,829,2679,10540,5
lagen,1046,4103,616,3252,1522,10539,5
kaile,789,4103,1668,1295,2679,10534,5
heins,844,2863,1668,1391,3767,10533,5
depas,1128,2863,560,2214,3767,10532,5
toner,1264,3069,1757,3252,1190,10532,5
dupes,1128,1824,560,3252,3767,10531,5
lanse,1046,4103,1757,945,2679,10530,5
corta,1512,3069,2201,1385,2362,10529,5
janel,446,4103,1757,3252,971,10529,5
gorps,965,3069,2201,526,3767,10528,5
gunas,965,1824,1757,2214,3767,10527,5
paths,1184,4103,1048,423,3767,10525,5
sabec,2206,4103,664,3252,300,10525,5
zarfs,176,4103,2201,278,3767,10525,5
warse,596,4103,2201,945,2679,10524,5
deray,1128,2863,2201,2214,2116,10522,5
faire,847,4103,1668,1225,2679,10522,5
fives,847,2239,417,3252,3767,10522,5
naled,647,4103,1603,3252,917,10522,5
haire,844,4103,1668,1225,2679,10519,5
hives,844,2239,417,3252,3767,10519,5
maven,1225,4103,417,3252,1522,10519,5
coran,1512,3069,2201,2214,1522,10518,5
porte,1184,3069,2201,1385,2679,10518,5
grues,965,1543,990,3252,3767,10517,5
lonie,1046,3069,1757,1963,2679,10514,5
fogas,847,3069,616,2214,3767,10513,5
tardy,1264,4103,2201,829,2116,10513,5
forks,847,3069,2201,628,3767,10512,5
menus,1225,2863,1757,899,3767,10511,5
gadus,965,4103,774,899,3767,10508,5
hikes,844,2239,406,3252,3767,10508,5
coned,1512,3069,1757,3252,917,10507,5
baker,1555,4103,406,3252,1190,10506,5
pomey,1184,3069,885,3252,2116,10506,5
tarve,1264,4103,2201,259,2679,10506,5
luges,1046,1824,616,3252,3767,10505,5
herds,844,2863,2201,829,3767,10504,5
jarek,446,4103,2201,3252,502,10504,5
karly,789,4103,2201,1295,2116,10504,5
losey,1046,3069,1021,3252,2116,10504,5
pated,1184,4103,1048,3252,917,10504,5
benia,1555,2863,1757,1963,2362,10500,5
faden,847,4103,774,3252,1522,10498,5
hamus,844,4103,885,899,3767,10498,5
tynes,1264,458,1757,3252,3767,10498,5
bagel,1555,4103,616,3252,971,10497,5
forms,847,3069,2201,612,3767,10496,5
manly,1225,4103,1757,1295,2116,10496,5
haden,844,4103,774,3252,1522,10495,5
notis,647,3069,1048,1963,3767,10494,5
sadly,2206,4103,774,1295,2116,10494,5
molds,1225,3069,1603,829,3767,10493,5
moner,1225,3069,1757,3252,1190,10493,5
ables,1698,172,1603,3252,3767,10492,5
lacie,1046,4103,701,1963,2679,10492,5
donet,1128,3069,1757,3252,1284,10490,5
siler,2206,2239,1603,3252,1190,10490,5
fetis,847,2863,1048,1963,3767,10488,5
floes,847,1193,1426,3252,3767,10485,5
lored,1046,3069,2201,3252,917,10485,5
mateo,1225,4103,1048,3252,857,10485,5
wavey,596,4103,417,3252,2116,10484,5
aotus,1698,3069,1048,899,3767,10481,5
bayer,1555,4103,381,3252,1190,10481,5
teaks,1264,2863,1959,628,3767,10481,5
yanks,225,4103,1757,628,3767,10480,5
tends,1264,2863,1757,829,3767,10480,5
weals,596,2863,1959,1295,3767,10480,5
paven,1184,4103,417,3252,1522,10478,5
salot,2206,4103,1603,1282,1284,10478,5
barih,1555,4103,2201,1963,654,10476,5
lamer,1046,4103,885,3252,1190,10476,5
caver,1512,4103,417,3252,1190,10474,5
mardy,1225,4103,2201,829,2116,10474,5
rafts,948,4103,271,1385,3767,10474,5
louey,1046,3069,990,3252,2116,10473,5
taber,1264,4103,664,3252,1190,10473,5
ramet,948,4103,885,3252,1284,10472,5
macer,1225,4103,701,3252,1190,10471,5
waled,596,4103,1603,3252,917,10471,5
baxie,1555,4103,170,1963,2679,10470,5
tongs,1264,3069,1757,612,3767,10469,5
twaes,1264,226,1959,3252,3767,10468,5
girls,965,2239,2201,1295,3767,10467,5
karez,789,4103,2201,3252,122,10467,5
marve,1225,4103,2201,259,2679,10467,5
radie,948,4103,774,1963,2679,10467,5
dolus,1128,3069,1603,899,3767,10466,5
felts,847,2863,1603,1385,3767,10465,5
teams,1264,2863,1959,612,3767,10465,5
yangs,225,4103,1757,612,3767,10464,5
leads,1046,2863,1959,829,3767,10464,5
natus,647,4103,1048,899,3767,10464,5
caker,1512,4103,406,3252,1190,10463,5
maril,1225,4103,2201,1963,971,10463,5
naifs,647,4103,1668,278,3767,10463,5
tacks,1264,4103,701,628,3767,10463,5
words,596,3069,2201,829,3767,10462,5
cuney,1512,1824,1757,3252,2116,10461,5
dirae,1128,2239,2201,2214,2679,10461,5
logis,1046,3069,616,1963,3767,10461,5
nears,647,2863,1959,1225,3767,10461,5
qaids,93,4103,1668,829,3767,10460,5
betrs,1555,2863,1048,1225,3767,10458,5
kenos,789,2863,1757,1282,3767,10458,5
majos,1225,4103,81,1282,3767,10458,5
sabin,2206,4103,664,1963,1522,10458,5
fawns,847,4103,349,1391,3767,10457,5
oaten,532,4103,1048,3252,1522,10457,5
trias,1264,1543,1668,2214,3767,10456,5
rubes,948,1824,664,3252,3767,10455,5
seral,2206,2863,2201,2214,971,10455,5
soken,2206,3069,406,3252,1522,10455,5
giros,965,2239,2201,1282,3767,10454,5
loams,1046,3069,1959,612,3767,10453,5
pitas,1184,2239,1048,2214,3767,10452,5
lepas,1046,2863,560,2214,3767,10450,5
foray,847,3069,2201,2214,2116,10447,5
goers,965,3069,1421,1225,3767,10447,5
turns,1264,1824,2201,1391,3767,10447,5
bilos,1555,2239,1603,1282,3767,10446,5
monks,1225,3069,1757,628,3767,10446,5
noils,647,3069,1668,1295,3767,10446,5
taily,1264,4103,1668,1295,2116,10446,5
firns,847,2239,2201,1391,3767,10445,5
maice,1225,4103,1668,770,2679,10445,5
moxas,1225,3069,170,2214,3767,10445,5
sonly,2206,3069,1757,1295,2116,10443,5
payen,1184,4103,381,3252,1522,10442,5
laise,1046,4103,1668,945,2679,10441,5
mends,1225,2863,1757,829,3767,10441,5
ragen,948,4103,616,3252,1522,10441,5
vamos,404,4103,885,1282,3767,10441,5
kaden,789,4103,774,3252,1522,10440,5
natie,647,4103,1048,1963,2679,10440,5
paget,1184,4103,616,3252,1284,10439,5
sealy,2206,2863,1959,1295,2116,10439,5
dance,1128,4103,1757,770,2679,10437,5
gaums,965,4103,990,612,3767,10437,5
hater,844,4103,1048,3252,1190,10437,5
heils,844,2863,1668,1295,3767,10437,5
waine,596,4103,1668,1391,2679,10437,5
antes,1698,671,1048,3252,3767,10436,5
sonar,2206,3069,1757,2214,1190,10436,5
miley,1225,2239,1603,3252,2116,10435,5
molet,1225,3069,1603,3252,1284,10433,5
pardy,1184,4103,2201,829,2116,10433,5
pukes,1184,1824,406,3252,3767,10433,5
vaned,404,4103,1757,3252,917,10433,5
malty,1225,4103,1603,1385,2116,10432,5
aunts,1698,1824,1757,1385,3767,10431,5
waite,596,4103,1668,1385,2679,10431,5
pacer,1184,4103,701,3252,1190,10430,5
wanle,596,4103,1757,1295,2679,10430,5
soget,2206,3069,616,3252,1284,10427,5
jeans,446,2863,1959,1391,3767,10426,5
parve,1184,4103,2201,259,2679,10426,5
tavie,1264,4103,417,1963,2679,10426,5
tager,1264,4103,616,3252,1190,10425,5
macks,1225,4103,701,628,3767,10424,5
calpe,1512,4103,1603,526,2679,10423,5
daven,1128,4103,417,3252,1522,10422,5
tamed,1264,4103,885,3252,917,10421,5
paseo,1184,4103,1021,3252,857,10417,5
malin,1225,4103,1603,1963,1522,10416,5
lazos,1046,4103,217,1282,3767,10415,5
marcy,1225,4103,2201,770,2116,10415,5
tonia,1264,3069,1757,1963,2362,10415,5
lande,1046,4103,1757,829,2679,10414,5
wipes,596,2239,560,3252,3767,10414,5
waifs,596,4103,1668,278,3767,10412,5
daubs,1128,4103,990,423,3767,10411,5
liney,1046,2239,1757,3252,2116,10410,5
wears,596,2863,1959,1225,3767,10410,5
bovey,1555,3069,417,3252,2116,10409,5
damps,1128,4103,885,526,3767,10409,5
marid,1225,4103,2201,1963,917,10409,5
early,693,4103,2201,1295,2116,10408,5
germs,965,2863,2201,612,3767,10408,5
warde,596,4103,2201,829,2679,10408,5
kelts,789,2863,1603,1385,3767,10407,5
corse,1512,3069,2201,945,2679,10406,5
gored,965,3069,2201,3252,917,10404,5
moier,1225,3069,1668,3252,1190,10404,5
axles,1698,83,1603,3252,3767,10403,5
conte,1512,3069,1757,1385,2679,10402,5
nuris,647,1824,2201,1963,3767,10402,5
peaks,1184,2863,1959,628,3767,10401,5
warty,596,4103,2201,1385,2116,10401,5
caged,1512,4103,616,3252,917,10400,5
pends,1184,2863,1757,829,3767,10400,5
sured,2206,1824,2201,3252,917,10400,5
capel,1512,4103,560,3252,971,10398,5
boled,1555,3069,1603,3252,917,10396,5
ditas,1128,2239,1048,2214,3767,10396,5
doner,1128,3069,1757,3252,1190,10396,5
gamer,965,4103,885,3252,1190,10395,5
pouts,1184,3069,990,1385,3767,10395,5
serai,2206,2863,2201,2214,910,10394,5
bigas,1555,2239,616,2214,3767,10391,5
birks,1555,2239,2201,628,3767,10390,5
devas,1128,2863,417,2214,3767,10389,5
pongs,1184,3069,1757,612,3767,10389,5
dials,1128,2239,1959,1295,3767,10388,5
kirns,789,2239,2201,1391,3767,10387,5
laths,1046,4103,1048,423,3767,10387,5
mavie,1225,4103,417,1963,2679,10387,5
lacet,1046,4103,701,3252,1284,10386,5
lorne,1046,3069,2201,1391,2679,10386,5
peags,1184,2863,1959,612,3767,10385,5
sably,2206,4103,664,1295,2116,10384,5
packs,1184,4103,701,628,3767,10383,5
carot,1512,4103,2201,1282,1284,10382,5
sober,2206,3069,664,3252,1190,10381,5
vinas,404,2239,1757,2214,3767,10381,5
toler,1264,3069,1603,3252,1190,10378,5
veats,404,2863,1959,1385,3767,10378,5
dukes,1128,1824,406,3252,3767,10377,5
cefis,1512,2863,271,1963,3767,10376,5
cosen,1512,3069,1021,3252,1522,10376,5
mange,1225,4103,1757,612,2679,10376,5
monia,1225,3069,1757,1963,2362,10376,5
nemas,647,2863,885,2214,3767,10376,5
gabie,965,4103,664,1963,2679,10374,5
biens,1555,2239,1421,1391,3767,10373,5
gulas,965,1824,1603,2214,3767,10373,5
mints,1225,2239,1757,1385,3767,10373,5
berna,1555,2863,2201,1391,2362,10372,5
paste,1184,4103,1021,1385,2679,10372,5
garbe,965,4103,2201,423,2679,10371,5
saify,2206,4103,1668,278,2116,10371,5
chris,1512,927,2201,1963,3767,10370,5
hafts,844,4103,271,1385,3767,10370,5
seary,2206,2863,1959,1225,2116,10369,5
taper,1264,4103,560,3252,1190,10369,5
jibes,446,2239,664,3252,3767,10368,5
heirs,844,2863,1668,1225,3767,10367,5
arney,1698,1543,1757,3252,2116,10366,5
berta,1555,2863,2201,1385,2362,10366,5
covey,1512,3069,417,3252,2116,10366,5
lated,1046,4103,1048,3252,917,10366,5
reads,948,2863,1959,829,3767,10366,5
aurie,1698,1824,2201,1963,2679,10365,5
caphs,1512,4103,560,423,3767,10365,5
lader,1046,4103,774,3252,1190,10365,5
tobey,1264,3069,664,3252,2116,10365,5
vices,404,2239,701,3252,3767,10363,5
dynes,1128,458,1757,3252,3767,10362,5
airel,1698,2239,2201,3252,971,10361,5
ainus,1698,2239,1757,899,3767,10360,5
bandy,1555,4103,1757,829,2116,10360,5
drais,1128,1543,1959,1963,3767,10360,5
comae,1512,3069,885,2214,2679,10359,5
jorie,446,3069,2201,1963,2679,10358,5
tawie,1264,4103,349,1963,2679,10358,5
boite,1555,3069,1668,1385,2679,10356,5
carby,1512,4103,2201,423,2116,10355,5
cokey,1512,3069,406,3252,2116,10355,5
kaser,789,4103,1021,3252,1190,10355,5
lance,1046,4103,1757,770,2679,10355,5
roams,948,3069,1959,612,3767,10355,5
buren,1555,1824,2201,3252,1522,10354,5
dawen,1128,4103,349,3252,1522,10354,5
sapin,2206,4103,560,1963,1522,10354,5
soily,2206,3069,1668,1295,2116,10354,5
coled,1512,3069,1603,3252,917,10353,5
repas,948,2863,560,2214,3767,10352,5
belay,1555,2863,1603,2214,2116,10351,5
sacry,2206,4103,701,1225,2116,10351,5
mario,1225,4103,2201,1963,857,10349,5
haole,844,4103,1426,1295,2679,10347,5
samir,2206,4103,885,1963,1190,10347,5
wocas,596,3069,701,2214,3767,10347,5
belia,1555,2863,1603,1963,2362,10346,5
mouls,1225,3069,990,1295,3767,10346,5
pager,1184,4103,616,3252,1190,10345,5
bagne,1555,4103,616,1391,2679,10344,5
caped,1512,4103,560,3252,917,10344,5
janys,446,4103,1757,271,3767,10344,5
jasen,446,4103,1021,3252,1522,10344,5
raise,948,4103,1668,945,2679,10343,5
dalny,1128,4103,1603,1391,2116,10341,5
joins,446,3069,1668,1391,3767,10341,5
koels,789,3069,1421,1295,3767,10341,5
pulis,1184,1824,1603,1963,3767,10341,5
fagen,847,4103,616,3252,1522,10340,5
forel,847,3069,2201,3252,971,10340,5
laven,1046,4103,417,3252,1522,10340,5
lased,1046,4103,1021,3252,917,10339,5
moler,1225,3069,1603,3252,1190,10339,5
diley,1128,2239,1603,3252,2116,10338,5
hagen,844,4103,616,3252,1522,10337,5
jutes,446,1824,1048,3252,3767,10337,5
honus,844,3069,1757,899,3767,10336,5
cions,1512,2239,1426,1391,3767,10335,5
dongs,1128,3069,1757,612,3767,10333,5
maron,1225,4103,2201,1282,1522,10333,5
soger,2206,3069,616,3252,1190,10333,5
manit,1225,4103,1757,1963,1284,10332,5
pints,1184,2239,1757,1385,3767,10332,5
batse,1555,4103,1048,945,2679,10330,5
maloy,1225,4103,1603,1282,2116,10329,5
hanse,844,4103,1757,945,2679,10328,5
alves,1698,1193,417,3252,3767,10327,5
lamps,1046,4103,885,526,3767,10327,5
borty,1555,3069,2201,1385,2116,10326,5
hoers,844,3069,1421,1225,3767,10326,5
vibes,404,2239,664,3252,3767,10326,5
madel,1225,4103,774,3252,971,10325,5
narew,647,4103,2201,3252,122,10325,5
jakey,446,4103,406,3252,2116,10323,5
sunet,2206,1824,1757,3252,1284,10323,5
kayos,789,4103,381,1282,3767,10322,5
ratel,948,4103,1048,3252,971,10322,5
drias,1128,1543,1668,2214,3767,10320,5
darcy,1128,4103,2201,770,2116,10318,5
laity,1046,4103,1668,1385,2116,10318,5
candy,1512,4103,1757,829,2116,10317,5
alkes,1698,1193,406,3252,3767,10316,5
tours,1264,3069,990,1225,3767,10315,5
litas,1046,2239,1048,2214,3767,10314,5
loner,1046,3069,1757,3252,1190,10314,5
kamet,789,4103,885,3252,1284,10313,5
nogas,647,3069,616,2214,3767,10313,5
keirs,789,2863,1668,1225,3767,10312,5
durns,1128,1824,2201,1391,3767,10311,5
warly,596,4103,2201,1295,2116,10311,5
daily,1128,4103,1668,1295,2116,10310,5
ranty,948,4103,1757,1385,2116,10309,5
santo,2206,4103,1757,1385,857,10308,5
aired,1698,2239,2201,3252,917,10307,5
forbs,847,3069,2201,423,3767,10307,5
hobis,844,3069,664,1963,3767,10307,5
nerds,647,2863,2201,829,3767,10307,5
myles,1225,458,1603,3252,3767,10305,5
celia,1512,2863,1603,1963,2362,10303,5
filea,847,2239,1603,3252,2362,10303,5
cowey,1512,3069,349,3252,2116,10298,5
poler,1184,3069,1603,3252,1190,10298,5
norms,647,3069,2201,612,3767,10296,5
danke,1128,4103,1757,628,2679,10295,5
lardy,1046,4103,2201,829,2116,10295,5
coifs,1512,3069,1668,278,3767,10294,5
cadre,1512,4103,774,1225,2679,10293,5
facie,847,4103,701,1963,2679,10293,5
lacer,1046,4103,701,3252,1190,10292,5
paron,1184,4103,2201,1282,1522,10292,5
bolte,1555,3069,1603,1385,2679,10291,5
daune,1128,4103,990,1391,2679,10291,5
davie,1128,4103,417,1963,2679,10290,5
corny,1512,3069,2201,1391,2116,10289,5
pimas,1184,2239,885,2214,3767,10289,5
zeros,176,2863,2201,1282,3767,10289,5
bunts,1555,1824,1757,1385,3767,10288,5
larve,1046,4103,2201,259,2679,10288,5
veals,404,2863,1959,1295,3767,10288,5
herms,844,2863,2201,612,3767,10287,5
jaine,446,4103,1668,1391,2679,10287,5
melds,1225,2863,1603,829,3767,10287,5
salvy,2206,4103,1603,259,2116,10287,5
gated,965,4103,1048,3252,917,10285,5
gader,965,4103,774,3252,1190,10284,5
corty,1512,3069,2201,1385,2116,10283,5
solar,2206,3069,1603,2214,1190,10282,5
salim,2206,4103,1603,1963,406,10281,5
donia,1128,3069,1757,1963,2362,10279,5
lajos,1046,4103,81,1282,3767,10279,5
texas,1264,2863,170,2214,3767,10278,5
habus,844,4103,664,899,3767,10277,5
soper,2206,3069,560,3252,1190,10277,5
tuxes,1264,1824,170,3252,3767,10277,5
dints,1128,2239,1757,1385,3767,10276,5
fixes,847,2239,170,3252,3767,10275,5
hoyas,844,3069,381,2214,3767,10275,5
gance,965,4103,1757,770,2679,10274,5
hamer,844,4103,885,3252,1190,10274,5
monel,1225,3069,1757,3252,971,10274,5
tevis,1264,2863,417,1963,3767,10274,5
lawen,1046,4103,349,3252,1522,10272,5
purls,1184,1824,2201,1295,3767,10271,5
wives,596,2239,417,3252,3767,10271,5
jolts,446,3069,1603,1385,3767,10270,5
minos,1225,2239,1757,1282,3767,10270,5
toran,1264,3069,2201,2214,1522,10270,5
fonds,847,3069,1757,829,3767,10269,5
marje,1225,4103,2201,61,2679,10269,5
rated,948,4103,1048,3252,917,10268,5
corin,1512,3069,2201,1963,1522,10267,5
nudes,647,1824,774,3252,3767,10264,5
palew,1184,4103,1603,3252,122,10264,5
sabme,2206,4103,664,612,2679,10264,5
leaks,1046,2863,1959,628,3767,10263,5
heads,844,2863,1959,829,3767,10262,5
lends,1046,2863,1757,829,3767,10262,5
works,596,3069,2201,628,3767,10261,5
varec,404,4103,2201,3252,300,10260,5
gaven,965,4103,417,3252,1522,10259,5
toned,1264,3069,1757,3252,917,10259,5
jarde,446,4103,2201,829,2679,10258,5
tachs,1264,4103,701,423,3767,10258,5
louts,1046,3069,990,1385,3767,10257,5
margy,1225,4103,2201,612,2116,10257,5
rance,948,4103,1757,770,2679,10257,5
cavel,1512,4103,417,3252,971,10255,5
fulas,847,1824,1603,2214,3767,10255,5
legis,1046,2863,616,1963,3767,10255,5
foams,847,3069,1959,612,3767,10254,5
tabel,1264,4103,664,3252,971,10254,5
barfy,1555,4103,2201,278,2116,10253,5
cable,1512,4103,664,1295,2679,10253,5
canid,1512,4103,1757,1963,917,10252,5
dario,1128,4103,2201,1963,857,10252,5
hulas,844,1824,1603,2214,3767,10252,5
genus,965,2863,1757,899,3767,10251,5
longs,1046,3069,1757,612,3767,10251,5
paule,1184,4103,990,1295,2679,10251,5
tadeo,1264,4103,774,3252,857,10250,5
wamus,596,4103,885,899,3767,10250,5
bagle,1555,4103,616,1295,2679,10248,5
morna,1225,3069,2201,1391,2362,10248,5
kosey,789,3069,1021,3252,2116,10247,5
gamps,965,4103,885,526,3767,10246,5
paige,1184,4103,1668,612,2679,10246,5
cunts,1512,1824,1757,1385,3767,10245,5
lacks,1046,4103,701,628,3767,10245,5
worms,596,3069,2201,612,3767,10245,5
cosie,1512,3069,1021,1963,2679,10244,5
narev,647,4103,2201,3252,41,10244,5
morta,1225,3069,2201,1385,2362,10242,5
noria,647,3069,2201,1963,2362,10242,5
raven,948,4103,417,3252,1522,10242,5
rased,948,4103,1021,3252,917,10241,5
dairy,1128,4103,1668,1225,2116,10240,5
furey,847,1824,2201,3252,2116,10240,5
neils,647,2863,1668,1295,3767,10240,5
haise,844,4103,1668,945,2679,10239,5
soule,2206,3069,990,1295,2679,10239,5
seity,2206,2863,1668,1385,2116,10238,5
pogey,1184,3069,616,3252,2116,10237,5
sauve,2206,4103,990,259,2679,10237,5
daron,1128,4103,2201,1282,1522,10236,5
feria,847,2863,2201,1963,2362,10236,5
liars,1046,2239,1959,1225,3767,10236,5
danit,1128,4103,1757,1963,1284,10235,5
kacie,789,4103,701,1963,2679,10235,5
pours,1184,3069,990,1225,3767,10235,5
baked,1555,4103,406,3252,917,10233,5
golds,965,3069,1603,829,3767,10233,5
goner,965,3069,1757,3252,1190,10233,5
fagus,847,4103,616,899,3767,10232,5
parky,1184,4103,2201,628,2116,10232,5
moran,1225,3069,2201,2214,1522,10231,5
larid,1046,4103,2201,1963,917,10230,5
somne,2206,3069,885,1391,2679,10230,5
cause,1512,4103,990,945,2679,10229,5
ramps,948,4103,885,526,3767,10229,5
vodas,404,3069,774,2214,3767,10228,5
volts,404,3069,1603,1385,3767,10228,5
vilas,404,2239,1603,2214,3767,10227,5
doane,1128,3069,1959,1391,2679,10226,5
rainy,948,4103,1668,1391,2116,10226,5
taver,1264,4103,417,3252,1190,10226,5
lambs,1046,4103,885,423,3767,10224,5
ganef,965,4103,1757,3252,145,10222,5
maure,1225,4103,990,1225,2679,10222,5
mopey,1225,3069,560,3252,2116,10222,5
vatus,404,4103,1048,899,3767,10221,5
woads,596,3069,1959,829,3767,10220,5
macbs,1225,4103,701,423,3767,10219,5
machs,1225,4103,701,423,3767,10219,5
midas,1225,2239,774,2214,3767,10219,5
milts,1225,2239,1603,1385,3767,10219,5
saito,2206,4103,1668,1385,857,10219,5
hatel,844,4103,1048,3252,971,10218,5
brans,1555,1543,1959,1391,3767,10215,5
mabel,1225,4103,664,3252,971,10215,5
taker,1264,4103,406,3252,1190,10215,5
gardy,965,4103,2201,829,2116,10214,5
troas,1264,1543,1426,2214,3767,10214,5
welts,596,2863,1603,1385,3767,10214,5
capys,1512,4103,560,271,3767,10213,5
arley,1698,1543,1603,3252,2116,10212,5
crois,1512,1543,1426,1963,3767,10211,5
savin,2206,4103,417,1963,1522,10211,5
brats,1555,1543,1959,1385,3767,10209,5
tenia,1264,2863,1757,1963,2362,10209,5
treas,1264,1543,1421,2214,3767,10209,5
bayed,1555,4103,381,3252,917,10208,5
hiney,844,2239,1757,3252,2116,10208,5
rials,948,2239,1959,1295,3767,10208,5
biers,1555,2239,1421,1225,3767,10207,5
lager,1046,4103,616,3252,1190,10207,5
baldy,1555,4103,1603,829,2116,10206,5
tagel,1264,4103,616,3252,971,10206,5
cagle,1512,4103,616,1295,2679,10205,5
yeans,225,2863,1959,1391,3767,10205,5
hopis,844,3069,560,1963,3767,10203,5
lamed,1046,4103,885,3252,917,10203,5
taxus,1264,4103,170,899,3767,10203,5
duros,1128,1824,2201,1282,3767,10202,5
caved,1512,4103,417,3252,917,10201,5
juris,446,1824,2201,1963,3767,10201,5
porta,1184,3069,2201,1385,2362,10201,5
yeats,225,2863,1959,1385,3767,10199,5
noels,647,3069,1421,1295,3767,10199,5
maced,1225,4103,701,3252,917,10198,5
fiats,847,2239,1959,1385,3767,10197,5
lakie,1046,4103,406,1963,2679,10197,5
lange,1046,4103,1757,612,2679,10197,5
sardo,2206,4103,2201,829,857,10196,5
lints,1046,2239,1757,1385,3767,10194,5
lowis,1046,3069,349,1963,3767,10194,5
corly,1512,3069,2201,1295,2116,10193,5
baize,1555,4103,1668,186,2679,10191,5
carvy,1512,4103,2201,259,2116,10191,5
gawen,965,4103,349,3252,1522,10191,5
caked,1512,4103,406,3252,917,10190,5
tayer,1264,4103,381,3252,1190,10190,5
water,596,4103,1048,3252,1190,10189,5
sofie,2206,3069,271,1963,2679,10188,5
facet,847,4103,701,3252,1284,10187,5
mazie,1225,4103,217,1963,2679,10187,5
sadhe,2206,4103,774,423,2679,10185,5
saucy,2206,4103,990,770,2116,10185,5
tansy,1264,4103,1757,945,2116,10185,5
horne,844,3069,2201,1391,2679,10184,5
cabre,1512,4103,664,1225,2679,10183,5
bajer,1555,4103,81,3252,1190,10181,5
dogey,1128,3069,616,3252,2116,10181,5
forte,847,3069,2201,1385,2679,10181,5
meous,1225,2863,1426,899,3767,10180,5
curie,1512,1824,2201,1963,2679,10179,5
bagre,1555,4103,616,1225,2679,10178,5
strey,2206,403,2201,3252,2116,10178,5
burds,1555,1824,2201,829,3767,10176,5
darky,1128,4103,2201,628,2116,10176,5
godey,965,3069,774,3252,2116,10176,5
gouts,965,3069,990,1385,3767,10176,5
maker,1225,4103,406,3252,1190,10176,5
vents,404,2863,1757,1385,3767,10176,5
salic,2206,4103,1603,1963,300,10175,5
aulos,1698,1824,1603,1282,3767,10174,5
halse,844,4103,1603,945,2679,10174,5
kagus,789,4103,616,899,3767,10174,5
dinos,1128,2239,1757,1282,3767,10173,5
golet,965,3069,1603,3252,1284,10173,5
boden,1555,3069,774,3252,1522,10172,5
soave,2206,3069,1959,259,2679,10172,5
ronks,948,3069,1757,628,3767,10169,5
fated,847,4103,1048,3252,917,10167,5
glues,965,1193,990,3252,3767,10167,5
magel,1225,4103,616,3252,971,10167,5
cozey,1512,3069,217,3252,2116,10166,5
fader,847,4103,774,3252,1190,10166,5
homey,844,3069,885,3252,2116,10166,5
reaks,948,2863,1959,628,3767,10165,5
sawny,2206,4103,349,1391,2116,10165,5
basin,1555,4103,1021,1963,1522,10164,5
hated,844,4103,1048,3252,917,10164,5
rends,948,2863,1757,829,3767,10164,5
andes,1698,671,774,3252,3767,10162,5
sobel,2206,3069,664,3252,971,10162,5
folie,847,3069,1603,1963,2679,10161,5
leaps,1046,2863,1959,526,3767,10161,5
maely,1225,4103,1421,1295,2116,10160,5
banky,1555,4103,1757,628,2116,10159,5
routs,948,3069,990,1385,3767,10159,5
funis,847,1824,1757,1963,3767,10158,5
lairy,1046,4103,1668,1225,2116,10158,5
riley,948,2239,1603,3252,2116,10158,5
tawer,1264,4103,349,3252,1190,10158,5
torse,1264,3069,2201,945,2679,10158,5
kande,789,4103,1757,829,2679,10157,5
paced,1184,4103,701,3252,917,10157,5
regis,948,2863,616,1963,3767,10157,5
calve,1512,4103,1603,259,2679,10156,5
laron,1046,4103,2201,1282,1522,10154,5
salto,2206,4103,1603,1385,857,10154,5
coire,1512,3069,1668,1225,2679,10153,5
hance,844,4103,1757,770,2679,10153,5
limas,1046,2239,885,2214,3767,10151,5
mayer,1225,4103,381,3252,1190,10151,5
bouet,1555,3069,990,3252,1284,10150,5
nirls,647,2239,2201,1295,3767,10149,5
reams,948,2863,1959,612,3767,10149,5
kopis,789,3069,560,1963,3767,10148,5
binds,1555,2239,1757,829,3767,10147,5
gaily,965,4103,1668,1295,2116,10147,5
habet,844,4103,664,3252,1284,10147,5
knies,789,671,1668,3252,3767,10147,5
racks,948,4103,701,628,3767,10147,5
micas,1225,2239,701,2214,3767,10146,5
paver,1184,4103,417,3252,1190,10146,5
petos,1184,2863,1048,1282,3767,10144,5
bangy,1555,4103,1757,612,2116,10143,5
gambs,965,4103,885,423,3767,10143,5
gurts,965,1824,2201,1385,3767,10142,5
duxes,1128,1824,170,3252,3767,10141,5
maxie,1225,4103,170,1963,2679,10140,5
sayce,2206,4103,381,770,2679,10139,5
coset,1512,3069,1021,3252,1284,10138,5
haven,844,4103,417,3252,1522,10138,5
maceo,1225,4103,701,3252,857,10138,5
meigs,1225,2863,1668,612,3767,10135,5
doran,1128,3069,2201,2214,1522,10134,5
jazey,446,4103,217,3252,2116,10134,5
proas,1184,1543,1426,2214,3767,10134,5
verus,404,2863,2201,899,3767,10134,5
cawed,1512,4103,349,3252,917,10133,5
curds,1512,1824,2201,829,3767,10133,5
comus,1512,3069,885,899,3767,10132,5
jareb,446,4103,2201,3252,129,10131,5
coden,1512,3069,774,3252,1522,10129,5
chais,1512,927,1959,1963,3767,10128,5
iamus,473,4103,885,899,3767,10127,5
rotls,948,3069,1048,1295,3767,10127,5
berny,1555,2863,2201,1391,2116,10126,5
sabir,2206,4103,664,1963,1190,10126,5
dolia,1128,3069,1603,1963,2362,10125,5
dopey,1128,3069,560,3252,2116,10125,5
oater,532,4103,1048,3252,1190,10125,5
wifes,596,2239,271,3252,3767,10125,5
savoy,2206,4103,417,1282,2116,10124,5
teays,1264,2863,1959,271,3767,10124,5
baric,1555,4103,2201,1963,300,10122,5
dachs,1128,4103,701,423,3767,10122,5
gamed,965,4103,885,3252,917,10122,5
wafts,596,4103,271,1385,3767,10122,5
jives,446,2239,417,3252,3767,10121,5
berty,1555,2863,2201,1385,2116,10120,5
sanct,2206,4103,1757,770,1284,10120,5
coxey,1512,3069,170,3252,2116,10119,5
loafs,1046,3069,1959,278,3767,10119,5
morse,1225,3069,2201,945,2679,10119,5
weirs,596,2863,1668,1225,3767,10119,5
ganev,965,4103,1757,3252,41,10118,5
tovey,1264,3069,417,3252,2116,10118,5
berat,1555,2863,2201,2214,1284,10117,5
sunay,2206,1824,1757,2214,2116,10117,5
buret,1555,1824,2201,3252,1284,10116,5
gonia,965,3069,1757,1963,2362,10116,5
milos,1225,2239,1603,1282,3767,10116,5
sapit,2206,4103,560,1963,1284,10116,5
folds,847,3069,1603,829,3767,10115,5
monte,1225,3069,1757,1385,2679,10115,5
cutis,1512,1824,1048,1963,3767,10114,5
leics,1046,2863,1668,770,3767,10114,5
minae,1225,2239,1757,2214,2679,10114,5
novas,647,3069,417,2214,3767,10114,5
maged,1225,4103,616,3252,917,10113,5
holds,844,3069,1603,829,3767,10112,5
honer,844,3069,1757,3252,1190,10112,5
mapel,1225,4103,560,3252,971,10111,5
nobis,647,3069,664,1963,3767,10110,5
payer,1184,4103,381,3252,1190,10110,5
nosey,647,3069,1021,3252,2116,10105,5
pansy,1184,4103,1757,945,2116,10105,5
picas,1184,2239,701,2214,3767,10105,5
ramed,948,4103,885,3252,917,10105,5
toled,1264,3069,1603,3252,917,10105,5
maher,1225,4103,334,3252,1190,10104,5
barto,1555,4103,2201,1385,857,10101,5
cangy,1512,4103,1757,612,2116,10100,5
zante,176,4103,1757,1385,2679,10100,5
range,948,4103,1757,612,2679,10099,5
tirks,1264,2239,2201,628,3767,10099,5
calid,1512,4103,1603,1963,917,10098,5
herbs,844,2863,2201,423,3767,10098,5
lours,1046,3069,990,1225,3767,10097,5
sorva,2206,3069,2201,259,2362,10097,5
taped,1264,4103,560,3252,917,10096,5
larky,1046,4103,2201,628,2116,10094,5
facer,847,4103,701,3252,1190,10093,5
hardy,844,4103,2201,829,2116,10093,5
veins,404,2863,1668,1391,3767,10093,5
criey,1512,1543,1668,3252,2116,10091,5
cults,1512,1824,1603,1385,3767,10091,5
linos,1046,2239,1757,1282,3767,10091,5
damle,1128,4103,885,1295,2679,10090,5
daver,1128,4103,417,3252,1190,10090,5
serio,2206,2863,2201,1963,857,10090,5
cetus,1512,2863,1048,899,3767,10089,5
corke,1512,3069,2201,628,2679,10089,5
chias,1512,927,1668,2214,3767,10088,5
binet,1555,2239,1757,3252,1284,10087,5
boser,1555,3069,1021,3252,1190,10087,5
harve,844,4103,2201,259,2679,10086,5
wiros,596,2239,2201,1282,3767,10085,5
wauks,596,4103,990,628,3767,10084,5
seora,2206,2863,1426,1225,2362,10082,5
tiens,1264,2239,1421,1391,3767,10082,5
terna,1264,2863,2201,1391,2362,10081,5
bytes,1555,458,1048,3252,3767,10080,5
daker,1128,4103,406,3252,1190,10079,5
rojas,948,3069,81,2214,3767,10079,5
vaire,404,4103,1668,1225,2679,10079,5
denay,1128,2863,1757,2214,2116,10078,5
hynes,844,458,1757,3252,3767,10078,5
largy,1046,4103,2201,612,2116,10078,5
mnras,1225,671,2201,2214,3767,10078,5
pawer,1184,4103,349,3252,1190,10078,5
certy,1512,2863,2201,1385,2116,10077,5
namer,647,4103,885,3252,1190,10077,5
jamie,446,4103,885,1963,2679,10076,5
nixes,647,2239,170,3252,3767,10075,5
pilos,1184,2239,1603,1282,3767,10075,5
cerat,1512,2863,2201,2214,1284,10074,5
seron,2206,2863,2201,1282,1522,10074,5
bairn,1555,4103,1668,1225,1522,10073,5
corge,1512,3069,2201,612,2679,10073,5
curet,1512,1824,2201,3252,1284,10073,5
garon,965,4103,2201,1282,1522,10073,5
senit,2206,2863,1757,1963,1284,10073,5
mawks,1225,4103,349,628,3767,10072,5
paged,1184,4103,616,3252,917,10072,5
wizes,596,2239,217,3252,3767,10071,5
gaper,965,4103,560,3252,1190,10070,5
carol,1512,4103,2201,1282,971,10069,5
lorna,1046,3069,2201,1391,2362,10069,5
tandy,1264,4103,1757,829,2116,10069,5
kioea,789,2239,1426,3252,2362,10068,5
zetas,176,2863,1048,2214,3767,10068,5
sower,2206,3069,349,3252,1190,10066,5
balon,1555,4103,1603,1282,1522,10065,5
birne,1555,2239,2201,1391,2679,10065,5
honks,844,3069,1757,628,3767,10065,5
duats,1128,1824,1959,1385,3767,10063,5
fends,847,2863,1757,829,3767,10063,5
reaps,948,2863,1959,526,3767,10063,5
cerin,1512,2863,2201,1963,1522,10061,5
janek,446,4103,1757,3252,502,10060,5
mirks,1225,2239,2201,628,3767,10060,5
zeals,176,2863,1959,1295,3767,10060,5
luxes,1046,1824,170,3252,3767,10059,5
hiren,844,2239,2201,3252,1522,10058,5
koner,789,3069,1757,3252,1190,10057,5
faber,847,4103,664,3252,1190,10056,5
levis,1046,2863,417,1963,3767,10056,5
hamel,844,4103,885,3252,971,10055,5
ranit,948,4103,1757,1963,1284,10055,5
telia,1264,2863,1603,1963,2362,10055,5
vaden,404,4103,774,3252,1522,10055,5
haber,844,4103,664,3252,1190,10053,5
poems,1184,3069,1421,612,3767,10053,5
rimas,948,2239,885,2214,3767,10053,5
loran,1046,3069,2201,2214,1522,10052,5
wokas,596,3069,406,2214,3767,10052,5
baroi,1555,4103,2201,1282,910,10051,5
dansy,1128,4103,1757,945,2116,10049,5
flues,847,1193,990,3252,3767,10049,5
hongs,844,3069,1757,612,3767,10049,5
posen,1184,3069,1021,3252,1522,10048,5
alois,1698,1193,1426,1963,3767,10047,5
facks,847,4103,701,628,3767,10046,5
roane,948,3069,1959,1391,2679,10046,5
hacks,844,4103,701,628,3767,10043,5
yipes,225,2239,560,3252,3767,10043,5
kerbs,789,2863,2201,423,3767,10043,5
laure,1046,4103,990,1225,2679,10043,5
miens,1225,2239,1421,1391,3767,10043,5
merna,1225,2863,2201,1391,2362,10042,5
sirex,2206,2239,2201,3252,144,10042,5
butea,1555,1824,1048,3252,2362,10041,5
dalpe,1128,4103,1603,526,2679,10039,5
years,225,2863,1959,1225,3767,10039,5
calio,1512,4103,1603,1963,857,10038,5
farcy,847,4103,2201,770,2116,10037,5
fiars,847,2239,1959,1225,3767,10037,5
merta,1225,2863,2201,1385,2362,10036,5
bowls,1555,3069,349,1295,3767,10035,5
padle,1184,4103,774,1295,2679,10035,5
favus,847,4103,417,899,3767,10033,5
sadye,2206,4103,774,271,2679,10033,5
haste,844,4103,1021,1385,2679,10032,5
cairn,1512,4103,1668,1225,1522,10030,5
mandy,1225,4103,1757,829,2116,10030,5
gelds,965,2863,1603,829,3767,10027,5
karil,789,4103,2201,1963,971,10027,5
pokey,1184,3069,406,3252,2116,10027,5
haily,844,4103,1668,1295,2116,10026,5
poled,1184,3069,1603,3252,917,10025,5
dorse,1128,3069,2201,945,2679,10022,5
sapir,2206,4103,560,1963,1190,10022,5
vedas,404,2863,774,2214,3767,10022,5
carli,1512,4103,2201,1295,910,10021,5
hurts,844,1824,2201,1385,3767,10021,5
muley,1225,1824,1603,3252,2116,10020,5
coben,1512,3069,664,3252,1522,10019,5
dilos,1128,2239,1603,1282,3767,10019,5
laced,1046,4103,701,3252,917,10019,5
salix,2206,4103,1603,1963,144,10019,5
torin,1264,3069,2201,1963,1522,10019,5
borda,1555,3069,2201,829,2362,10016,5
melia,1225,2863,1603,1963,2362,10016,5
saith,2206,4103,1668,1385,654,10016,5
vinea,404,2239,1757,3252,2362,10014,5
bayle,1555,4103,381,1295,2679,10013,5
harze,844,4103,2201,186,2679,10013,5
selry,2206,2863,1603,1225,2116,10013,5
senal,2206,2863,1757,2214,971,10011,5
boral,1555,3069,2201,2214,971,10010,5
fager,847,4103,616,3252,1190,10008,5
laver,1046,4103,417,3252,1190,10008,5
pions,1184,2239,1426,1391,3767,10007,5
tavel,1264,4103,417,3252,971,10007,5
madre,1225,4103,774,1225,2679,10006,5
balky,1555,4103,1603,628,2116,10005,5
hager,844,4103,616,3252,1190,10005,5
table,1264,4103,664,1295,2679,10005,5
famed,847,4103,885,3252,917,10004,5
faute,847,4103,990,1385,2679,10004,5
jakos,446,4103,406,1282,3767,10004,5
macle,1225,4103,701,1295,2679,10003,5
comet,1512,3069,885,3252,1284,10002,5
girds,965,2239,2201,829,3767,10001,5
haute,844,4103,990,1385,2679,10001,5
kamel,789,4103,885,3252,971,10000,5
kouts,789,3069,990,1385,3767,10000,5
kiley,789,2239,1603,3252,2116,9999,5
codie,1512,3069,774,1963,2679,9997,5
laker,1046,4103,406,3252,1190,9997,5
ronel,948,3069,1757,3252,971,9997,5
veils,404,2863,1668,1295,3767,9997,5
morty,1225,3069,2201,1385,2116,9996,5
hange,844,4103,1757,612,2679,9995,5
morat,1225,3069,2201,2214,1284,9993,5
cowls,1512,3069,349,1295,3767,9992,5
defis,1128,2863,271,1963,3767,9992,5
hints,844,2239,1757,1385,3767,9992,5
poine,1184,3069,1668,1391,2679,9991,5
waise,596,4103,1668,945,2679,9991,5
balmy,1555,4103,1603,612,2116,9989,5
pandy,1184,4103,1757,829,2116,9989,5
lewis,1046,2863,349,1963,3767,9988,5
sofer,2206,3069,271,3252,1190,9988,5
yamen,225,4103,885,3252,1522,9987,5
mazer,1225,4103,217,3252,1190,9987,5
baske,1555,4103,1021,628,2679,9986,5
dovey,1128,3069,417,3252,2116,9982,5
cubas,1512,1824,664,2214,3767,9981,5
kalin,789,4103,1603,1963,1522,9980,5
morin,1225,3069,2201,1963,1522,9980,5
sargo,2206,4103,2201,612,857,9979,5
taxer,1264,4103,170,3252,1190,9979,5
soaky,2206,3069,1959,628,2116,9978,5
bugas,1555,1824,616,2214,3767,9976,5
dawks,1128,4103,349,628,3767,9975,5
toile,1264,3069,1668,1295,2679,9975,5
saunt,2206,4103,990,1391,1284,9974,5
duals,1128,1824,1959,1295,3767,9973,5
pagne,1184,4103,616,1391,2679,9973,5
layer,1046,4103,381,3252,1190,9972,5
arils,1698,1543,1668,1295,3767,9971,5
cogen,1512,3069,616,3252,1522,9971,5
darby,1128,4103,2201,423,2116,9971,5
fario,847,4103,2201,1963,857,9971,5
goran,965,3069,2201,2214,1522,9971,5
mancy,1225,4103,1757,770,2116,9971,5
birle,1555,2239,2201,1295,2679,9969,5
naxos,647,4103,170,1282,3767,9969,5
carlo,1512,4103,2201,1295,857,9968,5
fouls,847,3069,990,1295,3767,9968,5
coral,1512,3069,2201,2214,971,9967,5
potus,1184,3069,1048,899,3767,9967,5
mable,1225,4103,664,1295,2679,9966,5
nader,647,4103,774,3252,1190,9966,5
manid,1225,4103,1757,1963,917,9965,5
padre,1184,4103,774,1225,2679,9965,5
bolan,1555,3069,1603,2214,1522,9963,5
dirks,1128,2239,2201,628,3767,9963,5
foims,847,3069,1668,612,3767,9963,5
trois,1264,1543,1426,1963,3767,9963,5
gaure,965,4103,990,1225,2679,9962,5
nolie,647,3069,1603,1963,2679,9961,5
porny,1184,3069,2201,1391,2116,9961,5
daisy,1128,4103,1668,945,2116,9960,5
winey,596,2239,1757,3252,2116,9960,5
burgs,1555,1824,2201,612,3767,9959,5
fairy,847,4103,1668,1225,2116,9959,5
gilts,965,2239,1603,1385,3767,9959,5
heaps,844,2863,1959,526,3767,9959,5
holer,844,3069,1603,3252,1190,9958,5
wanty,596,4103,1757,1385,2116,9957,5
hairy,844,4103,1668,1225,2116,9956,5
gabel,965,4103,664,3252,971,9955,5
porty,1184,3069,2201,1385,2116,9955,5
fanit,847,4103,1757,1963,1284,9954,5
sepia,2206,2863,560,1963,2362,9954,5
bahoe,1555,4103,334,1282,2679,9953,5
jubes,446,1824,664,3252,3767,9953,5
parik,1184,4103,2201,1963,502,9953,5
coaly,1512,3069,1959,1295,2116,9951,5
palsy,1184,4103,1603,945,2116,9951,5
socle,2206,3069,701,1295,2679,9950,5
fovea,847,3069,417,3252,2362,9947,5
aurel,1698,1824,2201,3252,971,9946,5
calmy,1512,4103,1603,612,2116,9946,5
merla,1225,2863,2201,1295,2362,9946,5
derna,1128,2863,2201,1391,2362,9945,5
hobey,844,3069,664,3252,2116,9945,5
ropey,948,3069,560,3252,2116,9945,5
dahms,1128,4103,334,612,3767,9944,5
aoide,1698,3069,1668,829,2679,9943,5
wasel,596,4103,1021,3252,971,9943,5
kepis,789,2863,560,1963,3767,9942,5
taked,1264,4103,406,3252,917,9942,5
maidy,1225,4103,1668,829,2116,9941,5
acmes,1698,338,885,3252,3767,9940,5
diets,1128,2239,1421,1385,3767,9940,5
konia,789,3069,1757,1963,2362,9940,5
bauge,1555,4103,990,612,2679,9939,5
baume,1555,4103,990,612,2679,9939,5
hazen,844,4103,217,3252,1522,9938,5
tarim,1264,4103,2201,1963,406,9937,5
moile,1225,3069,1668,1295,2679,9936,5
molys,1225,3069,1603,271,3767,9935,5
twoes,1264,226,1426,3252,3767,9935,5
furls,847,1824,2201,1295,3767,9934,5
jauks,446,4103,990,628,3767,9934,5
sahme,2206,4103,334,612,2679,9934,5
hurls,844,1824,2201,1295,3767,9931,5
capek,1512,4103,560,3252,502,9929,5
pavel,1184,4103,417,3252,971,9927,5
demos,1128,2863,885,1282,3767,9925,5
brins,1555,1543,1668,1391,3767,9924,5
delay,1128,2863,1603,2214,2116,9924,5
trans,1264,1543,1959,1391,3767,9924,5
raced,948,4103,701,3252,917,9921,5
colan,1512,3069,1603,2214,1522,9920,5
delia,1128,2863,1603,1963,2362,9919,5
brits,1555,1543,1668,1385,3767,9918,5
soncy,2206,3069,1757,770,2116,9918,5
badin,1555,4103,774,1963,1522,9917,5
punts,1184,1824,1757,1385,3767,9917,5
boise,1555,3069,1668,945,2679,9916,5
tiers,1264,2239,1421,1225,3767,9916,5
copen,1512,3069,560,3252,1522,9915,5
wader,596,4103,774,3252,1190,9915,5
folks,847,3069,1603,628,3767,9914,5
yauds,225,4103,990,829,3767,9914,5
jonie,446,3069,1757,1963,2679,9914,5
leafs,1046,2863,1959,278,3767,9913,5
soble,2206,3069,664,1295,2679,9913,5
canby,1512,4103,1757,423,2116,9911,5
cobus,1512,3069,664,899,3767,9911,5
holks,844,3069,1603,628,3767,9911,5
saruk,2206,4103,2201,899,502,9911,5
genia,965,2863,1757,1963,2362,9910,5
carib,1512,4103,2201,1963,129,9908,5
comer,1512,3069,885,3252,1190,9908,5
fuzes,847,1824,217,3252,3767,9907,5
bogus,1555,3069,616,899,3767,9906,5
coila,1512,3069,1668,1295,2362,9906,5
guans,965,1824,1959,1391,3767,9906,5
morly,1225,3069,2201,1295,2116,9906,5
virls,404,2239,2201,1295,3767,9906,5
jerks,446,2863,2201,628,3767,9905,5
perla,1184,2863,2201,1295,2362,9905,5
blois,1555,1193,1426,1963,3767,9904,5
josey,446,3069,1021,3252,2116,9904,5
marvy,1225,4103,2201,259,2116,9904,5
pause,1184,4103,990,945,2679,9901,5
fogey,847,3069,616,3252,2116,9900,5
lovey,1046,3069,417,3252,2116,9900,5
dorty,1128,3069,2201,1385,2116,9899,5
barth,1555,4103,2201,1385,654,9898,5
fours,847,3069,990,1225,3767,9898,5
kerfs,789,2863,2201,278,3767,9898,5
renay,948,2863,1757,2214,2116,9898,5
karon,789,4103,2201,1282,1522,9897,5
nukes,647,1824,406,3252,3767,9896,5
botel,1555,3069,1048,3252,971,9895,5
holms,844,3069,1603,612,3767,9895,5
hours,844,3069,990,1225,3767,9895,5
faxen,847,4103,170,3252,1522,9894,5
polys,1184,3069,1603,271,3767,9894,5
lawks,1046,4103,349,628,3767,9893,5
sarpo,2206,4103,2201,526,857,9893,5
finos,847,2239,1757,1282,3767,9892,5
jacie,446,4103,701,1963,2679,9892,5
gayer,965,4103,381,3252,1190,9891,5
yogas,225,3069,616,2214,3767,9891,5
ogres,532,139,2201,3252,3767,9891,5
yorks,225,3069,2201,628,3767,9890,5
seram,2206,2863,2201,2214,406,9890,5
yikes,225,2239,406,3252,3767,9889,5
minus,1225,2239,1757,899,3767,9887,5
gansy,965,4103,1757,945,2116,9886,5
aurei,1698,1824,2201,3252,910,9885,5
tawed,1264,4103,349,3252,917,9885,5
turds,1264,1824,2201,829,3767,9885,5
beany,1555,2863,1959,1391,2116,9884,5
corbe,1512,3069,2201,423,2679,9884,5
dorin,1128,3069,2201,1963,1522,9883,5
bogie,1555,3069,616,1963,2679,9882,5
ligas,1046,2239,616,2214,3767,9882,5
takeo,1264,4103,406,3252,857,9882,5
thais,1264,927,1959,1963,3767,9880,5
farmy,847,4103,2201,612,2116,9879,5
waken,596,4103,406,3252,1522,9879,5
mayed,1225,4103,381,3252,917,9878,5
sault,2206,4103,990,1295,1284,9878,5
howea,844,3069,349,3252,2362,9876,5
kaleb,789,4103,1603,3252,129,9876,5
soapy,2206,3069,1959,526,2116,9876,5
cymes,1512,458,885,3252,3767,9874,5
dancy,1128,4103,1757,770,2116,9874,5
pumas,1184,1824,885,2214,3767,9874,5
burps,1555,1824,2201,526,3767,9873,5
oaths,532,4103,1048,423,3767,9873,5
paved,1184,4103,417,3252,917,9873,5
tired,1264,2239,2201,3252,917,9873,5
iowas,473,3069,349,2214,3767,9872,5
sofia,2206,3069,271,1963,2362,9871,5
toxey,1264,3069,170,3252,2116,9871,5
damek,1128,4103,885,3252,502,9870,5
lions,1046,2239,1426,1391,3767,9869,5
morez,1225,3069,2201,3252,122,9869,5
vobis,404,3069,664,1963,3767,9867,5
wanly,596,4103,1757,1295,2116,9867,5
berit,1555,2863,2201,1963,1284,9866,5
yetis,225,2863,1048,1963,3767,9866,5
moire,1225,3069,1668,1225,2679,9866,5
zeins,176,2863,1668,1391,3767,9865,5
coups,1512,3069,990,526,3767,9864,5
forta,847,3069,2201,1385,2362,9864,5
liens,1046,2239,1421,1391,3767,9864,5
vegas,404,2863,616,2214,3767,9864,5
wolds,596,3069,1603,829,3767,9864,5
lerna,1046,2863,2201,1391,2362,9863,5
selda,2206,2863,1603,829,2362,9863,5
curia,1512,1824,2201,1963,2362,9862,5
fenks,847,2863,1757,628,3767,9862,5
maple,1225,4103,560,1295,2679,9862,5
clois,1512,1193,1426,1963,3767,9861,5
dunts,1128,1824,1757,1385,3767,9861,5
horta,844,3069,2201,1385,2362,9861,5
maize,1225,4103,1668,186,2679,9861,5
matin,1225,4103,1048,1963,1522,9861,5
blats,1555,1193,1959,1385,3767,9859,5
gorse,965,3069,2201,945,2679,9859,5
reims,948,2863,1668,612,3767,9858,5
halke,844,4103,1603,628,2679,9857,5
kaule,789,4103,990,1295,2679,9856,5
diols,1128,2239,1426,1295,3767,9855,5
tangy,1264,4103,1757,612,2116,9852,5
landy,1046,4103,1757,829,2116,9851,5
waget,596,4103,616,3252,1284,9851,5
zaire,176,4103,1668,1225,2679,9851,5
diels,1128,2239,1421,1295,3767,9850,5
eulis,693,1824,1603,1963,3767,9850,5
horan,844,3069,2201,2214,1522,9850,5
masty,1225,4103,1021,1385,2116,9850,5
jupes,446,1824,560,3252,3767,9849,5
sowel,2206,3069,349,3252,971,9847,5
agues,1698,139,990,3252,3767,9846,5
conde,1512,3069,1757,829,2679,9846,5
mawed,1225,4103,349,3252,917,9846,5
pinus,1184,2239,1757,899,3767,9846,5
wekas,596,2863,406,2214,3767,9846,5
bacin,1555,4103,701,1963,1522,9844,5
faure,847,4103,990,1225,2679,9844,5
folia,847,3069,1603,1963,2362,9844,5
badly,1555,4103,774,1295,2116,9843,5
corsy,1512,3069,2201,945,2116,9843,5
togae,1264,3069,616,2214,2679,9842,5
holia,844,3069,1603,1963,2362,9841,5
boder,1555,3069,774,3252,1190,9840,5
towns,1264,3069,349,1391,3767,9840,5
cogie,1512,3069,616,1963,2679,9839,5
honed,844,3069,1757,3252,917,9839,5
hilts,844,2239,1603,1385,3767,9838,5
prats,1184,1543,1959,1385,3767,9838,5
warve,596,4103,2201,259,2679,9838,5
payed,1184,4103,381,3252,917,9837,5
yarke,225,4103,2201,628,2679,9836,5
piers,1184,2239,1421,1225,3767,9836,5
raged,948,4103,616,3252,917,9836,5
yawns,225,4103,349,1391,3767,9835,5
kinos,789,2239,1757,1282,3767,9834,5
mired,1225,2239,2201,3252,917,9834,5
basir,1555,4103,1021,1963,1190,9832,5
jaups,446,4103,990,526,3767,9832,5
bonce,1555,3069,1757,770,2679,9830,5
marni,1225,4103,2201,1391,910,9830,5
gonys,965,3069,1757,271,3767,9829,5
lotus,1046,3069,1048,899,3767,9829,5
manky,1225,4103,1757,628,2116,9829,5
naily,647,4103,1668,1295,2116,9829,5
maude,1225,4103,990,829,2679,9826,5
poire,1184,3069,1668,1225,2679,9825,5
marti,1225,4103,2201,1385,910,9824,5
clans,1512,1193,1959,1391,3767,9822,5
gazet,965,4103,217,3252,1284,9821,5
faced,847,4103,701,3252,917,9820,5
patin,1184,4103,1048,1963,1522,9820,5
bruis,1555,1543,990,1963,3767,9818,5
dumas,1128,1824,885,2214,3767,9818,5
minds,1225,2239,1757,829,3767,9817,5
wonks,596,3069,1757,628,3767,9817,5
solve,2206,3069,1603,259,2679,9816,5
brios,1555,1543,1668,1282,3767,9815,5
oaken,532,4103,406,3252,1522,9815,5
sarum,2206,4103,2201,899,406,9815,5
mangy,1225,4103,1757,612,2116,9813,5
ornas,532,1543,1757,2214,3767,9813,5
weaks,596,2863,1959,628,3767,9813,5
gawks,965,4103,349,628,3767,9812,5
rosen,948,3069,1021,3252,1522,9812,5
wends,596,2863,1757,829,3767,9812,5
pikas,1184,2239,406,2214,3767,9810,5
lexis,1046,2863,170,1963,3767,9809,5
pasty,1184,4103,1021,1385,2116,9809,5
bathe,1555,4103,1048,423,2679,9808,5
danio,1128,4103,1757,1963,857,9808,5
gokey,965,3069,406,3252,2116,9808,5
copus,1512,3069,560,899,3767,9807,5
debts,1128,2863,664,1385,3767,9807,5
glias,965,1193,1668,2214,3767,9807,5
janty,446,4103,1757,1385,2116,9807,5
wamel,596,4103,885,3252,971,9807,5
haver,844,4103,417,3252,1190,9806,5
wiley,596,2239,1603,3252,2116,9806,5
pawed,1184,4103,349,3252,917,9805,5
sandi,2206,4103,1757,829,910,9805,5
named,647,4103,885,3252,917,9804,5
sukey,2206,1824,406,3252,2116,9804,5
burel,1555,1824,2201,3252,971,9803,5
walty,596,4103,1603,1385,2116,9803,5
metus,1225,2863,1048,899,3767,9802,5
abris,1698,172,2201,1963,3767,9801,5
lorin,1046,3069,2201,1963,1522,9801,5
mebos,1225,2863,664,1282,3767,9801,5
coted,1512,3069,1048,3252,917,9798,5
faker,847,4103,406,3252,1190,9798,5
veray,404,2863,2201,2214,2116,9798,5
coder,1512,3069,774,3252,1190,9797,5
gaped,965,4103,560,3252,917,9797,5
pecos,1184,2863,701,1282,3767,9797,5
koran,789,3069,2201,2214,1522,9795,5
wacks,596,4103,701,628,3767,9795,5
sowed,2206,3069,349,3252,917,9793,5
bilks,1555,2239,1603,628,3767,9792,5
rokey,948,3069,406,3252,2116,9791,5
dinus,1128,2239,1757,899,3767,9790,5
harpy,844,4103,2201,526,2116,9790,5
talio,1264,4103,1603,1963,857,9790,5
kilns,789,2239,1603,1391,3767,9789,5
vagus,404,4103,616,899,3767,9789,5
merat,1225,2863,2201,2214,1284,9787,5
denys,1128,2863,1757,271,3767,9786,5
bonar,1555,3069,1757,2214,1190,9785,5
moter,1225,3069,1048,3252,1190,9784,5
serac,2206,2863,2201,2214,300,9784,5
waste,596,4103,1021,1385,2679,9784,5
kilts,789,2239,1603,1385,3767,9783,5
parti,1184,4103,2201,1385,910,9783,5
drats,1128,1543,1959,1385,3767,9782,5
tairn,1264,4103,1668,1225,1522,9782,5
ypres,225,336,2201,3252,3767,9781,5
rouen,948,3069,990,3252,1522,9781,5
buaer,1555,1824,1959,3252,1190,9780,5
raped,948,4103,560,3252,917,9780,5
kabel,789,4103,664,3252,971,9779,5
lunts,1046,1824,1757,1385,3767,9779,5
mayne,1225,4103,381,1391,2679,9779,5
pleas,1184,1193,1421,2214,3767,9779,5
waily,596,4103,1668,1295,2116,9778,5
boget,1555,3069,616,3252,1284,9776,5
gerta,965,2863,2201,1385,2362,9776,5
hoare,844,3069,1959,1225,2679,9776,5
talon,1264,4103,1603,1282,1522,9774,5
galbe,965,4103,1603,423,2679,9773,5
todus,1264,3069,774,899,3767,9773,5
coven,1512,3069,417,3252,1522,9772,5
duits,1128,1824,1668,1385,3767,9772,5
cosed,1512,3069,1021,3252,917,9771,5
horla,844,3069,2201,1295,2362,9771,5
vedis,404,2863,774,1963,3767,9771,5
bordy,1555,3069,2201,829,2116,9770,5
hayer,844,4103,381,3252,1190,9770,5
busey,1555,1824,1021,3252,2116,9768,5
mazel,1225,4103,217,3252,971,9768,5
suine,2206,1824,1668,1391,2679,9768,5
euros,693,1824,2201,1282,3767,9767,5
uvres,420,126,2201,3252,3767,9766,5
xerus,36,2863,2201,899,3767,9766,5
cathe,1512,4103,1048,423,2679,9765,5
divas,1128,2239,417,2214,3767,9765,5
riots,948,2239,1426,1385,3767,9765,5
cabin,1512,4103,664,1963,1522,9764,5
cadew,1512,4103,774,3252,122,9763,5
neaps,647,2863,1959,526,3767,9762,5
nefas,647,2863,271,2214,3767,9762,5
suite,2206,1824,1668,1385,2679,9762,5
ceral,1512,2863,2201,2214,971,9761,5
laxer,1046,4103,170,3252,1190,9761,5
aidos,1698,2239,774,1282,3767,9760,5
jolie,446,3069,1603,1963,2679,9760,5
songy,2206,3069,1757,612,2116,9760,5
comps,1512,3069,885,526,3767,9759,5
nairy,647,4103,1668,1225,2116,9759,5
solid,2206,3069,1603,1963,917,9758,5
moser,1225,3069,1021,3252,1190,9757,5
wager,596,4103,616,3252,1190,9757,5
coiny,1512,3069,1668,1391,2116,9756,5
seamy,2206,2863,1959,612,2116,9756,5
randy,948,4103,1757,829,2116,9753,5
cutey,1512,1824,1048,3252,2116,9752,5
naper,647,4103,560,3252,1190,9752,5
kaver,789,4103,417,3252,1190,9751,5
perty,1184,2863,2201,1385,2116,9749,5
sapid,2206,4103,560,1963,917,9749,5
domus,1128,3069,885,899,3767,9748,5
bowen,1555,3069,349,3252,1522,9747,5
louie,1046,3069,990,1963,2679,9747,5
patly,1184,4103,1048,1295,2116,9746,5
ardis,1698,1543,774,1963,3767,9745,5
lakhs,1046,4103,406,423,3767,9745,5
porge,1184,3069,2201,612,2679,9745,5
relay,948,2863,1603,2214,2116,9744,5
poter,1184,3069,1048,3252,1190,9743,5
boice,1555,3069,1668,770,2679,9741,5
decos,1128,2863,701,1282,3767,9741,5
parol,1184,4103,2201,1282,971,9741,5
guars,965,1824,1959,1225,3767,9740,5
yawls,225,4103,349,1295,3767,9739,5
kenay,789,2863,1757,2214,2116,9739,5
filos,847,2239,1603,1282,3767,9738,5
hawer,844,4103,349,3252,1190,9738,5
horse,844,3069,2201,945,2679,9738,5
payne,1184,4103,381,1391,2679,9738,5
picea,1184,2239,701,3252,2362,9738,5
voids,404,3069,1668,829,3767,9737,5
laved,1046,4103,417,3252,917,9735,5
praos,1184,1543,1959,1282,3767,9735,5
garik,965,4103,2201,1963,502,9734,5
marli,1225,4103,2201,1295,910,9734,5
modus,1225,3069,774,899,3767,9734,5
nurls,647,1824,2201,1295,3767,9734,5
valse,404,4103,1603,945,2679,9734,5
balor,1555,4103,1603,1282,1190,9733,5
safir,2206,4103,271,1963,1190,9733,5
tubas,1264,1824,664,2214,3767,9733,5
bunds,1555,1824,1757,829,3767,9732,5
feods,847,2863,1426,829,3767,9732,5
cinel,1512,2239,1757,3252,971,9731,5
serau,2206,2863,2201,2214,247,9731,5
parto,1184,4103,2201,1385,857,9730,5
surat,2206,1824,2201,2214,1284,9729,5
bolty,1555,3069,1603,1385,2116,9728,5
salud,2206,4103,1603,899,917,9728,5
cordy,1512,3069,2201,829,2116,9727,5
curbs,1512,1824,2201,423,3767,9727,5
gazer,965,4103,217,3252,1190,9727,5
laked,1046,4103,406,3252,917,9724,5
orias,532,1543,1668,2214,3767,9724,5
badge,1555,4103,774,612,2679,9723,5
vader,404,4103,774,3252,1190,9723,5
hasek,844,4103,1021,3252,502,9722,5
bocks,1555,3069,701,628,3767,9720,5
corve,1512,3069,2201,259,2679,9720,5
gorin,965,3069,2201,1963,1522,9720,5
toral,1264,3069,2201,2214,971,9719,5
poser,1184,3069,1021,3252,1190,9716,5
moina,1225,3069,1668,1391,2362,9715,5
mazed,1225,4103,217,3252,917,9714,5
talky,1264,4103,1603,628,2116,9714,5
lurie,1046,1824,2201,1963,2679,9713,5
vance,404,4103,1757,770,2679,9713,5
faery,847,4103,1421,1225,2116,9712,5
marut,1225,4103,2201,899,1284,9712,5
gawps,965,4103,349,526,3767,9710,5
modie,1225,3069,774,1963,2679,9710,5
ailed,1698,2239,1603,3252,917,9709,5
gavel,965,4103,417,3252,971,9708,5
hosen,844,3069,1021,3252,1522,9708,5
linus,1046,2239,1757,899,3767,9708,5
cured,1512,1824,2201,3252,917,9706,5
gable,965,4103,664,1295,2679,9706,5
marjy,1225,4103,2201,61,2116,9706,5
taxed,1264,4103,170,3252,917,9706,5
borid,1555,3069,2201,1963,917,9705,5
campe,1512,4103,885,526,2679,9705,5
cebus,1512,2863,664,899,3767,9705,5
dorsa,1128,3069,2201,945,2362,9705,5
xenos,36,2863,1757,1282,3767,9705,5
cowen,1512,3069,349,3252,1522,9704,5
downs,1128,3069,349,1391,3767,9704,5
boily,1555,3069,1668,1295,2116,9703,5
navet,647,4103,417,3252,1284,9703,5
strae,2206,403,2201,2214,2679,9703,5
layed,1046,4103,381,3252,917,9699,5
cuyas,1512,1824,381,2214,3767,9698,5
hovey,844,3069,417,3252,2116,9698,5
liers,1046,2239,1421,1225,3767,9698,5
daric,1128,4103,2201,1963,300,9695,5
jukes,446,1824,406,3252,3767,9695,5
narky,647,4103,2201,628,2116,9695,5
pelfs,1184,2863,1603,278,3767,9695,5
borah,1555,3069,2201,2214,654,9693,5
parli,1184,4103,2201,1295,910,9693,5
pilus,1184,2239,1603,899,3767,9692,5
siloa,2206,2239,1603,1282,2362,9692,5
hawks,844,4103,349,628,3767,9691,5
mirvs,1225,2239,2201,259,3767,9691,5
ravel,948,4103,417,3252,971,9691,5
zelos,176,2863,1603,1282,3767,9691,5
calor,1512,4103,1603,1282,1190,9690,5
derat,1128,2863,2201,2214,1284,9690,5
eolia,693,3069,1603,1963,2362,9690,5
masry,1225,4103,1021,1225,2116,9690,5
venus,404,2863,1757,899,3767,9690,5
cohen,1512,3069,334,3252,1522,9689,5
duret,1128,1824,2201,3252,1284,9689,5
helms,844,2863,1603,612,3767,9689,5
sumen,2206,1824,885,3252,1522,9689,5
tolna,1264,3069,1603,1391,2362,9689,5
pauly,1184,4103,990,1295,2116,9688,5
ranid,948,4103,1757,1963,917,9688,5
sowte,2206,3069,349,1385,2679,9688,5
value,404,4103,1603,899,2679,9688,5
doter,1128,3069,1048,3252,1190,9687,5
hokey,844,3069,406,3252,2116,9687,5
loire,1046,3069,1668,1225,2679,9687,5
davys,1128,4103,417,271,3767,9686,5
holed,844,3069,1603,3252,917,9685,5
vamps,404,4103,885,526,3767,9685,5
gorce,965,3069,2201,770,2679,9684,5
yerks,225,2863,2201,628,3767,9684,5
turks,1264,1824,2201,628,3767,9684,5
oakie,532,4103,406,1963,2679,9683,5
riacs,948,2239,1959,770,3767,9683,5
balun,1555,4103,1603,899,1522,9682,5
colat,1512,3069,1603,2214,1284,9682,5
gause,965,4103,990,945,2679,9682,5
golfs,965,3069,1603,278,3767,9682,5
latin,1046,4103,1048,1963,1522,9682,5
marlo,1225,4103,2201,1295,857,9681,5
runts,948,1824,1757,1385,3767,9681,5
cadge,1512,4103,774,612,2679,9680,5
kilos,789,2239,1603,1282,3767,9680,5
moral,1225,3069,2201,2214,971,9680,5
rakel,948,4103,406,3252,971,9680,5
rosie,948,3069,1021,1963,2679,9680,5
brens,1555,1543,1421,1391,3767,9677,5
benty,1555,2863,1757,1385,2116,9676,5
souly,2206,3069,990,1295,2116,9676,5
wyles,596,458,1603,3252,3767,9676,5
beira,1555,2863,1668,1225,2362,9673,5
gayel,965,4103,381,3252,971,9672,5
tolan,1264,3069,1603,2214,1522,9672,5
lasty,1046,4103,1021,1385,2116,9671,5
maint,1225,4103,1668,1391,1284,9671,5
riels,948,2239,1421,1295,3767,9670,5
altis,1698,1193,1048,1963,3767,9669,5
colin,1512,3069,1603,1963,1522,9669,5
cotys,1512,3069,1048,271,3767,9667,5
lawed,1046,4103,349,3252,917,9667,5
firms,847,2239,2201,612,3767,9666,5
sonya,2206,3069,1757,271,2362,9665,5
ferna,847,2863,2201,1391,2362,9664,5
vials,404,2239,1959,1295,3767,9664,5
loden,1046,3069,774,3252,1522,9663,5
miner,1225,2239,1757,3252,1190,9663,5
sited,2206,2239,1048,3252,917,9662,5
tahoe,1264,4103,334,1282,2679,9662,5
darst,1128,4103,2201,945,1284,9661,5
sider,2206,2239,774,3252,1190,9661,5
doser,1128,3069,1021,3252,1190,9660,5
savil,2206,4103,417,1963,971,9660,5
maury,1225,4103,990,1225,2116,9659,5
verbs,404,2863,2201,423,3767,9658,5
welds,596,2863,1603,829,3767,9658,5
doaty,1128,3069,1959,1385,2116,9657,5
jamel,446,4103,885,3252,971,9657,5
nevis,647,2863,417,1963,3767,9657,5
beths,1555,2863,1048,423,3767,9656,5
combs,1512,3069,885,423,3767,9656,5
craie,1512,1543,1959,1963,2679,9656,5
herta,844,2863,2201,1385,2362,9655,5
brads,1555,1543,1959,829,3767,9653,5
vardy,404,4103,2201,829,2116,9653,5
halbe,844,4103,1603,423,2679,9652,5
iambs,473,4103,885,423,3767,9651,5
since,2206,2239,1757,770,2679,9651,5
burne,1555,1824,2201,1391,2679,9650,5
corah,1512,3069,2201,2214,654,9650,5
lanky,1046,4103,1757,628,2116,9650,5
handy,844,4103,1757,829,2116,9649,5
laude,1046,4103,990,829,2679,9647,5
selma,2206,2863,1603,612,2362,9646,5
jacks,446,4103,701,628,3767,9645,5
murks,1225,1824,2201,628,3767,9645,5
coxae,1512,3069,170,2214,2679,9644,5
garvy,965,4103,2201,259,2116,9644,5
waxen,596,4103,170,3252,1522,9643,5
kaphs,789,4103,560,423,3767,9642,5
surly,2206,1824,2201,1295,2116,9642,5
winos,596,2239,1757,1282,3767,9641,5
arnie,1698,1543,1757,1963,2679,9640,5
yogis,225,3069,616,1963,3767,9640,5
banig,1555,4103,1757,1963,261,9639,5
delfs,1128,2863,1603,278,3767,9639,5
poral,1184,3069,2201,2214,971,9639,5
syren,2206,458,2201,3252,1522,9639,5
tings,1264,2239,1757,612,3767,9639,5
tobie,1264,3069,664,1963,2679,9639,5
scrae,2206,338,2201,2214,2679,9638,5
raved,948,4103,417,3252,917,9637,5
omnes,532,327,1757,3252,3767,9635,5
redos,948,2863,774,1282,3767,9634,5
fowey,847,3069,349,3252,2116,9633,5
muons,1225,1824,1426,1391,3767,9633,5
bolar,1555,3069,1603,2214,1190,9631,5
howey,844,3069,349,3252,2116,9630,5
jarid,446,4103,2201,1963,917,9630,5
paint,1184,4103,1668,1391,1284,9630,5
basye,1555,4103,1021,271,2679,9629,5
cokie,1512,3069,406,1963,2679,9629,5
conge,1512,3069,1757,612,2679,9629,5
raked,948,4103,406,3252,917,9626,5
tymes,1264,458,885,3252,3767,9626,5
grans,965,1543,1959,1391,3767,9625,5
toise,1264,3069,1668,945,2679,9625,5
jambs,446,4103,885,423,3767,9624,5
genys,965,2863,1757,271,3767,9623,5
mahoe,1225,4103,334,1282,2679,9623,5
horde,844,3069,2201,829,2679,9622,5
piner,1184,2239,1757,3252,1190,9622,5
horny,844,3069,2201,1391,2116,9621,5
pocus,1184,3069,701,899,3767,9620,5
vends,404,2863,1757,829,3767,9620,5
autos,1698,1824,1048,1282,3767,9619,5
birse,1555,2239,2201,945,2679,9619,5
siena,2206,2239,1421,1391,2362,9619,5
arlen,1698,1543,1603,3252,1522,9618,5
burys,1555,1824,2201,271,3767,9618,5
doina,1128,3069,1668,1391,2362,9618,5
forty,847,3069,2201,1385,2116,9618,5
palmy,1184,4103,1603,612,2116,9618,5
viren,404,2239,2201,3252,1522,9618,5
minks,1225,2239,1757,628,3767,9616,5
bowie,1555,3069,349,1963,2679,9615,5
bozen,1555,3069,217,3252,1522,9615,5
paske,1184,4103,1021,628,2679,9615,5
canto,1512,4103,1757,1385,857,9614,5
basil,1555,4103,1021,1963,971,9613,5
serab,2206,2863,2201,2214,129,9613,5
urias,420,1543,1668,2214,3767,9612,5
volet,404,3069,1603,3252,1284,9612,5
halsy,844,4103,1603,945,2116,9611,5
yaups,225,4103,990,526,3767,9611,5
korec,789,3069,2201,3252,300,9611,5
caryn,1512,4103,2201,271,1522,9609,5
walke,596,4103,1603,628,2679,9609,5
rahel,948,4103,334,3252,971,9608,5
hexis,844,2863,170,1963,3767,9607,5
jager,446,4103,616,3252,1190,9607,5
hazer,844,4103,217,3252,1190,9606,5
quais,93,1824,1959,1963,3767,9606,5
seraw,2206,2863,2201,2214,122,9606,5
soury,2206,3069,990,1225,2116,9606,5
helps,844,2863,1603,526,3767,9603,5
julis,446,1824,1603,1963,3767,9603,5
boyds,1555,3069,381,829,3767,9601,5
canst,1512,4103,1757,945,1284,9601,5
gaize,965,4103,1668,186,2679,9601,5
rayed,948,4103,381,3252,917,9601,5
layne,1046,4103,381,1391,2679,9600,5
naker,647,4103,406,3252,1190,9598,5
ruins,948,1824,1668,1391,3767,9598,5
sowle,2206,3069,349,1295,2679,9598,5
thoas,1264,927,1426,2214,3767,9598,5
urges,420,1543,616,3252,3767,9598,5
bylas,1555,458,1603,2214,3767,9597,5
jakie,446,4103,406,1963,2679,9597,5
koine,789,3069,1668,1391,2679,9596,5
tious,1264,2239,1426,899,3767,9595,5
kandy,789,4103,1757,829,2116,9594,5
berga,1555,2863,2201,612,2362,9593,5
fancy,847,4103,1757,770,2116,9593,5
latex,1046,4103,1048,3252,144,9593,5
larto,1046,4103,2201,1385,857,9592,5
menta,1225,2863,1757,1385,2362,9592,5
favel,847,4103,417,3252,971,9590,5
wilts,596,2239,1603,1385,3767,9590,5
nagel,647,4103,616,3252,971,9589,5
boule,1555,3069,990,1295,2679,9588,5
fable,847,4103,664,1295,2679,9588,5
sicer,2206,2239,701,3252,1190,9588,5
havel,844,4103,417,3252,971,9587,5
dayle,1128,4103,381,1295,2679,9586,5
moise,1225,3069,1668,945,2679,9586,5
hable,844,4103,664,1295,2679,9585,5
coper,1512,3069,560,3252,1190,9583,5
curfs,1512,1824,2201,278,3767,9582,5
turps,1264,1824,2201,526,3767,9582,5
kelia,789,2863,1603,1963,2362,9580,5
fosie,847,3069,1021,1963,2679,9579,5
lincs,1046,2239,1757,770,3767,9579,5
radek,948,4103,774,3252,502,9579,5
sedan,2206,2863,774,2214,1522,9579,5
codel,1512,3069,774,3252,971,9578,5
fanwe,847,4103,1757,192,2679,9578,5
gecos,965,2863,701,1282,3767,9578,5
linet,1046,2239,1757,3252,1284,9578,5
loser,1046,3069,1021,3252,1190,9578,5
bovet,1555,3069,417,3252,1284,9577,5
canli,1512,4103,1757,1295,910,9577,5
hunts,844,1824,1757,1385,3767,9577,5
sinew,2206,2239,1757,3252,122,9576,5
arius,1698,1543,1668,899,3767,9575,5
elais,693,1193,1959,1963,3767,9575,5
pinks,1184,2239,1757,628,3767,9575,5
shien,2206,927,1668,3252,1522,9575,5
warnt,596,4103,2201,1391,1284,9575,5
daint,1128,4103,1668,1391,1284,9574,5
roset,948,3069,1021,3252,1284,9574,5
rasty,948,4103,1021,1385,2116,9573,5
cowie,1512,3069,349,1963,2679,9572,5
cozen,1512,3069,217,3252,1522,9572,5
hapte,844,4103,560,1385,2679,9571,5
cobia,1512,3069,664,1963,2362,9570,5
garni,965,4103,2201,1391,910,9570,5
sayid,2206,4103,381,1963,917,9570,5
boxen,1555,3069,170,3252,1522,9568,5
marth,1225,4103,2201,1385,654,9568,5
aeron,1698,2863,2201,1282,1522,9566,5
diner,1128,2239,1757,3252,1190,9566,5
doums,1128,3069,990,612,3767,9566,5
force,847,3069,2201,770,2679,9566,5
motel,1225,3069,1048,3252,971,9565,5
fause,847,4103,990,945,2679,9564,5
ornis,532,1543,1757,1963,3767,9562,5
taupe,1264,4103,990,526,2679,9562,5
hause,844,4103,990,945,2679,9561,5
bavin,1555,4103,417,1963,1522,9560,5
monde,1225,3069,1757,829,2679,9559,5
pings,1184,2239,1757,612,3767,9559,5
waver,596,4103,417,3252,1190,9558,5
korat,789,3069,2201,2214,1284,9557,5
manor,1225,4103,1757,1282,1190,9557,5
balti,1555,4103,1603,1385,910,9556,5
vange,404,4103,1757,612,2679,9555,5
meany,1225,2863,1959,1391,2116,9554,5
maeon,1225,4103,1421,1282,1522,9553,5
lucas,1046,1824,701,2214,3767,9552,5
monty,1225,3069,1757,1385,2116,9552,5
japer,446,4103,560,3252,1190,9551,5
penta,1184,2863,1757,1385,2362,9551,5
siber,2206,2239,664,3252,1190,9551,5
chats,1512,927,1959,1385,3767,9550,5
dugas,1128,1824,616,2214,3767,9549,5
hadjs,844,4103,774,61,3767,9549,5
moira,1225,3069,1668,1225,2362,9549,5
silty,2206,2239,1603,1385,2116,9549,5
kelps,789,2863,1603,526,3767,9548,5
meaty,1225,2863,1959,1385,2116,9548,5
tiler,1264,2239,1603,3252,1190,9548,5
jobey,446,3069,664,3252,2116,9547,5
waker,596,4103,406,3252,1190,9547,5
bardo,1555,4103,2201,829,857,9545,5
poise,1184,3069,1668,945,2679,9545,5
joane,446,3069,1959,1391,2679,9544,5
korin,789,3069,2201,1963,1522,9544,5
romie,948,3069,885,1963,2679,9544,5
zande,176,4103,1757,829,2679,9544,5
dosia,1128,3069,1021,1963,2362,9543,5
tomia,1264,3069,885,1963,2362,9543,5
demus,1128,2863,885,899,3767,9542,5
borak,1555,3069,2201,2214,502,9541,5
gowns,965,3069,349,1391,3767,9541,5
norse,647,3069,2201,945,2679,9541,5
tenla,1264,2863,1757,1295,2362,9541,5
brien,1555,1543,1668,3252,1522,9540,5
rinds,948,2239,1757,829,3767,9540,5
selah,2206,2863,1603,2214,654,9540,5
dahle,1128,4103,334,1295,2679,9539,5
sabot,2206,4103,664,1282,1284,9539,5
gonta,965,3069,1757,1385,2362,9538,5
latry,1046,4103,1048,1225,2116,9538,5
limey,1046,2239,885,3252,2116,9538,5
lofts,1046,3069,271,1385,3767,9538,5
mosel,1225,3069,1021,3252,971,9538,5
dolan,1128,3069,1603,2214,1522,9536,5
merit,1225,2863,2201,1963,1284,9536,5
rangy,948,4103,1757,612,2116,9536,5
elias,693,1193,1668,2214,3767,9535,5
lazed,1046,4103,217,3252,917,9535,5
sango,2206,4103,1757,612,857,9535,5
tibey,1264,2239,664,3252,2116,9535,5
covet,1512,3069,417,3252,1284,9534,5
yance,225,4103,1757,770,2679,9534,5
shaer,2206,927,1959,3252,1190,9534,5
seric,2206,2863,2201,1963,300,9533,5
lutea,1046,1824,1048,3252,2362,9532,5
moths,1225,3069,1048,423,3767,9532,5
bunks,1555,1824,1757,628,3767,9531,5
lodie,1046,3069,774,1963,2679,9531,5
teian,1264,2863,1668,2214,1522,9531,5
comte,1512,3069,885,1385,2679,9530,5
dorca,1128,3069,2201,770,2362,9530,5
gerty,965,2863,2201,1385,2116,9530,5
conda,1512,3069,1757,829,2362,9529,5
dauke,1128,4103,990,628,2679,9528,5
pleis,1184,1193,1421,1963,3767,9528,5
vario,404,4103,2201,1963,857,9528,5
danby,1128,4103,1757,423,2116,9527,5
rudas,948,1824,774,2214,3767,9527,5
corky,1512,3069,2201,628,2116,9526,5
duets,1128,1824,1421,1385,3767,9525,5
faked,847,4103,406,3252,917,9525,5
domer,1128,3069,885,3252,1190,9524,5
goter,965,3069,1048,3252,1190,9524,5
reifs,948,2863,1668,278,3767,9524,5
trios,1264,1543,1668,1282,3767,9524,5
conal,1512,3069,1757,2214,971,9523,5
beday,1555,2863,774,2214,2116,9522,5
surge,2206,1824,2201,612,2679,9522,5
mopus,1225,3069,560,899,3767,9520,5
suter,2206,1824,1048,3252,1190,9520,5
belat,1555,2863,1603,2214,1284,9519,5
dinks,1128,2239,1757,628,3767,9519,5
lamin,1046,4103,885,1963,1522,9519,5
bolme,1555,3069,1603,612,2679,9518,5
fabre,847,4103,664,1225,2679,9518,5
solfa,2206,3069,1603,278,2362,9518,5
cavin,1512,4103,417,1963,1522,9517,5
douay,1128,3069,990,2214,2116,9517,5
harim,844,4103,2201,1963,406,9517,5
vairy,404,4103,1668,1225,2116,9516,5
bungs,1555,1824,1757,612,3767,9515,5
camuy,1512,4103,885,899,2116,9515,5
pious,1184,2239,1426,899,3767,9515,5
becks,1555,2863,701,628,3767,9514,5
furie,847,1824,2201,1963,2679,9514,5
forex,847,3069,2201,3252,144,9513,5
madly,1225,4103,774,1295,2116,9513,5
token,1264,3069,406,3252,1522,9513,5
paeon,1184,4103,1421,1282,1522,9512,5
moted,1225,3069,1048,3252,917,9511,5
sauld,2206,4103,990,1295,917,9511,5
baton,1555,4103,1048,1282,1522,9510,5
moder,1225,3069,774,3252,1190,9510,5
virus,404,2239,2201,899,3767,9510,5
bowet,1555,3069,349,3252,1284,9509,5
miler,1225,2239,1603,3252,1190,9509,5
slier,2206,1193,1668,3252,1190,9509,5
bawty,1555,4103,349,1385,2116,9508,5
gazel,965,4103,217,3252,971,9508,5
jaime,446,4103,1668,612,2679,9508,5
leroy,1046,2863,2201,1282,2116,9508,5
torma,1264,3069,2201,612,2362,9508,5
frans,847,1543,1959,1391,3767,9507,5
peaty,1184,2863,1959,1385,2116,9507,5
donec,1128,3069,1757,3252,300,9506,5
bercy,1555,2863,2201,770,2116,9505,5
zapus,176,4103,560,899,3767,9505,5
carom,1512,4103,2201,1282,406,9504,5
latke,1046,4103,1048,628,2679,9504,5
birde,1555,2239,2201,829,2679,9503,5
dings,1128,2239,1757,612,3767,9503,5
dobie,1128,3069,664,1963,2679,9503,5
shred,2206,927,2201,3252,917,9503,5
birny,1555,2239,2201,1391,2116,9502,5
cardo,1512,4103,2201,829,857,9502,5
rayne,948,4103,381,1391,2679,9502,5
bevus,1555,2863,417,899,3767,9501,5
frats,847,1543,1959,1385,3767,9501,5
ladue,1046,4103,774,899,2679,9501,5
fayed,847,4103,381,3252,917,9500,5
mewls,1225,2863,349,1295,3767,9499,5
hayed,844,4103,381,3252,917,9497,5
jours,446,3069,990,1225,3767,9497,5
suade,2206,1824,1959,829,2679,9497,5
magec,1225,4103,616,3252,300,9496,5
horeb,844,3069,2201,3252,129,9495,5
jonel,446,3069,1757,3252,971,9495,5
leuds,1046,2863,990,829,3767,9495,5
perit,1184,2863,2201,1963,1284,9495,5
goaty,965,3069,1959,1385,2116,9494,5
plans,1184,1193,1959,1391,3767,9494,5
singe,2206,2239,1757,612,2679,9493,5
worse,596,3069,2201,945,2679,9490,5
halve,844,4103,1603,259,2679,9488,5
plats,1184,1193,1959,1385,3767,9488,5
zunis,176,1824,1757,1963,3767,9487,5
arlie,1698,1543,1603,1963,2679,9486,5
barco,1555,4103,2201,770,857,9486,5
aiden,1698,2239,774,3252,1522,9485,5
coady,1512,3069,1959,829,2116,9485,5
liner,1046,2239,1757,3252,1190,9484,5
valew,404,4103,1603,3252,122,9484,5
waged,596,4103,616,3252,917,9484,5
bason,1555,4103,1021,1282,1522,9483,5
kreis,789,1543,1421,1963,3767,9483,5
locus,1046,3069,701,899,3767,9482,5
laury,1046,4103,990,1225,2116,9480,5
salop,2206,4103,1603,1282,285,9479,5
bailo,1555,4103,1668,1295,857,9478,5
cagit,1512,4103,616,1963,1284,9478,5
mathe,1225,4103,1048,423,2679,9478,5
oreas,532,1543,1421,2214,3767,9477,5
culet,1512,1824,1603,3252,1284,9475,5
gilus,965,2239,1603,899,3767,9473,5
meows,1225,2863,1426,192,3767,9473,5
torve,1264,3069,2201,259,2679,9472,5
cawny,1512,4103,349,1391,2116,9471,5
hasty,844,4103,1021,1385,2116,9469,5
morga,1225,3069,2201,612,2362,9469,5
baird,1555,4103,1668,1225,917,9468,5
piler,1184,2239,1603,3252,1190,9468,5
caton,1512,4103,1048,1282,1522,9467,5
copia,1512,3069,560,1963,2362,9466,5
lurks,1046,1824,2201,628,3767,9466,5
velds,404,2863,1603,829,3767,9466,5
hawed,844,4103,349,3252,917,9465,5
hurds,844,1824,2201,829,3767,9465,5
pairt,1184,4103,1668,1225,1284,9464,5
celin,1512,2863,1603,1963,1522,9463,5
moity,1225,3069,1668,1385,2116,9463,5
karim,789,4103,2201,1963,406,9462,5
milks,1225,2239,1603,628,3767,9462,5
bache,1555,4103,701,423,2679,9461,5
bunia,1555,1824,1757,1963,2362,9461,5
jenks,446,2863,1757,628,3767,9461,5
baign,1555,4103,1668,612,1522,9460,5
dorsy,1128,3069,2201,945,2116,9459,5
gavle,965,4103,417,1295,2679,9459,5
ponce,1184,3069,1757,770,2679,9459,5
taube,1264,4103,990,423,2679,9459,5
mealy,1225,2863,1959,1295,2116,9458,5
nerta,647,2863,2201,1385,2362,9458,5
larix,1046,4103,2201,1963,144,9457,5
fired,847,2239,2201,3252,917,9456,5
dogie,1128,3069,616,1963,2679,9455,5
sonja,2206,3069,1757,61,2362,9455,5
gazed,965,4103,217,3252,917,9454,5
hasin,844,4103,1021,1963,1522,9453,5
hired,844,2239,2201,3252,917,9453,5
serut,2206,2863,2201,899,1284,9453,5
donat,1128,3069,1757,2214,1284,9452,5
piane,1184,2239,1959,1391,2679,9452,5
terai,1264,2863,2201,2214,910,9452,5
mashe,1225,4103,1021,423,2679,9451,5
suina,2206,1824,1668,1391,2362,9451,5
valry,404,4103,1603,1225,2116,9451,5
krans,789,1543,1959,1391,3767,9449,5
moyen,1225,3069,381,3252,1522,9449,5
vinos,404,2239,1757,1282,3767,9449,5
hanky,844,4103,1757,628,2116,9448,5
lorca,1046,3069,2201,770,2362,9448,5
boyer,1555,3069,381,3252,1190,9447,5
chaos,1512,927,1959,1282,3767,9447,5
siper,2206,2239,560,3252,1190,9447,5
senam,2206,2863,1757,2214,406,9446,5
lobus,1046,3069,664,899,3767,9445,5
balut,1555,4103,1603,899,1284,9444,5
nemos,647,2863,885,1282,3767,9444,5
silex,2206,2239,1603,3252,144,9444,5
zoner,176,3069,1757,3252,1190,9444,5
posed,1184,3069,1021,3252,917,9443,5
fleas,847,1193,1421,2214,3767,9442,5
kiers,789,2239,1421,1225,3767,9441,5
cason,1512,4103,1021,1282,1522,9440,5
cover,1512,3069,417,3252,1190,9440,5
cozie,1512,3069,217,1963,2679,9440,5
jilts,446,2239,1603,1385,3767,9440,5
mordy,1225,3069,2201,829,2116,9440,5
tiran,1264,2239,2201,2214,1522,9440,5
berio,1555,2863,2201,1963,857,9439,5
finds,847,2239,1757,829,3767,9439,5
gamin,965,4103,885,1963,1522,9438,5
nelia,647,2863,1603,1963,2362,9438,5
sabik,2206,4103,664,1963,502,9438,5
links,1046,2239,1757,628,3767,9437,5
pathe,1184,4103,1048,423,2679,9437,5
razed,948,4103,217,3252,917,9437,5
today,1264,3069,774,2214,2116,9437,5
brags,1555,1543,1959,612,3767,9436,5
dicey,1128,2239,701,3252,2116,9436,5
hinds,844,2239,1757,829,3767,9436,5
yamel,225,4103,885,3252,971,9436,5
samto,2206,4103,885,1385,857,9436,5
duels,1128,1824,1421,1295,3767,9435,5
fangy,847,4103,1757,612,2116,9435,5
lyris,1046,458,2201,1963,3767,9435,5
salmi,2206,4103,1603,612,910,9434,5
rodie,948,3069,774,1963,2679,9433,5
beora,1555,2863,1426,1225,2362,9431,5
tonry,1264,3069,1757,1225,2116,9431,5
halid,844,4103,1603,1963,917,9430,5
notus,647,3069,1048,899,3767,9430,5
coker,1512,3069,406,3252,1190,9429,5
tined,1264,2239,1757,3252,917,9429,5
slane,2206,1193,1959,1391,2679,9428,5
melan,1225,2863,1603,2214,1522,9427,5
nipas,647,2239,560,2214,3767,9427,5
teary,1264,2863,1959,1225,2116,9427,5
fults,847,1824,1603,1385,3767,9426,5
kivas,789,2239,417,2214,3767,9426,5
tanzy,1264,4103,1757,186,2116,9426,5
belar,1555,2863,1603,2214,1190,9425,5
caird,1512,4103,1668,1225,917,9425,5
fetus,847,2863,1048,899,3767,9424,5
yacks,225,4103,701,628,3767,9424,5
gayle,965,4103,381,1295,2679,9423,5
tarsi,1264,4103,2201,945,910,9423,5
slate,2206,1193,1959,1385,2679,9422,5
halwe,844,4103,1603,192,2679,9421,5
horsa,844,3069,2201,945,2362,9421,5
lings,1046,2239,1757,612,3767,9421,5
merca,1225,2863,2201,770,2362,9421,5
mynas,1225,458,1757,2214,3767,9421,5
ramin,948,4103,885,1963,1522,9421,5
coaid,1512,3069,1959,1963,917,9420,5
goral,965,3069,2201,2214,971,9420,5
repos,948,2863,560,1282,3767,9420,5
mured,1225,1824,2201,3252,917,9419,5
bawly,1555,4103,349,1295,2116,9418,5
ferny,847,2863,2201,1391,2116,9418,5
mirna,1225,2239,2201,1391,2362,9418,5
norty,647,3069,2201,1385,2116,9418,5
vanir,404,4103,1757,1963,1190,9417,5
sural,2206,1824,2201,2214,971,9416,5
bower,1555,3069,349,3252,1190,9415,5
deina,1128,2863,1668,1391,2362,9412,5
wafer,596,4103,271,3252,1190,9412,5
fatly,847,4103,1048,1295,2116,9409,5
botan,1555,3069,1048,2214,1522,9408,5
dairt,1128,4103,1668,1225,1284,9408,5
fohns,847,3069,334,1391,3767,9408,5
forge,847,3069,2201,612,2679,9408,5
forme,847,3069,2201,612,2679,9408,5
javer,446,4103,417,3252,1190,9408,5
ladin,1046,4103,774,1963,1522,9408,5
poyen,1184,3069,381,3252,1522,9408,5
tombs,1264,3069,885,423,3767,9408,5
loise,1046,3069,1668,945,2679,9407,5
herat,844,2863,2201,2214,1284,9406,5
rayle,948,4103,381,1295,2679,9406,5
horme,844,3069,2201,612,2679,9405,5
coyer,1512,3069,381,3252,1190,9404,5
lazys,1046,4103,217,271,3767,9404,5
gilds,965,2239,1603,829,3767,9403,5
pinel,1184,2239,1757,3252,971,9403,5
seavy,2206,2863,1959,259,2116,9403,5
coram,1512,3069,2201,2214,406,9402,5
hacek,844,4103,701,3252,502,9402,5
yurts,225,1824,2201,1385,3767,9402,5
pubis,1184,1824,664,1963,3767,9402,5
torah,1264,3069,2201,2214,654,9402,5
luray,1046,1824,2201,2214,2116,9401,5
miran,1225,2239,2201,2214,1522,9401,5
wandy,596,4103,1757,829,2116,9401,5
consy,1512,3069,1757,945,2116,9399,5
hayne,844,4103,381,1391,2679,9398,5
loups,1046,3069,990,526,3767,9398,5
pelta,1184,2863,1603,1385,2362,9397,5
pusey,1184,1824,1021,3252,2116,9397,5
zonks,176,3069,1757,628,3767,9397,5
diane,1128,2239,1959,1391,2679,9396,5
malik,1225,4103,1603,1963,502,9396,5
patsy,1184,4103,1048,945,2116,9396,5
aldis,1698,1193,774,1963,3767,9395,5
beisa,1555,2863,1668,945,2362,9393,5
crags,1512,1543,1959,612,3767,9393,5
crams,1512,1543,1959,612,3767,9393,5
madge,1225,4103,774,612,2679,9393,5
aoife,1698,3069,1668,278,2679,9392,5
chars,1512,927,1959,1225,3767,9390,5
kiyas,789,2239,381,2214,3767,9390,5
mined,1225,2239,1757,3252,917,9390,5
mocks,1225,3069,701,628,3767,9390,5
navel,647,4103,417,3252,971,9390,5
raxed,948,4103,170,3252,917,9390,5
sirky,2206,2239,2201,628,2116,9390,5
aches,1698,338,334,3252,3767,9389,5
aruns,1698,1543,990,1391,3767,9389,5
crius,1512,1543,1668,899,3767,9389,5
sogat,2206,3069,616,2214,1284,9389,5
doven,1128,3069,417,3252,1522,9388,5
jewis,446,2863,349,1963,3767,9388,5
nable,647,4103,664,1295,2679,9388,5
hazel,844,4103,217,3252,971,9387,5
juans,446,1824,1959,1391,3767,9387,5
siket,2206,2239,406,3252,1284,9387,5
sinal,2206,2239,1757,2214,971,9387,5
yager,225,4103,616,3252,1190,9386,5
outas,532,1824,1048,2214,3767,9385,5
rizas,948,2239,217,2214,3767,9385,5
marsi,1225,4103,2201,945,910,9384,5
nolte,647,3069,1603,1385,2679,9383,5
kinds,789,2239,1757,829,3767,9381,5
salmo,2206,4103,1603,612,857,9381,5
casky,1512,4103,1021,628,2116,9380,5
manti,1225,4103,1757,1385,910,9380,5
perca,1184,2863,2201,770,2362,9380,5
moste,1225,3069,1021,1385,2679,9379,5
skiey,2206,137,1668,3252,2116,9379,5
pured,1184,1824,2201,3252,917,9378,5
serif,2206,2863,2201,1963,145,9378,5
tupis,1264,1824,560,1963,3767,9378,5
bulks,1555,1824,1603,628,3767,9377,5
doubs,1128,3069,990,423,3767,9377,5
harst,844,4103,2201,945,1284,9377,5
septa,2206,2863,560,1385,2362,9376,5
leany,1046,2863,1959,1391,2116,9375,5
zacks,176,4103,701,628,3767,9375,5
senza,2206,2863,1757,186,2362,9374,5
logie,1046,3069,616,1963,2679,9373,5
bodle,1555,3069,774,1295,2679,9372,5
cower,1512,3069,349,3252,1190,9372,5
lieus,1046,2239,1421,899,3767,9372,5
perai,1184,2863,2201,2214,910,9372,5
fawne,847,4103,349,1391,2679,9369,5
niels,647,2239,1421,1295,3767,9369,5
sicel,2206,2239,701,3252,971,9369,5
benda,1555,2863,1757,829,2362,9366,5
baith,1555,4103,1668,1385,654,9365,5
cairo,1512,4103,1668,1225,857,9365,5
cotan,1512,3069,1048,2214,1522,9365,5
dilks,1128,2239,1603,628,3767,9365,5
ureas,420,1543,1421,2214,3767,9365,5
begay,1555,2863,616,2214,2116,9364,5
supen,2206,1824,560,3252,1522,9364,5
berky,1555,2863,2201,628,2116,9363,5
remus,948,2863,885,899,3767,9362,5
gomer,965,3069,885,3252,1190,9361,5
pomel,1184,3069,885,3252,971,9361,5
taryn,1264,4103,2201,271,1522,9361,5
bazin,1555,4103,217,1963,1522,9360,5
sowan,2206,3069,349,2214,1522,9360,5
turne,1264,1824,2201,1391,2679,9359,5
decus,1128,2863,701,899,3767,9358,5
donar,1128,3069,1757,2214,1190,9358,5
sumer,2206,1824,885,3252,1190,9357,5
ginks,965,2239,1757,628,3767,9356,5
naive,647,4103,1668,259,2679,9356,5
rolan,948,3069,1603,2214,1522,9356,5
nacre,647,4103,701,1225,2679,9355,5
dagny,1128,4103,616,1391,2116,9354,5
harli,844,4103,2201,1295,910,9353,5
movie,1225,3069,417,1963,2679,9353,5
doyen,1128,3069,381,3252,1522,9352,5
hilus,844,2239,1603,899,3767,9352,5
padge,1184,4103,774,612,2679,9352,5
podia,1184,3069,774,1963,2362,9352,5
praus,1184,1543,1959,899,3767,9352,5
tarok,1264,4103,2201,1282,502,9352,5
biset,1555,2239,1021,3252,1284,9351,5
kerat,789,2863,2201,2214,1284,9351,5
ulnas,420,1193,1757,2214,3767,9351,5
costa,1512,3069,1021,1385,2362,9349,5
pined,1184,2239,1757,3252,917,9349,5
pocks,1184,3069,701,628,3767,9349,5
manic,1225,4103,1757,1963,300,9348,5
bergy,1555,2863,2201,612,2116,9347,5
harod,844,4103,2201,1282,917,9347,5
peary,1184,2863,1959,1225,2116,9347,5
robus,948,3069,664,899,3767,9347,5
karol,789,4103,2201,1282,971,9346,5
sadic,2206,4103,774,1963,300,9346,5
sanbo,2206,4103,1757,423,857,9346,5
somal,2206,3069,885,2214,971,9345,5
godet,965,3069,774,3252,1284,9344,5
gilet,965,2239,1603,3252,1284,9343,5
kayne,789,4103,381,1391,2679,9343,5
menat,1225,2863,1757,2214,1284,9343,5
parsi,1184,4103,2201,945,910,9343,5
monge,1225,3069,1757,612,2679,9342,5
theis,1264,927,1421,1963,3767,9342,5
delta,1128,2863,1603,1385,2362,9341,5
sapor,2206,4103,560,1282,1190,9341,5
sedat,2206,2863,774,2214,1284,9341,5
idles,473,245,1603,3252,3767,9340,5
nagle,647,4103,616,1295,2679,9340,5
tawse,1264,4103,349,945,2679,9340,5
tolar,1264,3069,1603,2214,1190,9340,5
tufas,1264,1824,271,2214,3767,9340,5
dukas,1128,1824,406,2214,3767,9339,5
rinks,948,2239,1757,628,3767,9339,5
carmi,1512,4103,2201,612,910,9338,5
kerin,789,2863,2201,1963,1522,9338,5
fazed,847,4103,217,3252,917,9336,5
toper,1264,3069,560,3252,1190,9335,5
grins,965,1543,1668,1391,3767,9334,5
turfs,1264,1824,2201,278,3767,9334,5
alien,1698,1193,1668,3252,1522,9333,5
burna,1555,1824,2201,1391,2362,9333,5
eyras,693,458,2201,2214,3767,9333,5
hazed,844,4103,217,3252,917,9333,5
yaron,225,4103,2201,1282,1522,9333,5
lapse,1046,4103,560,945,2679,9333,5
lefts,1046,2863,271,1385,3767,9332,5
ramex,948,4103,885,3252,144,9332,5
sangh,2206,4103,1757,612,654,9332,5
sibel,2206,2239,664,3252,971,9332,5
claus,1512,1193,1959,899,3767,9330,5
areus,1698,1543,1421,899,3767,9328,5
grits,965,1543,1668,1385,3767,9328,5
limns,1046,2239,885,1391,3767,9328,5
blens,1555,1193,1421,1391,3767,9327,5
burta,1555,1824,2201,1385,2362,9327,5
fowls,847,3069,349,1295,3767,9327,5
manto,1225,4103,1757,1385,857,9327,5
blots,1555,1193,1426,1385,3767,9326,5
bondy,1555,3069,1757,829,2116,9326,5
calif,1512,4103,1603,1963,145,9326,5
meths,1225,2863,1048,423,3767,9326,5
calix,1512,4103,1603,1963,144,9325,5
naked,647,4103,406,3252,917,9325,5
pamir,1184,4103,885,1963,1190,9325,5
howls,844,3069,349,1295,3767,9324,5
towie,1264,3069,349,1963,2679,9324,5
women,596,3069,885,3252,1522,9324,5
daube,1128,4103,990,423,2679,9323,5
rings,948,2239,1757,612,3767,9323,5
alcis,1698,1193,701,1963,3767,9322,5
beady,1555,2863,1959,829,2116,9322,5
ferly,847,2863,2201,1295,2116,9322,5
yameo,225,4103,885,3252,857,9322,5
karst,789,4103,2201,945,1284,9322,5
maryn,1225,4103,2201,271,1522,9322,5
blets,1555,1193,1421,1385,3767,9321,5
corby,1512,3069,2201,423,2116,9321,5
debus,1128,2863,664,899,3767,9321,5
koser,789,3069,1021,3252,1190,9321,5
wanze,596,4103,1757,186,2679,9321,5
culms,1512,1824,1603,612,3767,9318,5
pakse,1184,4103,406,945,2679,9317,5
weihs,596,2863,1668,423,3767,9317,5
buran,1555,1824,2201,2214,1522,9316,5
guria,965,1824,2201,1963,2362,9315,5
alnus,1698,1193,1757,899,3767,9314,5
bawke,1555,4103,349,628,2679,9314,5
kytes,789,458,1048,3252,3767,9314,5
liane,1046,2239,1959,1391,2679,9314,5
marok,1225,4103,2201,1282,502,9313,5
wolfs,596,3069,1603,278,3767,9313,5
conga,1512,3069,1757,612,2362,9312,5
waxer,596,4103,170,3252,1190,9311,5
coped,1512,3069,560,3252,917,9310,5
garth,965,4103,2201,1385,654,9308,5
craps,1512,1543,1959,526,3767,9307,5
jelks,446,2863,1603,628,3767,9307,5
panic,1184,4103,1757,1963,300,9307,5
domel,1128,3069,885,3252,971,9305,5
temps,1264,2863,885,526,3767,9305,5
waive,596,4103,1668,259,2679,9305,5
olpes,532,1193,560,3252,3767,9304,5
siver,2206,2239,417,3252,1190,9304,5
bigae,1555,2239,616,2214,2679,9303,5
copei,1512,3069,560,3252,910,9303,5
hogen,844,3069,616,3252,1522,9303,5
setal,2206,2863,1048,2214,971,9302,5
terga,1264,2863,2201,612,2362,9302,5
terma,1264,2863,2201,612,2362,9302,5
molar,1225,3069,1603,2214,1190,9301,5
pokie,1184,3069,406,1963,2679,9301,5
types,1264,458,560,3252,3767,9301,5
roups,948,3069,990,526,3767,9300,5
horal,844,3069,2201,2214,971,9299,5
kalon,789,4103,1603,1282,1522,9299,5
lathe,1046,4103,1048,423,2679,9299,5
karli,789,4103,2201,1295,910,9298,5
senor,2206,2863,1757,1282,1190,9298,5
ladew,1046,4103,774,3252,122,9297,5
feuds,847,2863,990,829,3767,9296,5
gorsy,965,3069,2201,945,2116,9296,5
moper,1225,3069,560,3252,1190,9296,5
golem,965,3069,1603,3252,406,9295,5
maniu,1225,4103,1757,1963,247,9295,5
sonic,2206,3069,1757,1963,300,9295,5
bernt,1555,2863,2201,1391,1284,9294,5
gaspe,965,4103,1021,526,2679,9294,5
docks,1128,3069,701,628,3767,9293,5
faint,847,4103,1668,1391,1284,9293,5
ogles,532,139,1603,3252,3767,9293,5
selva,2206,2863,1603,259,2362,9293,5
siker,2206,2239,406,3252,1190,9293,5
softa,2206,3069,271,1385,2362,9293,5
yolks,225,3069,1603,628,3767,9292,5
deary,1128,2863,1959,1225,2116,9291,5
model,1225,3069,774,3252,971,9291,5
ierna,473,2863,2201,1391,2362,9290,5
clons,1512,1193,1426,1391,3767,9289,5
faxed,847,4103,170,3252,917,9289,5
jokey,446,3069,406,3252,2116,9289,5
racep,948,4103,701,3252,285,9289,5
noire,647,3069,1668,1225,2679,9288,5
poufs,1184,3069,990,278,3767,9288,5
tuner,1264,1824,1757,3252,1190,9287,5
foaly,847,3069,1959,1295,2116,9286,5
panto,1184,4103,1757,1385,857,9286,5
cargo,1512,4103,2201,612,857,9285,5
dolin,1128,3069,1603,1963,1522,9285,5
finer,847,2239,1757,3252,1190,9285,5
gulae,965,1824,1603,2214,2679,9285,5
mowie,1225,3069,349,1963,2679,9285,5
waved,596,4103,417,3252,917,9285,5
biter,1555,2239,1048,3252,1190,9284,5
cafoy,1512,4103,271,1282,2116,9284,5
dorcy,1128,3069,2201,770,2116,9284,5
sigel,2206,2239,616,3252,971,9284,5
barch,1555,4103,2201,770,654,9283,5
clots,1512,1193,1426,1385,3767,9283,5
focus,847,3069,701,899,3767,9283,5
saxon,2206,4103,170,1282,1522,9283,5
taino,1264,4103,1668,1391,857,9283,5
ronde,948,3069,1757,829,2679,9282,5
alsey,1698,1193,1021,3252,2116,9280,5
baldr,1555,4103,1603,829,1190,9280,5
hocus,844,3069,701,899,3767,9280,5
cavit,1512,4103,417,1963,1284,9279,5
spret,2206,336,2201,3252,1284,9279,5
bogys,1555,3069,616,271,3767,9278,5
japed,446,4103,560,3252,917,9278,5
rheas,948,927,1421,2214,3767,9277,5
byrls,1555,458,2201,1295,3767,9276,5
doily,1128,3069,1668,1295,2116,9276,5
yours,225,3069,990,1225,3767,9276,5
baerl,1555,4103,1421,1225,971,9275,5
glans,965,1193,1959,1391,3767,9275,5
tiled,1264,2239,1603,3252,917,9275,5
tonal,1264,3069,1757,2214,971,9275,5
waked,596,4103,406,3252,917,9274,5
goths,965,3069,1048,423,3767,9272,5
nasty,647,4103,1021,1385,2116,9272,5
abyes,1698,172,381,3252,3767,9270,5
seato,2206,2863,1959,1385,857,9270,5
tofus,1264,3069,271,899,3767,9270,5
bonpa,1555,3069,1757,526,2362,9269,5
holna,844,3069,1603,1391,2362,9269,5
havre,844,4103,417,1225,2679,9268,5
mardi,1225,4103,2201,829,910,9268,5
nurds,647,1824,2201,829,3767,9268,5
chins,1512,927,1668,1391,3767,9265,5
aimer,1698,2239,885,3252,1190,9264,5
maudy,1225,4103,990,829,2116,9263,5
meiny,1225,2863,1668,1391,2116,9263,5
kamin,789,4103,885,1963,1522,9262,5
slare,2206,1193,1959,1225,2679,9262,5
yirds,225,2239,2201,829,3767,9261,5
lordy,1046,3069,2201,829,2116,9261,5
rosel,948,3069,1021,3252,971,9261,5
clads,1512,1193,1959,829,3767,9260,5
polar,1184,3069,1603,2214,1190,9260,5
chits,1512,927,1668,1385,3767,9259,5
moule,1225,3069,990,1295,2679,9258,5
takin,1264,4103,406,1963,1522,9258,5
lukas,1046,1824,406,2214,3767,9257,5
janye,446,4103,1757,271,2679,9256,5
mauve,1225,4103,990,259,2679,9256,5
ricey,948,2239,701,3252,2116,9256,5
wrans,596,1543,1959,1391,3767,9256,5
cunei,1512,1824,1757,3252,910,9255,5
kohls,789,3069,334,1295,3767,9254,5
tardo,1264,4103,2201,829,857,9254,5
carpi,1512,4103,2201,526,910,9252,5
danic,1128,4103,1757,1963,300,9251,5
jandy,446,4103,1757,829,2116,9251,5
denty,1128,2863,1757,1385,2116,9249,5
dolce,1128,3069,1603,770,2679,9249,5
iatse,473,4103,1048,945,2679,9248,5
kayle,789,4103,381,1295,2679,9247,5
solim,2206,3069,1603,1963,406,9247,5
bonze,1555,3069,1757,186,2679,9246,5
bruns,1555,1543,990,1391,3767,9246,5
denat,1128,2863,1757,2214,1284,9246,5
voled,404,3069,1603,3252,917,9245,5
koral,789,3069,2201,2214,971,9244,5
pinte,1184,2239,1757,1385,2679,9244,5
shier,2206,927,1668,3252,1190,9243,5
monda,1225,3069,1757,829,2362,9242,5
caeli,1512,4103,1421,1295,910,9241,5
citer,1512,2239,1048,3252,1190,9241,5
juley,446,1824,1603,3252,2116,9241,5
homer,844,3069,885,3252,1190,9240,5
lured,1046,1824,2201,3252,917,9240,5
vigas,404,2239,616,2214,3767,9240,5
lampe,1046,4103,885,526,2679,9239,5
silda,2206,2239,1603,829,2362,9239,5
bouse,1555,3069,990,945,2679,9238,5
finks,847,2239,1757,628,3767,9238,5
mikey,1225,2239,406,3252,2116,9238,5
toady,1264,3069,1959,829,2116,9237,5
badon,1555,4103,774,1282,1522,9236,5
boxer,1555,3069,170,3252,1190,9236,5
monal,1225,3069,1757,2214,971,9236,5
radly,948,4103,774,1295,2116,9236,5
fayre,847,4103,381,1225,2679,9235,5
lehrs,1046,2863,334,1225,3767,9235,5
gobet,965,3069,664,3252,1284,9234,5
reina,948,2863,1668,1391,2362,9232,5
sebat,2206,2863,664,2214,1284,9231,5
mavin,1225,4103,417,1963,1522,9230,5
subet,2206,1824,664,3252,1284,9230,5
genoa,965,2863,1757,1282,2362,9229,5
gruis,965,1543,990,1963,3767,9228,5
hauge,844,4103,990,612,2679,9228,5
kumis,789,1824,885,1963,3767,9228,5
carob,1512,4103,2201,1282,129,9227,5
pardi,1184,4103,2201,829,910,9227,5
toure,1264,3069,990,1225,2679,9227,5
litae,1046,2239,1048,2214,2679,9226,5
malti,1225,4103,1603,1385,910,9226,5
pylas,1184,458,1603,2214,3767,9226,5
alius,1698,1193,1668,899,3767,9225,5
caque,1512,4103,32,899,2679,9225,5
daryn,1128,4103,2201,271,1522,9225,5
filet,847,2239,1603,3252,1284,9225,5
maist,1225,4103,1668,945,1284,9225,5
tungs,1264,1824,1757,612,3767,9224,5
docia,1128,3069,701,1963,2362,9223,5
kaury,789,4103,990,1225,2116,9223,5
meril,1225,2863,2201,1963,971,9223,5
neifs,647,2863,1668,278,3767,9223,5
tawny,1264,4103,349,1391,2116,9223,5
sevan,2206,2863,417,2214,1522,9222,5
viens,404,2239,1421,1391,3767,9222,5
arnel,1698,1543,1757,3252,971,9221,5
covel,1512,3069,417,3252,971,9221,5
verna,404,2863,2201,1391,2362,9221,5
wasty,596,4103,1021,1385,2116,9221,5
gerda,965,2863,2201,829,2362,9220,5
coble,1512,3069,664,1295,2679,9219,5
hobie,844,3069,664,1963,2679,9219,5
limos,1046,2239,885,1282,3767,9219,5
beica,1555,2863,1668,770,2362,9218,5
topia,1264,3069,560,1963,2362,9218,5
nowts,647,3069,349,1385,3767,9217,5
poule,1184,3069,990,1295,2679,9217,5
robet,948,3069,664,3252,1284,9217,5
riane,948,2239,1959,1391,2679,9216,5
bogle,1555,3069,616,1295,2679,9214,5
naric,647,4103,2201,1963,300,9214,5
datil,1128,4103,1048,1963,971,9213,5
hoary,844,3069,1959,1225,2116,9213,5
woden,596,3069,774,3252,1522,9213,5
belda,1555,2863,1603,829,2362,9212,5
mcias,1225,338,1668,2214,3767,9212,5
nerty,647,2863,2201,1385,2116,9212,5
wilen,596,2239,1603,3252,1522,9212,5
lined,1046,2239,1757,3252,917,9211,5
locks,1046,3069,701,628,3767,9211,5
selby,2206,2863,1603,423,2116,9211,5
frits,847,1543,1668,1385,3767,9210,5
leary,1046,2863,1959,1225,2116,9209,5
marci,1225,4103,2201,770,910,9209,5
aurin,1698,1824,2201,1963,1522,9208,5
norge,647,3069,2201,612,2679,9208,5
roven,948,3069,417,3252,1522,9208,5
rosed,948,3069,1021,3252,917,9207,5
conah,1512,3069,1757,2214,654,9206,5
noter,647,3069,1048,3252,1190,9206,5
hoise,844,3069,1668,945,2679,9205,5
surma,2206,1824,2201,612,2362,9205,5
wired,596,2239,2201,3252,917,9205,5
burse,1555,1824,2201,945,2679,9204,5
crabs,1512,1543,1959,423,3767,9204,5
cathy,1512,4103,1048,423,2116,9202,5
coman,1512,3069,885,2214,1522,9202,5
cuneo,1512,1824,1757,3252,857,9202,5
jorin,446,3069,2201,1963,1522,9201,5
lanti,1046,4103,1757,1385,910,9201,5
rathe,948,4103,1048,423,2679,9201,5
sanfo,2206,4103,1757,278,857,9201,5
senvy,2206,2863,1757,259,2116,9201,5
kahle,789,4103,334,1295,2679,9200,5
rabin,948,4103,664,1963,1522,9200,5
wanky,596,4103,1757,628,2116,9200,5
carpo,1512,4103,2201,526,857,9199,5
doper,1128,3069,560,3252,1190,9199,5
ourie,532,1824,2201,1963,2679,9199,5
suity,2206,1824,1668,1385,2116,9199,5
fogus,847,3069,616,899,3767,9198,5
gloea,965,1193,1426,3252,2362,9198,5
porky,1184,3069,2201,628,2116,9198,5
savor,2206,4103,417,1282,1190,9198,5
geums,965,2863,990,612,3767,9197,5
pikey,1184,2239,406,3252,2116,9197,5
bowel,1555,3069,349,3252,971,9196,5
ceram,1512,2863,2201,2214,406,9196,5
flois,847,1193,1426,1963,3767,9196,5
terah,1264,2863,2201,2214,654,9196,5
piled,1184,2239,1603,3252,917,9195,5
romps,948,3069,885,526,3767,9195,5
lapin,1046,4103,560,1963,1522,9194,5
malic,1225,4103,1603,1963,300,9194,5
danli,1128,4103,1757,1295,910,9193,5
perdy,1184,2863,2201,829,2116,9193,5
sidle,2206,2239,774,1295,2679,9193,5
orans,532,1543,1959,1391,3767,9192,5
farth,847,4103,2201,1385,654,9190,5
syria,2206,458,2201,1963,2362,9190,5
goyen,965,3069,381,3252,1522,9189,5
javel,446,4103,417,3252,971,9189,5
pavin,1184,4103,417,1963,1522,9189,5
dowie,1128,3069,349,1963,2679,9188,5
dozen,1128,3069,217,3252,1522,9188,5
gonef,965,3069,1757,3252,145,9188,5
kobus,789,3069,664,899,3767,9188,5
molge,1225,3069,1603,612,2679,9188,5
mulet,1225,1824,1603,3252,1284,9188,5
winds,596,2239,1757,829,3767,9188,5
media,1225,2863,774,1963,2362,9187,5
tahin,1264,4103,334,1963,1522,9186,5
tamil,1264,4103,885,1963,971,9186,5
mungs,1225,1824,1757,612,3767,9185,5
hotel,844,3069,1048,3252,971,9184,5
retia,948,2863,1048,1963,2362,9184,5
borax,1555,3069,2201,2214,144,9183,5
koila,789,3069,1668,1295,2362,9183,5
korai,789,3069,2201,2214,910,9183,5
monad,1225,3069,1757,2214,917,9182,5
peril,1184,2863,2201,1963,971,9182,5
porgy,1184,3069,2201,612,2116,9182,5
tavoy,1264,4103,417,1282,2116,9182,5
toker,1264,3069,406,3252,1190,9181,5
gordy,965,3069,2201,829,2116,9180,5
adzes,1698,245,217,3252,3767,9179,5
noser,647,3069,1021,3252,1190,9179,5
bator,1555,4103,1048,1282,1190,9178,5
josie,446,3069,1021,1963,2679,9178,5
gudea,965,1824,774,3252,2362,9177,5
yaker,225,4103,406,3252,1190,9176,5
besan,1555,2863,1021,2214,1522,9175,5
horsy,844,3069,2201,945,2116,9175,5
mercy,1225,2863,2201,770,2116,9175,5
canso,1512,4103,1757,945,857,9174,5
fogie,847,3069,616,1963,2679,9174,5
lovie,1046,3069,417,1963,2679,9174,5
pardo,1184,4103,2201,829,857,9174,5
siped,2206,2239,560,3252,917,9174,5
loger,1046,3069,616,3252,1190,9173,5
malto,1225,4103,1603,1385,857,9173,5
solti,2206,3069,1603,1385,910,9173,5
hudis,844,1824,774,1963,3767,9172,5
batik,1555,4103,1048,1963,502,9171,5
zoned,176,3069,1757,3252,917,9171,5
featy,847,2863,1959,1385,2116,9170,5
tache,1264,4103,701,423,2679,9170,5
roget,948,3069,616,3252,1284,9169,5
coved,1512,3069,417,3252,917,9167,5
derma,1128,2863,2201,612,2362,9166,5
yuans,225,1824,1959,1391,3767,9166,5
sergt,2206,2863,2201,612,1284,9166,5
bialy,1555,2239,1959,1295,2116,9164,5
deota,1128,2863,1426,1385,2362,9164,5
kings,789,2239,1757,612,3767,9164,5
norit,647,3069,2201,1963,1284,9164,5
bacon,1555,4103,701,1282,1522,9163,5
longe,1046,3069,1757,612,2679,9163,5
lunet,1046,1824,1757,3252,1284,9163,5
resay,948,2863,1021,2214,2116,9162,5
shane,2206,927,1959,1391,2679,9162,5
curse,1512,1824,2201,945,2679,9161,5
martu,1225,4103,2201,1385,247,9161,5
deity,1128,2863,1668,1385,2116,9160,5
lupis,1046,1824,560,1963,3767,9160,5
punks,1184,1824,1757,628,3767,9160,5
oidea,532,2239,774,3252,2362,9159,5
mayce,1225,4103,381,770,2679,9158,5
avlis,1698,126,1603,1963,3767,9157,5
flans,847,1193,1959,1391,3767,9157,5
gowen,965,3069,349,3252,1522,9157,5
hosel,844,3069,1021,3252,971,9157,5
saiph,2206,4103,1668,526,654,9157,5
chios,1512,927,1668,1282,3767,9156,5
coked,1512,3069,406,3252,917,9156,5
kenta,789,2863,1757,1385,2362,9156,5
marco,1225,4103,2201,770,857,9156,5
nodus,647,3069,774,899,3767,9156,5
sorci,2206,3069,2201,770,910,9156,5
toyer,1264,3069,381,3252,1190,9156,5
alids,1698,1193,1668,829,3767,9155,5
nilus,647,2239,1603,899,3767,9155,5
patio,1184,4103,1048,1963,857,9155,5
bandi,1555,4103,1757,829,910,9154,5
fuels,847,1824,1421,1295,3767,9154,5
sewan,2206,2863,349,2214,1522,9154,5
aider,1698,2239,774,3252,1190,9153,5
mason,1225,4103,1021,1282,1522,9153,5
mover,1225,3069,417,3252,1190,9153,5
denar,1128,2863,1757,2214,1190,9152,5
facty,847,4103,701,1385,2116,9152,5
mensa,1225,2863,1757,945,2362,9152,5
bilek,1555,2239,1603,3252,502,9151,5
flats,847,1193,1959,1385,3767,9151,5
taroc,1264,4103,2201,1282,300,9150,5
wayne,596,4103,381,1391,2679,9150,5
antis,1698,671,1048,1963,3767,9147,5
bojer,1555,3069,81,3252,1190,9147,5
teasy,1264,2863,1959,945,2116,9147,5
tykes,1264,458,406,3252,3767,9147,5
brigs,1555,1543,1668,612,3767,9145,5
brims,1555,1543,1668,612,3767,9145,5
trams,1264,1543,1959,612,3767,9145,5
pungs,1184,1824,1757,612,3767,9144,5
cesta,1512,2863,1021,1385,2362,9143,5
louys,1046,3069,990,271,3767,9143,5
pecks,1184,2863,701,628,3767,9143,5
bowed,1555,3069,349,3252,917,9142,5
campy,1512,4103,885,526,2116,9142,5
dorky,1128,3069,2201,628,2116,9142,5
gomel,965,3069,885,3252,971,9142,5
ponca,1184,3069,1757,770,2362,9142,5
dikey,1128,2239,406,3252,2116,9141,5
hague,844,4103,616,899,2679,9141,5
rebus,948,2863,664,899,3767,9141,5
gober,965,3069,664,3252,1190,9140,5
rowen,948,3069,349,3252,1522,9140,5
stray,2206,403,2201,2214,2116,9140,5
volte,404,3069,1603,1385,2679,9140,5
donal,1128,3069,1757,2214,971,9139,5
paton,1184,4103,1048,1282,1522,9139,5
dorje,1128,3069,2201,61,2679,9138,5
hazle,844,4103,217,1295,2679,9138,5
milne,1225,2239,1603,1391,2679,9137,5
sline,2206,1193,1668,1391,2679,9137,5
galik,965,4103,1603,1963,502,9136,5
suber,2206,1824,664,3252,1190,9136,5
javed,446,4103,417,3252,917,9135,5
lepus,1046,2863,560,899,3767,9135,5
stria,2206,403,2201,1963,2362,9135,5
percy,1184,2863,2201,770,2116,9134,5
roice,948,3069,1668,770,2679,9134,5
telar,1264,2863,1603,2214,1190,9134,5
davin,1128,4103,417,1963,1522,9133,5
ariel,1698,1543,1668,3252,971,9132,5
foder,847,3069,774,3252,1190,9132,5
radke,948,4103,774,628,2679,9132,5
coyed,1512,3069,381,3252,917,9131,5
filer,847,2239,1603,3252,1190,9131,5
mache,1225,4103,701,423,2679,9131,5
munia,1225,1824,1757,1963,2362,9131,5
pirny,1184,2239,2201,1391,2116,9131,5
signe,2206,2239,616,1391,2679,9131,5
slite,2206,1193,1668,1385,2679,9131,5
viols,404,2239,1426,1295,3767,9131,5
hefts,844,2863,271,1385,3767,9130,5
hoder,844,3069,774,3252,1190,9129,5
warst,596,4103,2201,945,1284,9129,5
geary,965,2863,1959,1225,2116,9128,5
marsh,1225,4103,2201,945,654,9128,5
mobed,1225,3069,664,3252,917,9127,5
dormy,1128,3069,2201,612,2116,9126,5
bargh,1555,4103,2201,612,654,9125,5
jarvy,446,4103,2201,259,2116,9125,5
verla,404,2863,2201,1295,2362,9125,5
lemay,1046,2863,885,2214,2116,9124,5
tower,1264,3069,349,3252,1190,9124,5
hotei,844,3069,1048,3252,910,9123,5
konde,789,3069,1757,829,2679,9123,5
beaky,1555,2863,1959,628,2116,9121,5
carum,1512,4103,2201,899,406,9121,5
senti,2206,2863,1757,1385,910,9121,5
wytes,596,458,1048,3252,3767,9121,5
zenia,176,2863,1757,1963,2362,9121,5
bendy,1555,2863,1757,829,2116,9120,5
sicle,2206,2239,701,1295,2679,9120,5
nepos,647,2863,560,1282,3767,9119,5
toged,1264,3069,616,3252,917,9118,5
aiken,1698,2239,406,3252,1522,9117,5
buine,1555,1824,1668,1391,2679,9117,5
cadgy,1512,4103,774,612,2116,9117,5
loper,1046,3069,560,3252,1190,9117,5
moyer,1225,3069,381,3252,1190,9117,5
voile,404,3069,1668,1295,2679,9115,5
cumae,1512,1824,885,2214,2679,9114,5
gapin,965,4103,560,1963,1522,9113,5
rocks,948,3069,701,628,3767,9113,5
ceuta,1512,2863,990,1385,2362,9112,5
darci,1128,4103,2201,770,910,9112,5
candi,1512,4103,1757,829,910,9111,5
heian,844,2863,1668,2214,1522,9111,5
maroc,1225,4103,2201,1282,300,9111,5
benil,1555,2863,1757,1963,971,9109,5
toher,1264,3069,334,3252,1190,9109,5
lidos,1046,2239,774,1282,3767,9108,5
ohias,532,927,1668,2214,3767,9108,5
bluey,1555,1193,990,3252,2116,9106,5
gybes,965,458,664,3252,3767,9106,5
hiate,844,2239,1959,1385,2679,9106,5
jahel,446,4103,334,3252,971,9106,5
moxie,1225,3069,170,1963,2679,9106,5
beamy,1555,2863,1959,612,2116,9105,5
bidet,1555,2239,774,3252,1284,9104,5
dunks,1128,1824,1757,628,3767,9104,5
hoven,844,3069,417,3252,1522,9104,5
sizer,2206,2239,217,3252,1190,9104,5
backy,1555,4103,701,628,2116,9103,5
deair,1128,2863,1959,1963,1190,9103,5
hosed,844,3069,1021,3252,917,9103,5
polit,1184,3069,1603,1963,1284,9103,5
kosel,789,3069,1021,3252,971,9102,5
molpe,1225,3069,1603,526,2679,9102,5
bando,1555,4103,1757,829,857,9101,5
poker,1184,3069,406,3252,1190,9101,5
anils,1698,671,1668,1295,3767,9099,5
cabio,1512,4103,664,1963,857,9099,5
cowed,1512,3069,349,3252,917,9099,5
klans,789,1193,1959,1391,3767,9099,5
oaric,532,4103,2201,1963,300,9099,5
surah,2206,1824,2201,2214,654,9099,5
carbo,1512,4103,2201,423,857,9096,5
feral,847,2863,2201,2214,971,9096,5
orals,532,1543,1959,1295,3767,9096,5
roily,948,3069,1668,1295,2116,9096,5
aliet,1698,1193,1668,3252,1284,9095,5
brays,1555,1543,1959,271,3767,9095,5
hydes,844,458,774,3252,3767,9095,5
melar,1225,2863,1603,2214,1190,9095,5
bagio,1555,4103,616,1963,857,9094,5
boart,1555,3069,1959,1225,1284,9092,5
sacro,2206,4103,701,1225,857,9092,5
forma,847,3069,2201,612,2362,9091,5
tarmi,1264,4103,2201,612,910,9090,5
segar,2206,2863,616,2214,1190,9089,5
boric,1555,3069,2201,1963,300,9088,5
dungs,1128,1824,1757,612,3767,9088,5
leona,1046,2863,1426,1391,2362,9088,5
burny,1555,1824,2201,1391,2116,9087,5
cyans,1512,458,1959,1391,3767,9087,5
cosin,1512,3069,1021,1963,1522,9087,5
dawny,1128,4103,349,1391,2116,9087,5
decks,1128,2863,701,628,3767,9087,5
blams,1555,1193,1959,612,3767,9086,5
genty,965,2863,1757,1385,2116,9086,5
grots,965,1543,1426,1385,3767,9086,5
yelks,225,2863,1603,628,3767,9086,5
numis,647,1824,885,1963,3767,9086,5
phren,1184,927,2201,3252,1522,9086,5
mower,1225,3069,349,3252,1190,9085,5
crane,1512,1543,1959,1391,2679,9084,5
fonly,847,3069,1757,1295,2116,9084,5
geira,965,2863,1668,1225,2362,9083,5
sible,2206,2239,664,1295,2679,9083,5
tophs,1264,3069,560,423,3767,9083,5
conky,1512,3069,1757,628,2116,9082,5
leota,1046,2863,1426,1385,2362,9082,5
burty,1555,1824,2201,1385,2116,9081,5
sitra,2206,2239,1048,1225,2362,9080,5
tapir,1264,4103,560,1963,1190,9080,5
tonka,1264,3069,1757,628,2362,9080,5
coude,1512,3069,990,829,2679,9079,5
crate,1512,1543,1959,1385,2679,9078,5
dercy,1128,2863,2201,770,2116,9078,5
soche,2206,3069,701,423,2679,9078,5
corti,1512,3069,2201,1385,910,9077,5
healy,844,2863,1959,1295,2116,9077,5
soign,2206,3069,1668,612,1522,9077,5
atren,1698,403,2201,3252,1522,9076,5
dhals,1128,927,1959,1295,3767,9076,5
mirly,1225,2239,2201,1295,2116,9076,5
boyne,1555,3069,381,1391,2679,9075,5
scray,2206,338,2201,2214,2116,9075,5
nawle,647,4103,349,1295,2679,9073,5
spray,2206,336,2201,2214,2116,9073,5
route,948,3069,990,1385,2679,9071,5
auden,1698,1824,774,3252,1522,9070,5
pujas,1184,1824,81,2214,3767,9070,5
dirty,1128,2239,2201,1385,2116,9069,5
tokay,1264,3069,406,2214,2116,9069,5
films,847,2239,1603,612,3767,9068,5
jawed,446,4103,349,3252,917,9067,5
kafre,789,4103,271,1225,2679,9067,5
keita,789,2863,1668,1385,2362,9067,5
peasy,1184,2863,1959,945,2116,9067,5
shale,2206,927,1959,1295,2679,9066,5
burin,1555,1824,2201,1963,1522,9065,5
prams,1184,1543,1959,612,3767,9065,5
chaus,1512,927,1959,899,3767,9064,5
samul,2206,4103,885,899,971,9064,5
tonga,1264,3069,1757,612,2362,9064,5
grads,965,1543,1959,829,3767,9063,5
fordy,847,3069,2201,829,2116,9062,5
toped,1264,3069,560,3252,917,9062,5
mirex,1225,2239,2201,3252,144,9061,5
prius,1184,1543,1668,899,3767,9061,5
derah,1128,2863,2201,2214,654,9060,5
traps,1264,1543,1959,526,3767,9059,5
cando,1512,4103,1757,829,857,9058,5
caryl,1512,4103,2201,271,971,9058,5
marou,1225,4103,2201,1282,247,9058,5
loket,1046,3069,406,3252,1284,9057,5
sixer,2206,2239,170,3252,1190,9057,5
birsy,1555,2239,2201,945,2116,9056,5
dover,1128,3069,417,3252,1190,9056,5
logia,1046,3069,616,1963,2362,9056,5
viers,404,2239,1421,1225,3767,9056,5
gambe,965,4103,885,423,2679,9055,5
guids,965,1824,1668,829,3767,9053,5
puler,1184,1824,1603,3252,1190,9053,5
beant,1555,2863,1959,1391,1284,9052,5
peron,1184,2863,2201,1282,1522,9052,5
fagin,847,4103,616,1963,1522,9051,5
margi,1225,4103,2201,612,910,9051,5
mosan,1225,3069,1021,2214,1522,9051,5
coart,1512,3069,1959,1225,1284,9049,5
cuifs,1512,1824,1668,278,3767,9049,5
norad,647,3069,2201,2214,917,9048,5
bantu,1555,4103,1757,1385,247,9047,5
softy,2206,3069,271,1385,2116,9047,5
hulen,844,1824,1603,3252,1522,9045,5
power,1184,3069,349,3252,1190,9044,5
bowne,1555,3069,349,1391,2679,9043,5
clags,1512,1193,1959,612,3767,9043,5
clams,1512,1193,1959,612,3767,9043,5
banco,1555,4103,1757,770,857,9042,5
kathe,789,4103,1048,423,2679,9042,5
selim,2206,2863,1603,1963,406,9041,5
berun,1555,2863,2201,899,1522,9040,5
lakin,1046,4103,406,1963,1522,9040,5
tonye,1264,3069,1757,271,2679,9040,5
beman,1555,2863,885,2214,1522,9039,5
camby,1512,4103,885,423,2116,9039,5
alvis,1698,1193,417,1963,3767,9038,5
saudi,2206,4103,990,829,910,9038,5
waxed,596,4103,170,3252,917,9038,5
earth,693,4103,2201,1385,654,9036,5
martz,1225,4103,2201,1385,122,9036,5
curat,1512,1824,2201,2214,1284,9035,5
tobys,1264,3069,664,271,3767,9035,5
dache,1128,4103,701,423,2679,9034,5
wilds,596,2239,1603,829,3767,9034,5
winer,596,2239,1757,3252,1190,9034,5
dryas,1128,1543,381,2214,3767,9033,5
korma,789,3069,2201,612,2362,9033,5
super,2206,1824,560,3252,1190,9032,5
brale,1555,1543,1959,1295,2679,9031,5
godel,965,3069,774,3252,971,9031,5
girse,965,2239,2201,945,2679,9029,5
vasty,404,4103,1021,1385,2116,9029,5
aisne,1698,2239,1021,1391,2679,9028,5
salvo,2206,4103,1603,259,857,9028,5
sowar,2206,3069,349,2214,1190,9028,5
sepoy,2206,2863,560,1282,2116,9027,5
besra,1555,2863,1021,1225,2362,9026,5
cutie,1512,1824,1048,1963,2679,9026,5
novae,647,3069,417,2214,2679,9026,5
aeric,1698,2863,2201,1963,300,9025,5
fyces,847,458,701,3252,3767,9025,5
judas,446,1824,774,2214,3767,9025,5
funds,847,1824,1757,829,3767,9024,5
shiel,2206,927,1668,3252,971,9024,5
gobia,965,3069,664,1963,2362,9023,5
moped,1225,3069,560,3252,917,9023,5
curin,1512,1824,2201,1963,1522,9022,5
decay,1128,2863,701,2214,2116,9022,5
lunks,1046,1824,1757,628,3767,9022,5
nobie,647,3069,664,1963,2679,9022,5
silma,2206,2239,1603,612,2362,9022,5
taxin,1264,4103,170,1963,1522,9022,5
afros,1698,73,2201,1282,3767,9021,5
pauky,1184,4103,990,628,2116,9021,5
bouar,1555,3069,990,2214,1190,9018,5
tacye,1264,4103,701,271,2679,9018,5
chots,1512,927,1426,1385,3767,9017,5
picae,1184,2239,701,2214,2679,9017,5
thins,1264,927,1668,1391,3767,9017,5
braws,1555,1543,1959,192,3767,9016,5
crips,1512,1543,1668,526,3767,9016,5
tulia,1264,1824,1603,1963,2362,9016,5
aerol,1698,2863,2201,1282,971,9015,5
donsy,1128,3069,1757,945,2116,9015,5
fadge,847,4103,774,612,2679,9015,5
fadme,847,4103,774,612,2679,9015,5
fraus,847,1543,1959,899,3767,9015,5
marko,1225,4103,2201,628,857,9014,5
tuned,1264,1824,1757,3252,917,9014,5
botry,1555,3069,1048,1225,2116,9013,5
ranli,948,4103,1757,1295,910,9013,5
fined,847,2239,1757,3252,917,9012,5
loave,1046,3069,1959,259,2679,9012,5
bited,1555,2239,1048,3252,917,9011,5
dykes,1128,458,406,3252,3767,9011,5
newts,647,2863,349,1385,3767,9011,5
bider,1555,2239,774,3252,1190,9010,5
sakti,2206,4103,406,1385,910,9010,5
doxie,1128,3069,170,1963,2679,9009,5
drags,1128,1543,1959,612,3767,9009,5
drams,1128,1543,1959,612,3767,9009,5
hocks,844,3069,701,628,3767,9009,5
lesiy,1046,2863,1021,1963,2116,9009,5
noise,647,3069,1668,945,2679,9008,5
tenai,1264,2863,1757,2214,910,9008,5
johns,446,3069,334,1391,3767,9007,5
jorge,446,3069,2201,612,2679,9007,5
kubis,789,1824,664,1963,3767,9007,5
farsi,847,4103,2201,945,910,9006,5
lochs,1046,3069,701,423,3767,9006,5
lungs,1046,1824,1757,612,3767,9006,5
lawny,1046,4103,349,1391,2116,9005,5
merak,1225,2863,2201,2214,502,9005,5
cantu,1512,4103,1757,1385,247,9004,5
elans,693,1193,1959,1391,3767,9003,5
forcy,847,3069,2201,770,2116,9003,5
gaudy,965,4103,990,829,2116,9003,5
ghats,965,927,1959,1385,3767,9003,5
fanti,847,4103,1757,1385,910,9002,5
laton,1046,4103,1048,1282,1522,9001,5
shoer,2206,927,1426,3252,1190,9001,5
jayne,446,4103,381,1391,2679,9000,5
cusie,1512,1824,1021,1963,2679,8999,5
litus,1046,2239,1048,899,3767,8999,5
kesia,789,2863,1021,1963,2362,8998,5
margo,1225,4103,2201,612,857,8998,5
duler,1128,1824,1603,3252,1190,8997,5
deron,1128,2863,2201,1282,1522,8996,5
share,2206,927,1959,1225,2679,8996,5
aiger,1698,2239,616,3252,1190,8995,5
belga,1555,2863,1603,612,2362,8995,5
penda,1184,2863,1757,829,2362,8995,5
chads,1512,927,1959,829,3767,8994,5
perky,1184,2863,2201,628,2116,8992,5
tozer,1264,3069,217,3252,1190,8992,5
aimed,1698,2239,885,3252,917,8991,5
arcos,1698,1543,701,1282,3767,8991,5
burly,1555,1824,2201,1295,2116,8991,5
valid,404,4103,1603,1963,917,8990,5
givey,965,2239,417,3252,2116,8989,5
penal,1184,2863,1757,2214,971,8989,5
altos,1698,1193,1048,1282,3767,8988,5
dower,1128,3069,349,3252,1190,8988,5
polad,1184,3069,1603,2214,917,8987,5
simla,2206,2239,885,1295,2362,8987,5
winks,596,2239,1757,628,3767,8987,5
muran,1225,1824,2201,2214,1522,8986,5
yelps,225,2863,1603,526,3767,8984,5
ponga,1184,3069,1757,612,2362,8984,5
nitos,647,2239,1048,1282,3767,8983,5
ayins,1698,458,1668,1391,3767,8982,5
risen,948,2239,1021,3252,1522,8982,5
coban,1512,3069,664,2214,1522,8981,5
duane,1128,1824,1959,1391,2679,8981,5
vetus,404,2863,1048,899,3767,8981,5
xenia,36,2863,1757,1963,2362,8981,5
peony,1184,2863,1426,1391,2116,8980,5
boyle,1555,3069,381,1295,2679,8979,5
capon,1512,4103,560,1282,1522,8979,5
gorky,965,3069,2201,628,2116,8979,5
gowds,965,3069,349,829,3767,8979,5
siple,2206,2239,560,1295,2679,8979,5
aleus,1698,1193,1421,899,3767,8978,5
joser,446,3069,1021,3252,1190,8978,5
sunda,2206,1824,1757,829,2362,8978,5
cipus,1512,2239,560,899,3767,8977,5
sozin,2206,3069,217,1963,1522,8977,5
bogan,1555,3069,616,2214,1522,8976,5
gonal,965,3069,1757,2214,971,8976,5
menad,1225,2863,1757,2214,917,8976,5
verny,404,2863,2201,1391,2116,8975,5
basti,1555,4103,1021,1385,910,8974,5
falun,847,4103,1603,899,1522,8974,5
frons,847,1543,1426,1391,3767,8974,5
gerdy,965,2863,2201,829,2116,8974,5
joeys,446,3069,1421,271,3767,8974,5
lover,1046,3069,417,3252,1190,8974,5
arite,1698,1543,1668,1385,2679,8973,5
craws,1512,1543,1959,192,3767,8973,5
tyros,1264,458,2201,1282,3767,8972,5
wings,596,2239,1757,612,3767,8971,5
foute,847,3069,990,1385,2679,8970,5
gavin,965,4103,417,1963,1522,8970,5
yawps,225,4103,349,526,3767,8970,5
rovet,948,3069,417,3252,1284,8970,5
shied,2206,927,1668,3252,917,8970,5
birma,1555,2239,2201,612,2362,8969,5
verty,404,2863,2201,1385,2116,8969,5
celka,1512,2863,1603,628,2362,8968,5
cited,1512,2239,1048,3252,917,8968,5
hadit,844,4103,774,1963,1284,8968,5
minta,1225,2239,1757,1385,2362,8968,5
biota,1555,2239,1426,1385,2362,8967,5
cider,1512,2239,774,3252,1190,8967,5
cozed,1512,3069,217,3252,917,8967,5
homed,844,3069,885,3252,917,8967,5
cavil,1512,4103,417,1963,971,8966,5
kohen,789,3069,334,3252,1522,8966,5
chria,1512,927,2201,1963,2362,8965,5
gaist,965,4103,1668,945,1284,8965,5
henty,844,2863,1757,1385,2116,8965,5
iatry,473,4103,1048,1225,2116,8965,5
kiran,789,2239,2201,2214,1522,8965,5
ronda,948,3069,1757,829,2362,8965,5
byars,1555,458,1959,1225,3767,8964,5
cahuy,1512,4103,334,899,2116,8964,5
direx,1128,2239,2201,3252,144,8964,5
gurle,965,1824,2201,1295,2679,8964,5
perak,1184,2863,2201,2214,502,8964,5
boxed,1555,3069,170,3252,917,8963,5
frets,847,1543,1421,1385,3767,8963,5
voter,404,3069,1048,3252,1190,8963,5
tadio,1264,4103,774,1963,857,8961,5
epris,693,336,2201,1963,3767,8960,5
laird,1046,4103,1668,1225,917,8959,5
riled,948,2239,1603,3252,917,8959,5
ronal,948,3069,1757,2214,971,8959,5
surgy,2206,1824,2201,612,2116,8959,5
writs,596,1543,1668,1385,3767,8959,5
claps,1512,1193,1959,526,3767,8957,5
kraus,789,1543,1959,899,3767,8957,5
pargo,1184,4103,2201,612,857,8957,5
goety,965,3069,1421,1385,2116,8956,5
artus,1698,1543,1048,899,3767,8955,5
manul,1225,4103,1757,899,971,8955,5
plots,1184,1193,1426,1385,3767,8955,5
pondy,1184,3069,1757,829,2116,8955,5
torun,1264,3069,2201,899,1522,8955,5
burez,1555,1824,2201,3252,122,8954,5
miter,1225,2239,1048,3252,1190,8954,5
toman,1264,3069,885,2214,1522,8954,5
march,1225,4103,2201,770,654,8953,5
ravin,948,4103,417,1963,1522,8953,5
vireo,404,2239,2201,3252,857,8953,5
bawdy,1555,4103,349,829,2116,8952,5
hayse,844,4103,381,945,2679,8952,5
keary,789,2863,1959,1225,2116,8952,5
lache,1046,4103,701,423,2679,8952,5
suety,2206,1824,1421,1385,2116,8952,5
sofar,2206,3069,271,2214,1190,8950,5
curly,1512,1824,2201,1295,2116,8948,5
lobed,1046,3069,664,3252,917,8948,5
bowle,1555,3069,349,1295,2679,8947,5
touse,1264,3069,990,945,2679,8947,5
sinky,2206,2239,1757,628,2116,8946,5
gaucy,965,4103,990,770,2116,8944,5
halfy,844,4103,1603,278,2116,8944,5
limen,1046,2239,885,3252,1522,8944,5
spaer,2206,336,1959,3252,1190,8943,5
basic,1555,4103,1021,1963,300,8942,5
gunks,965,1824,1757,628,3767,8941,5
birdy,1555,2239,2201,829,2116,8940,5
lucey,1046,1824,701,3252,2116,8939,5
warth,596,4103,2201,1385,654,8939,5
audie,1698,1824,774,1963,2679,8938,5
pechs,1184,2863,701,423,3767,8938,5
coyle,1512,3069,381,1295,2679,8936,5
loram,1046,3069,2201,2214,406,8936,5
vinet,404,2239,1757,3252,1284,8936,5
lecia,1046,2863,701,1963,2362,8935,5
royet,948,3069,381,3252,1284,8934,5
cogan,1512,3069,616,2214,1522,8933,5
noted,647,3069,1048,3252,917,8933,5
aisle,1698,2239,1021,1295,2679,8932,5
fatil,847,4103,1048,1963,971,8932,5
moble,1225,3069,664,1295,2679,8932,5
poway,1184,3069,349,2214,2116,8932,5
artie,1698,1543,1048,1963,2679,8931,5
goave,965,3069,1959,259,2679,8931,5
jodie,446,3069,774,1963,2679,8931,5
whoas,596,927,1426,2214,3767,8930,5
lykes,1046,458,406,3252,3767,8929,5
donga,1128,3069,1757,612,2362,8928,5
stoae,2206,403,1426,2214,2679,8928,5
dasnt,1128,4103,1021,1391,1284,8927,5
korah,789,3069,2201,2214,654,8927,5
miser,1225,2239,1021,3252,1190,8927,5
pinta,1184,2239,1757,1385,2362,8927,5
suave,2206,1824,1959,259,2679,8927,5
doisy,1128,3069,1668,945,2116,8926,5
jowls,446,3069,349,1295,3767,8926,5
halvy,844,4103,1603,259,2116,8925,5
sangu,2206,4103,1757,612,247,8925,5
besin,1555,2863,1021,1963,1522,8924,5
gecks,965,2863,701,628,3767,8924,5
lifey,1046,2239,271,3252,2116,8924,5
gauze,965,4103,990,186,2679,8923,5
oinks,532,2239,1757,628,3767,8923,5
onces,532,671,701,3252,3767,8923,5
gonad,965,3069,1757,2214,917,8922,5
leora,1046,2863,1426,1225,2362,8922,5
basto,1555,4103,1021,1385,857,8921,5
seton,2206,2863,1048,1282,1522,8921,5
berni,1555,2863,2201,1391,910,8920,5
coxed,1512,3069,170,3252,917,8920,5
damon,1128,4103,885,1282,1522,8920,5
hawse,844,4103,349,945,2679,8920,5
jamin,446,4103,885,1963,1522,8919,5
monah,1225,3069,1757,2214,654,8919,5
ratio,948,4103,1048,1963,857,8919,5
haply,844,4103,560,1295,2116,8918,5
paoli,1184,4103,1426,1295,910,8918,5
hemia,844,2863,885,1963,2362,8917,5
hoper,844,3069,560,3252,1190,8915,5
yumas,225,1824,885,2214,3767,8915,5
jubas,446,1824,664,2214,3767,8915,5
rhoea,948,927,1426,3252,2362,8915,5
adley,1698,245,1603,3252,2116,8914,5
berti,1555,2863,2201,1385,910,8914,5
lasky,1046,4103,1021,628,2116,8914,5
contr,1512,3069,1757,1385,1190,8913,5
cribs,1512,1543,1668,423,3767,8913,5
turse,1264,1824,2201,945,2679,8913,5
augen,1698,1824,616,3252,1522,8912,5
girny,965,2239,2201,1391,2116,8912,5
parch,1184,4103,2201,770,654,8912,5
tabid,1264,4103,664,1963,917,8911,5
redia,948,2863,774,1963,2362,8910,5
fidos,847,2239,774,1282,3767,8909,5
baioc,1555,4103,1668,1282,300,8908,5
cetin,1512,2863,1048,1963,1522,8908,5
hirse,844,2239,2201,945,2679,8908,5
konev,789,3069,1757,3252,41,8908,5
mouse,1225,3069,990,945,2679,8908,5
rungs,948,1824,1757,612,3767,8908,5
toked,1264,3069,406,3252,917,8908,5
recks,948,2863,701,628,3767,8907,5
soupy,2206,3069,990,526,2116,8907,5
argos,1698,1543,616,1282,3767,8906,5
lower,1046,3069,349,3252,1190,8906,5
nosed,647,3069,1021,3252,917,8906,5
bouge,1555,3069,990,612,2679,8905,5
towel,1264,3069,349,3252,971,8905,5
cowle,1512,3069,349,1295,2679,8904,5
howie,844,3069,349,1963,2679,8904,5
raton,948,4103,1048,1282,1522,8903,5
sewin,2206,2863,349,1963,1522,8903,5
sozly,2206,3069,217,1295,2116,8903,5
mosra,1225,3069,1021,1225,2362,8902,5
rowet,948,3069,349,3252,1284,8902,5
dargo,1128,4103,2201,612,857,8901,5
ritus,948,2239,1048,899,3767,8901,5
tayir,1264,4103,381,1963,1190,8901,5
armen,1698,1543,885,3252,1522,8900,5
jouks,446,3069,990,628,3767,8900,5
nathe,647,4103,1048,423,2679,8900,5
lotan,1046,3069,1048,2214,1522,8899,5
luane,1046,1824,1959,1391,2679,8899,5
bandh,1555,4103,1757,829,654,8898,5
facit,847,4103,701,1963,1284,8898,5
blahs,1555,1193,1959,423,3767,8897,5
gerah,965,2863,2201,2214,654,8897,5
paque,1184,4103,32,899,2679,8897,5
sitar,2206,2239,1048,2214,1190,8897,5
zerla,176,2863,2201,1295,2362,8897,5
bauno,1555,4103,990,1391,857,8896,5
daunt,1128,4103,990,1391,1284,8896,5
hanoi,844,4103,1757,1282,910,8896,5
neral,647,2863,2201,2214,971,8896,5
selig,2206,2863,1603,1963,261,8896,5
davit,1128,4103,417,1963,1284,8895,5
neuks,647,2863,990,628,3767,8895,5
slone,2206,1193,1426,1391,2679,8895,5
cosme,1512,3069,1021,612,2679,8893,5
cried,1512,1543,1668,3252,917,8892,5
norma,647,3069,2201,612,2362,8891,5
belah,1555,2863,1603,2214,654,8889,5
duran,1128,1824,2201,2214,1522,8889,5
maori,1225,4103,1426,1225,910,8889,5
slote,2206,1193,1426,1385,2679,8889,5
suzie,2206,1824,217,1963,2679,8889,5
mashy,1225,4103,1021,423,2116,8888,5
burke,1555,1824,2201,628,2679,8887,5
bursa,1555,1824,2201,945,2362,8887,5
hardi,844,4103,2201,829,910,8887,5
manso,1225,4103,1757,945,857,8887,5
molka,1225,3069,1603,628,2362,8887,5
ouray,532,1824,2201,2214,2116,8887,5
hylas,844,458,1603,2214,3767,8886,5
karyn,789,4103,2201,271,1522,8886,5
hemps,844,2863,885,526,3767,8885,5
rawin,948,4103,349,1963,1522,8885,5
jougs,446,3069,990,612,3767,8884,5
flrie,847,1193,2201,1963,2679,8883,5
hiems,844,2239,1421,612,3767,8883,5
toyed,1264,3069,381,3252,917,8883,5
herma,844,2863,2201,612,2362,8882,5
melda,1225,2863,1603,829,2362,8882,5
wefts,596,2863,271,1385,3767,8882,5
chien,1512,927,1668,3252,1522,8881,5
hypes,844,458,560,3252,3767,8881,5
dulia,1128,1824,1603,1963,2362,8880,5
moved,1225,3069,417,3252,917,8880,5
nealy,647,2863,1959,1295,2116,8880,5
sacul,2206,4103,701,899,971,8880,5
bavon,1555,4103,417,1282,1522,8879,5
neums,647,2863,990,612,3767,8879,5
sekar,2206,2863,406,2214,1190,8879,5
fauve,847,4103,990,259,2679,8878,5
biola,1555,2239,1426,1295,2362,8877,5
copan,1512,3069,560,2214,1522,8877,5
rason,948,4103,1021,1282,1522,8876,5
terza,1264,2863,2201,186,2362,8876,5
lynea,1046,458,1757,3252,2362,8875,5
pathy,1184,4103,1048,423,2116,8874,5
nashe,647,4103,1021,423,2679,8873,5
wasir,596,4103,1021,1963,1190,8873,5
biela,1555,2239,1421,1295,2362,8872,5
janot,446,4103,1757,1282,1284,8872,5
burge,1555,1824,2201,612,2679,8871,5
eably,693,4103,664,1295,2116,8871,5
shine,2206,927,1668,1391,2679,8871,5
segal,2206,2863,616,2214,971,8870,5
buote,1555,1824,1426,1385,2679,8869,5
edris,693,245,2201,1963,3767,8869,5
slade,2206,1193,1959,829,2679,8866,5
kolar,789,3069,1603,2214,1190,8865,5
laeti,1046,4103,1421,1385,910,8865,5
minoa,1225,2239,1757,1282,2362,8865,5
pensy,1184,2863,1757,945,2116,8865,5
fonda,847,3069,1757,829,2362,8864,5
surya,2206,1824,2201,271,2362,8864,5
dione,1128,2239,1426,1391,2679,8863,5
tandi,1264,4103,1757,829,910,8863,5
marbi,1225,4103,2201,423,910,8862,5
nurbs,647,1824,2201,423,3767,8862,5
forky,847,3069,2201,628,2116,8861,5
honda,844,3069,1757,829,2362,8861,5
bauld,1555,4103,990,1295,917,8860,5
fikey,847,2239,406,3252,2116,8860,5
flits,847,1193,1668,1385,3767,8860,5
wenoa,596,2863,1757,1282,2362,8860,5
dirge,1128,2239,2201,612,2679,8859,5
gyves,965,458,417,3252,3767,8859,5
slaty,2206,1193,1959,1385,2116,8859,5
blier,1555,1193,1668,3252,1190,8858,5
filed,847,2239,1603,3252,917,8858,5
habit,844,4103,664,1963,1284,8858,5
diter,1128,2239,1048,3252,1190,8857,5
mauby,1225,4103,990,423,2116,8857,5
dozer,1128,3069,217,3252,1190,8856,5
ferdy,847,2863,2201,829,2116,8856,5
laith,1046,4103,1668,1385,654,8856,5
woven,596,3069,417,3252,1522,8856,5
delua,1128,2863,1603,899,2362,8855,5
biune,1555,2239,990,1391,2679,8854,5
galut,965,4103,1603,899,1284,8854,5
rache,948,4103,701,423,2679,8854,5
trigs,1264,1543,1668,612,3767,8854,5
trims,1264,1543,1668,612,3767,8854,5
favin,847,4103,417,1963,1522,8852,5
kurys,789,1824,2201,271,3767,8852,5
amins,1698,327,1668,1391,3767,8851,5
mohel,1225,3069,334,3252,971,8851,5
okras,532,137,2201,2214,3767,8851,5
towed,1264,3069,349,3252,917,8851,5
olney,532,1193,1757,3252,2116,8850,5
robed,948,3069,664,3252,917,8850,5
alecs,1698,1193,1421,770,3767,8849,5
hasid,844,4103,1021,1963,917,8848,5
genua,965,2863,1757,899,2362,8846,5
grams,965,1543,1959,612,3767,8846,5
yawed,225,4103,349,3252,917,8846,5
lakme,1046,4103,406,612,2679,8846,5
longa,1046,3069,1757,612,2362,8846,5
polka,1184,3069,1603,628,2362,8846,5
cabot,1512,4103,664,1282,1284,8845,5
formy,847,3069,2201,612,2116,8845,5
woken,596,3069,406,3252,1522,8845,5
biose,1555,2239,1426,945,2679,8844,5
cursa,1512,1824,2201,945,2362,8844,5
loped,1046,3069,560,3252,917,8844,5
soult,2206,3069,990,1295,1284,8844,5
buoys,1555,1824,1426,271,3767,8843,5
slain,2206,1193,1959,1963,1522,8843,5
womps,596,3069,885,526,3767,8843,5
binge,1555,2239,1757,612,2679,8842,5
cisne,1512,2239,1021,1391,2679,8842,5
golpe,965,3069,1603,526,2679,8842,5
jarib,446,4103,2201,1963,129,8842,5
moldy,1225,3069,1603,829,2116,8842,5
viner,404,2239,1757,3252,1190,8842,5
delit,1128,2863,1603,1963,1284,8841,5
doncy,1128,3069,1757,770,2116,8840,5
lawry,1046,4103,349,1225,2116,8839,5
valmy,404,4103,1603,612,2116,8838,5
cyrus,1512,458,2201,899,3767,8837,5
fardo,847,4103,2201,829,857,8837,5
jinks,446,2239,1757,628,3767,8837,5
brine,1555,1543,1668,1391,2679,8836,5
cymas,1512,458,885,2214,3767,8836,5
coati,1512,3069,1959,1385,910,8835,5
doble,1128,3069,664,1295,2679,8835,5
neila,647,2863,1668,1295,2362,8835,5
etnas,693,403,1757,2214,3767,8834,5
floey,847,1193,1426,3252,2116,8834,5
khans,789,927,1959,1391,3767,8833,5
macon,1225,4103,701,1282,1522,8833,5
purse,1184,1824,2201,945,2679,8833,5
cobra,1512,3069,664,1225,2362,8832,5
genit,965,2863,1757,1963,1284,8832,5
farci,847,4103,2201,770,910,8831,5
pyxes,1184,458,170,3252,3767,8831,5
reasy,948,2863,1959,945,2116,8831,5
rykes,948,458,406,3252,3767,8831,5
sized,2206,2239,217,3252,917,8831,5
sluer,2206,1193,990,3252,1190,8831,5
brite,1555,1543,1668,1385,2679,8830,5
corpn,1512,3069,2201,526,1522,8830,5
kemps,789,2863,885,526,3767,8830,5
timer,1264,2239,885,3252,1190,8830,5
roxie,948,3069,170,1963,2679,8829,5
ceiba,1512,2863,1668,423,2362,8828,5
golda,965,3069,1603,829,2362,8828,5
poked,1184,3069,406,3252,917,8828,5
khats,789,927,1959,1385,3767,8827,5
nolde,647,3069,1603,829,2679,8827,5
terap,1264,2863,2201,2214,285,8827,5
cuter,1512,1824,1048,3252,1190,8826,5
gower,965,3069,349,3252,1190,8825,5
keota,789,2863,1426,1385,2362,8825,5
nalor,647,4103,1603,1282,1190,8825,5
powel,1184,3069,349,3252,971,8825,5
mandi,1225,4103,1757,829,910,8824,5
funks,847,1824,1757,628,3767,8823,5
rafty,948,4103,271,1385,2116,8823,5
volta,404,3069,1603,1385,2362,8823,5
hazem,844,4103,217,3252,406,8822,5
sewar,2206,2863,349,2214,1190,8822,5
jobie,446,3069,664,1963,2679,8821,5
muled,1225,1824,1603,3252,917,8821,5
drabs,1128,1543,1959,423,3767,8820,5
hunks,844,1824,1757,628,3767,8820,5
kenly,789,2863,1757,1295,2116,8820,5
largo,1046,4103,2201,612,857,8819,5
bogue,1555,3069,616,899,2679,8818,5
satyr,2206,4103,1048,271,1190,8818,5
cauld,1512,4103,990,1295,917,8817,5
bomke,1555,3069,885,628,2679,8816,5
girly,965,2239,2201,1295,2116,8816,5
oiler,532,2239,1603,3252,1190,8816,5
nadge,647,4103,774,612,2679,8815,5
varix,404,4103,2201,1963,144,8815,5
actis,1698,338,1048,1963,3767,8814,5
beigy,1555,2863,1668,612,2116,8814,5
felty,847,2863,1603,1385,2116,8814,5
perot,1184,2863,2201,1282,1284,8814,5
sepal,2206,2863,560,2214,971,8814,5
signa,2206,2239,616,1391,2362,8814,5
cyrie,1512,458,2201,1963,2679,8813,5
leady,1046,2863,1959,829,2116,8813,5
souza,2206,3069,990,186,2362,8813,5
boast,1555,3069,1959,945,1284,8812,5
hanif,844,4103,1757,1963,145,8812,5
mowed,1225,3069,349,3252,917,8812,5
nocks,647,3069,701,628,3767,8812,5
tacky,1264,4103,701,628,2116,8812,5
douse,1128,3069,990,945,2679,8811,5
maybe,1225,4103,381,423,2679,8811,5
rawly,948,4103,349,1295,2116,8811,5
wordy,596,3069,2201,829,2116,8811,5
cauli,1512,4103,990,1295,910,8810,5
bazil,1555,4103,217,1963,971,8809,5
fedia,847,2863,774,1963,2362,8809,5
agley,1698,139,1603,3252,2116,8808,5
fawny,847,4103,349,1391,2116,8806,5
fecks,847,2863,701,628,3767,8806,5
sidra,2206,2239,774,1225,2362,8806,5
ducts,1128,1824,701,1385,3767,8805,5
henry,844,2863,1757,1225,2116,8805,5
tesla,1264,2863,1021,1295,2362,8805,5
trays,1264,1543,1959,271,3767,8804,5
geisa,965,2863,1668,945,2362,8803,5
hecks,844,2863,701,628,3767,8803,5
milan,1225,2239,1603,2214,1522,8803,5
yorke,225,3069,2201,628,2679,8802,5
loamy,1046,3069,1959,612,2116,8802,5
bemat,1555,2863,885,2214,1284,8801,5
rotan,948,3069,1048,2214,1522,8801,5
cesar,1512,2863,1021,2214,1190,8800,5
dault,1128,4103,990,1295,1284,8800,5
rebia,948,2863,664,1963,2362,8800,5
vomer,404,3069,885,3252,1190,8800,5
biron,1555,2239,2201,1282,1522,8799,5
kogia,789,3069,616,1963,2362,8799,5
novus,647,3069,417,899,3767,8799,5
celio,1512,2863,1603,1963,857,8798,5
lenca,1046,2863,1757,770,2362,8798,5
voila,404,3069,1668,1295,2362,8798,5
cagot,1512,4103,616,1282,1284,8797,5
lenad,1046,2863,1757,2214,917,8797,5
toric,1264,3069,2201,1963,300,8797,5
aiver,1698,2239,417,3252,1190,8796,5
noily,647,3069,1668,1295,2116,8795,5
crine,1512,1543,1668,1391,2679,8793,5
feola,847,2863,1426,1295,2362,8793,5
nacry,647,4103,701,1225,2116,8792,5
negus,647,2863,616,899,3767,8792,5
silky,2206,2239,1603,628,2116,8792,5
dashy,1128,4103,1021,423,2116,8791,5
dakir,1128,4103,406,1963,1190,8790,5
mendy,1225,2863,1757,829,2116,8790,5
picus,1184,2239,701,899,3767,8790,5
arden,1698,1543,774,3252,1522,8789,5
sotik,2206,3069,1048,1963,502,8788,5
gaumy,965,4103,990,612,2116,8786,5
heily,844,2863,1668,1295,2116,8786,5
bizen,1555,2239,217,3252,1522,8785,5
norah,647,3069,2201,2214,654,8785,5
skien,2206,137,1668,3252,1522,8785,5
augie,1698,1824,616,1963,2679,8780,5
aunty,1698,1824,1757,1385,2116,8780,5
puled,1184,1824,1603,3252,917,8780,5
unais,420,671,1959,1963,3767,8780,5
gowks,965,3069,349,628,3767,8778,5
blane,1555,1193,1959,1391,2679,8777,5
chams,1512,927,1959,612,3767,8777,5
tawsy,1264,4103,349,945,2116,8777,5
coupe,1512,3069,990,526,2679,8776,5
buhls,1555,1824,334,1295,3767,8775,5
cogue,1512,3069,616,899,2679,8775,5
harco,844,4103,2201,770,857,8775,5
jaspe,446,4103,1021,526,2679,8775,5
jeany,446,2863,1959,1391,2116,8775,5
liter,1046,2239,1048,3252,1190,8775,5
versa,404,2863,2201,945,2362,8775,5
bothe,1555,3069,1048,423,2679,8774,5
crops,1512,1543,1426,526,3767,8774,5
dolma,1128,3069,1603,612,2362,8774,5
doura,1128,3069,990,1225,2362,8774,5
larch,1046,4103,2201,770,654,8774,5
pisay,1184,2239,1021,2214,2116,8774,5
prigs,1184,1543,1668,612,3767,8774,5
prims,1184,1543,1668,612,3767,8774,5
rosan,948,3069,1021,2214,1522,8774,5
turin,1264,1824,2201,1963,1522,8774,5
grids,965,1543,1668,829,3767,8772,5
hover,844,3069,417,3252,1190,8772,5
blate,1555,1193,1959,1385,2679,8771,5
janik,446,4103,1757,1963,502,8771,5
maryl,1225,4103,2201,271,971,8771,5
venta,404,2863,1757,1385,2362,8771,5
began,1555,2863,616,2214,1522,8770,5
genal,965,2863,1757,2214,971,8770,5
rozet,948,3069,217,3252,1284,8770,5
thens,1264,927,1421,1391,3767,8770,5
chwas,1512,927,349,2214,3767,8769,5
coast,1512,3069,1959,945,1284,8769,5
dowel,1128,3069,349,3252,971,8769,5
trips,1264,1543,1668,526,3767,8768,5
hamil,844,4103,885,1963,971,8766,5
copse,1512,3069,560,945,2679,8765,5
wadge,596,4103,774,612,2679,8764,5
adits,1698,245,1668,1385,3767,8763,5
oecus,532,2863,701,899,3767,8762,5
hoker,844,3069,406,3252,1190,8761,5
socha,2206,3069,701,423,2362,8761,5
wined,596,2239,1757,3252,917,8761,5
dauby,1128,4103,990,423,2116,8760,5
sepad,2206,2863,560,2214,917,8760,5
desta,1128,2863,1021,1385,2362,8759,5
weary,596,2863,1959,1225,2116,8759,5
dampy,1128,4103,885,526,2116,8758,5
moric,1225,3069,2201,1963,300,8758,5
germy,965,2863,2201,612,2116,8757,5
orcas,532,1543,701,2214,3767,8757,5
kelty,789,2863,1603,1385,2116,8756,5
eidos,693,2239,774,1282,3767,8755,5
fogel,847,3069,616,3252,971,8755,5
geoty,965,2863,1426,1385,2116,8755,5
renal,948,2863,1757,2214,971,8753,5
catur,1512,4103,1048,899,1190,8752,5
regia,948,2863,616,1963,2362,8752,5
towne,1264,3069,349,1391,2679,8752,5
apios,1698,336,1668,1282,3767,8751,5
codex,1512,3069,774,3252,144,8751,5
pazit,1184,4103,217,1963,1284,8751,5
peaky,1184,2863,1959,628,2116,8750,5
prate,1184,1543,1959,1385,2679,8750,5
kungs,789,1824,1757,612,3767,8749,5
prods,1184,1543,1426,829,3767,8749,5
zonta,176,3069,1757,1385,2362,8749,5
dinse,1128,2239,1757,945,2679,8748,5
murat,1225,1824,2201,2214,1284,8748,5
ronga,948,3069,1757,612,2362,8748,5
teman,1264,2863,885,2214,1522,8748,5
dusen,1128,1824,1021,3252,1522,8747,5
gnats,965,671,1959,1385,3767,8747,5
gofer,965,3069,271,3252,1190,8747,5
lomta,1046,3069,885,1385,2362,8747,5
balko,1555,4103,1603,628,857,8746,5
roped,948,3069,560,3252,917,8746,5
pouty,1184,3069,990,1385,2116,8744,5
quins,93,1824,1668,1391,3767,8743,5
afley,1698,73,1603,3252,2116,8742,5
capot,1512,4103,560,1282,1284,8741,5
dorab,1128,3069,2201,2214,129,8741,5
ramon,948,4103,885,1282,1522,8740,5
snare,2206,671,1959,1225,2679,8740,5
wombs,596,3069,885,423,3767,8740,5
birky,1555,2239,2201,628,2116,8739,5
foyer,847,3069,381,3252,1190,8739,5
sergo,2206,2863,2201,612,857,8739,5
sermo,2206,2863,2201,612,857,8739,5
abrus,1698,172,2201,899,3767,8737,5
belak,1555,2863,1603,2214,502,8737,5
foram,847,3069,2201,2214,406,8737,5
glens,965,1193,1421,1391,3767,8737,5
nambe,647,4103,885,423,2679,8737,5
quits,93,1824,1668,1385,3767,8737,5
binal,1555,2239,1757,2214,971,8736,5
lathy,1046,4103,1048,423,2116,8736,5
loman,1046,3069,885,2214,1522,8736,5
aesir,1698,2863,1021,1963,1190,8735,5
ayens,1698,458,1421,1391,3767,8735,5
poesy,1184,3069,1421,945,2116,8735,5
riden,948,2239,774,3252,1522,8735,5
sahib,2206,4103,334,1963,129,8735,5
deuna,1128,2863,990,1391,2362,8734,5
simar,2206,2239,885,2214,1190,8734,5
zacek,176,4103,701,3252,502,8734,5
gaunt,965,4103,990,1391,1284,8733,5
malgr,1225,4103,1603,612,1190,8733,5
colza,1512,3069,1603,186,2362,8732,5
cothe,1512,3069,1048,423,2679,8731,5
derby,1128,2863,2201,423,2116,8731,5
ferio,847,2863,2201,1963,857,8731,5
gaspy,965,4103,1021,526,2116,8731,5
keily,789,2863,1668,1295,2116,8731,5
vogie,404,3069,616,1963,2679,8731,5
blurs,1555,1193,990,1225,3767,8730,5
fykes,847,458,406,3252,3767,8730,5
ulans,420,1193,1959,1391,3767,8730,5
louse,1046,3069,990,945,2679,8729,5
copra,1512,3069,560,1225,2362,8728,5
foxie,847,3069,170,1963,2679,8728,5
frags,847,1543,1959,612,3767,8728,5
shoed,2206,927,1426,3252,917,8728,5
clods,1512,1193,1426,829,3767,8727,5
ladon,1046,4103,774,1282,1522,8727,5
dukey,1128,1824,406,3252,2116,8726,5
guran,965,1824,2201,2214,1522,8726,5
board,1555,3069,1959,1225,917,8725,5
hoxie,844,3069,170,1963,2679,8725,5
modla,1225,3069,774,1295,2362,8725,5
prays,1184,1543,1959,271,3767,8724,5
colby,1512,3069,1603,423,2116,8723,5
metra,1225,2863,1048,1225,2362,8723,5
sauch,2206,4103,990,770,654,8723,5
tonya,1264,3069,1757,271,2362,8723,5
meant,1225,2863,1959,1391,1284,8722,5
minty,1225,2239,1757,1385,2116,8722,5
sunil,2206,1824,1757,1963,971,8721,5
socky,2206,3069,701,628,2116,8720,5
stier,2206,403,1668,3252,1190,8719,5
bulan,1555,1824,1603,2214,1522,8718,5
ceint,1512,2863,1668,1391,1284,8718,5
sigla,2206,2239,616,1295,2362,8718,5
wrens,596,1543,1421,1391,3767,8718,5
maryd,1225,4103,2201,271,917,8717,5
ready,948,2863,1959,829,2116,8715,5
aldos,1698,1193,774,1282,3767,8714,5
raspy,948,4103,1021,526,2116,8714,5
alten,1698,1193,1048,3252,1522,8713,5
glads,965,1193,1959,829,3767,8713,5
raphe,948,4103,560,423,2679,8713,5
hamid,844,4103,885,1963,917,8712,5
hasky,844,4103,1021,628,2116,8712,5
heron,844,2863,2201,1282,1522,8712,5
musie,1225,1824,1021,1963,2679,8712,5
blocs,1555,1193,1426,770,3767,8711,5
pamhy,1184,4103,885,423,2116,8711,5
purty,1184,1824,2201,1385,2116,8710,5
blips,1555,1193,1668,526,3767,8709,5
kabir,789,4103,664,1963,1190,8709,5
ounds,532,1824,1757,829,3767,8709,5
perau,1184,2863,2201,2214,247,8709,5
zincs,176,2239,1757,770,3767,8709,5
cawky,1512,4103,349,628,2116,8708,5
lifts,1046,2239,271,1385,3767,8708,5
shrew,2206,927,2201,3252,122,8708,5
zoser,176,3069,1021,3252,1190,8708,5
arvos,1698,1543,417,1282,3767,8707,5
bemar,1555,2863,885,2214,1190,8707,5
dhlos,1128,927,1603,1282,3767,8707,5
wacke,596,4103,701,628,2679,8707,5
dilan,1128,2239,1603,2214,1522,8706,5
buhrs,1555,1824,334,1225,3767,8705,5
yowls,225,3069,349,1295,3767,8705,5
shire,2206,927,1668,1225,2679,8705,5
civet,1512,2239,417,3252,1284,8704,5
rakit,948,4103,406,1963,1284,8704,5
tenio,1264,2863,1757,1963,857,8704,5
anius,1698,671,1668,899,3767,8703,5
tomin,1264,3069,885,1963,1522,8703,5
bolag,1555,3069,1603,2214,261,8702,5
clays,1512,1193,1959,271,3767,8702,5
loved,1046,3069,417,3252,917,8701,5
nerka,647,2863,2201,628,2362,8701,5
repay,948,2863,560,2214,2116,8701,5
vague,404,4103,616,899,2679,8701,5
dirca,1128,2239,2201,770,2362,8700,5
hubey,844,1824,664,3252,2116,8700,5
aiery,1698,2239,1421,1225,2116,8699,5
cinda,1512,2239,1757,829,2362,8699,5
coyan,1512,3069,381,2214,1522,8698,5
jabin,446,4103,664,1963,1522,8698,5
runed,948,1824,1757,3252,917,8698,5
crile,1512,1543,1668,1295,2679,8697,5
dearn,1128,2863,1959,1225,1522,8697,5
kunia,789,1824,1757,1963,2362,8695,5
mouly,1225,3069,990,1295,2116,8695,5
phons,1184,927,1426,1391,3767,8695,5
dimer,1128,2239,885,3252,1190,8694,5
drate,1128,1543,1959,1385,2679,8694,5
jurel,446,1824,2201,3252,971,8694,5
purin,1184,1824,2201,1963,1522,8694,5
qiyas,93,2239,381,2214,3767,8694,5
herba,844,2863,2201,423,2362,8693,5
doxia,1128,3069,170,1963,2362,8692,5
pouce,1184,3069,990,770,2679,8692,5
chaps,1512,927,1959,526,3767,8691,5
pocan,1184,3069,701,2214,1522,8690,5
taxir,1264,4103,170,1963,1190,8690,5
voted,404,3069,1048,3252,917,8690,5
bodge,1555,3069,774,612,2679,8689,5
phots,1184,927,1426,1385,3767,8689,5
rotse,948,3069,1048,945,2679,8689,5
voder,404,3069,774,3252,1190,8689,5
bilge,1555,2239,1603,612,2679,8688,5
douty,1128,3069,990,1385,2116,8688,5
viler,404,2239,1603,3252,1190,8688,5
kazue,789,4103,217,899,2679,8687,5
alsen,1698,1193,1021,3252,1522,8686,5
besit,1555,2863,1021,1963,1284,8686,5
amirs,1698,327,1668,1225,3767,8685,5
balch,1555,4103,1603,770,654,8685,5
earom,693,4103,2201,1282,406,8685,5
gulps,965,1824,1603,526,3767,8685,5
ocrea,532,338,2201,3252,2362,8685,5
aryls,1698,1543,381,1295,3767,8684,5
coaxy,1512,3069,1959,26,2116,8682,5
petra,1184,2863,1048,1225,2362,8682,5
tiona,1264,2239,1426,1391,2362,8682,5
hosta,844,3069,1021,1385,2362,8681,5
splet,2206,336,1603,3252,1284,8681,5
adret,1698,245,2201,3252,1284,8680,5
mider,1225,2239,774,3252,1190,8680,5
sixte,2206,2239,170,1385,2679,8679,5
tirma,1264,2239,2201,612,2362,8678,5
bedin,1555,2863,774,1963,1522,8677,5
nadir,647,4103,774,1963,1190,8677,5
tiena,1264,2239,1421,1391,2362,8677,5
ednas,693,245,1757,2214,3767,8676,5
lerot,1046,2863,2201,1282,1284,8676,5
bousy,1555,3069,990,945,2116,8675,5
auget,1698,1824,616,3252,1284,8674,5
daryl,1128,4103,2201,271,971,8674,5
serow,2206,2863,2201,1282,122,8674,5
gyros,965,458,2201,1282,3767,8673,5
beati,1555,2863,1959,1385,910,8672,5
orgas,532,1543,616,2214,3767,8672,5
gonid,965,3069,1757,1963,917,8671,5
mince,1225,2239,1757,770,2679,8670,5
soapi,2206,3069,1959,526,910,8670,5
spaed,2206,336,1959,3252,917,8670,5
fulks,847,1824,1603,628,3767,8669,5
gotra,965,3069,1048,1225,2362,8669,5
junie,446,1824,1757,1963,2679,8669,5
perun,1184,2863,2201,899,1522,8669,5
silva,2206,2239,1603,259,2362,8669,5
drays,1128,1543,1959,271,3767,8668,5
notre,647,3069,1048,1225,2679,8668,5
diary,1128,2239,1959,1225,2116,8667,5
manoc,1225,4103,1757,1282,300,8667,5
blaws,1555,1193,1959,192,3767,8666,5
clips,1512,1193,1668,526,3767,8666,5
cowan,1512,3069,349,2214,1522,8666,5
hulks,844,1824,1603,628,3767,8666,5
balow,1555,4103,1603,1282,122,8665,5
sadoc,2206,4103,774,1282,300,8665,5
slake,2206,1193,1959,628,2679,8665,5
sutra,2206,1824,1048,1225,2362,8665,5
lerwa,1046,2863,2201,192,2362,8664,5
suant,2206,1824,1959,1391,1284,8664,5
armet,1698,1543,885,3252,1284,8662,5
boyla,1555,3069,381,1295,2362,8662,5
akins,1698,137,1668,1391,3767,8661,5
doric,1128,3069,2201,1963,300,8661,5
murly,1225,1824,2201,1295,2116,8661,5
piths,1184,2239,1048,423,3767,8661,5
relit,948,2863,1603,1963,1284,8661,5
theos,1264,927,1421,1282,3767,8661,5
adios,1698,245,1668,1282,3767,8660,5
verda,404,2863,2201,829,2362,8659,5
berth,1555,2863,2201,1385,654,8658,5
fadil,847,4103,774,1963,971,8658,5
judea,446,1824,774,3252,2362,8658,5
ardie,1698,1543,774,1963,2679,8657,5
faith,847,4103,1668,1385,654,8657,5
grabs,965,1543,1959,423,3767,8657,5
howks,844,3069,349,628,3767,8657,5
mcrae,1225,338,2201,2214,2679,8657,5
witen,596,2239,1048,3252,1522,8657,5
forby,847,3069,2201,423,2116,8656,5
lenka,1046,2863,1757,628,2362,8656,5
nerdy,647,2863,2201,829,2116,8656,5
larum,1046,4103,2201,899,406,8655,5
roble,948,3069,664,1295,2679,8655,5
lacon,1046,4103,701,1282,1522,8654,5
spier,2206,336,1668,3252,1190,8652,5
burao,1555,1824,2201,2214,857,8651,5
cohan,1512,3069,334,2214,1522,8651,5
comal,1512,3069,885,2214,971,8651,5
dagon,1128,4103,616,1282,1522,8651,5
iortn,473,3069,2201,1385,1522,8650,5
sexly,2206,2863,170,1295,2116,8650,5
moyle,1225,3069,381,1295,2679,8649,5
eaton,693,4103,1048,1282,1522,8648,5
yugas,225,1824,616,2214,3767,8646,5
mogan,1225,3069,616,2214,1522,8646,5
murex,1225,1824,2201,3252,144,8646,5
tangi,1264,4103,1757,612,910,8646,5
ticer,1264,2239,701,3252,1190,8646,5
normy,647,3069,2201,612,2116,8645,5
radio,948,4103,774,1963,857,8645,5
tubae,1264,1824,664,2214,2679,8645,5
bunde,1555,1824,1757,829,2679,8644,5
lukey,1046,1824,406,3252,2116,8644,5
tried,1264,1543,1668,3252,917,8644,5
hasnt,844,4103,1021,1391,1284,8643,5
belva,1555,2863,1603,259,2362,8642,5
biker,1555,2239,406,3252,1190,8642,5
fraps,847,1543,1959,526,3767,8642,5
hoped,844,3069,560,3252,917,8642,5
tirve,1264,2239,2201,259,2679,8642,5
belam,1555,2863,1603,2214,406,8641,5
cruds,1512,1543,990,829,3767,8641,5
jerad,446,2863,2201,2214,917,8641,5
contd,1512,3069,1757,1385,917,8640,5
powys,1184,3069,349,271,3767,8640,5
jebus,446,2863,664,899,3767,8639,5
roman,948,3069,885,2214,1522,8638,5
stane,2206,403,1959,1391,2679,8638,5
bunty,1555,1824,1757,1385,2116,8637,5
gault,965,4103,990,1295,1284,8637,5
vealy,404,2863,1959,1295,2116,8637,5
bonav,1555,3069,1757,2214,41,8636,5
douce,1128,3069,990,770,2679,8636,5
hamon,844,4103,885,1282,1522,8636,5
hermy,844,2863,2201,612,2116,8636,5
hopei,844,3069,560,3252,910,8635,5
sucre,2206,1824,701,1225,2679,8635,5
tahil,1264,4103,334,1963,971,8635,5
wracs,596,1543,1959,770,3767,8635,5
fardh,847,4103,2201,829,654,8634,5
fiden,847,2239,774,3252,1522,8634,5
taish,1264,4103,1668,945,654,8634,5
whats,596,927,1959,1385,3767,8634,5
bsret,1555,341,2201,3252,1284,8633,5
conti,1512,3069,1757,1385,910,8633,5
lowed,1046,3069,349,3252,917,8633,5
cousy,1512,3069,990,945,2116,8632,5
drips,1128,1543,1668,526,3767,8632,5
joice,446,3069,1668,770,2679,8632,5
juyas,446,1824,381,2214,3767,8632,5
rouse,948,3069,990,945,2679,8631,5
bowla,1555,3069,349,1295,2362,8630,5
sampi,2206,4103,885,526,910,8630,5
wisen,596,2239,1021,3252,1522,8630,5
aline,1698,1193,1668,1391,2679,8629,5
boyse,1555,3069,381,945,2679,8629,5
radon,948,4103,774,1282,1522,8629,5
shone,2206,927,1426,1391,2679,8629,5
terni,1264,2863,2201,1391,910,8629,5
auber,1698,1824,664,3252,1190,8628,5
gashy,965,4103,1021,423,2116,8628,5
gifts,965,2239,271,1385,3767,8627,5
wauve,596,4103,990,259,2679,8627,5
hofer,844,3069,271,3252,1190,8626,5
maund,1225,4103,990,1391,917,8626,5
beano,1555,2863,1959,1391,857,8625,5
marzi,1225,4103,2201,186,910,8625,5
minar,1225,2239,1757,2214,1190,8625,5
surfy,2206,1824,2201,278,2116,8625,5
bhuts,1555,927,990,1385,3767,8624,5
bruet,1555,1543,990,3252,1284,8624,5
jalor,446,4103,1603,1282,1190,8624,5
alite,1698,1193,1668,1385,2679,8623,5
claws,1512,1193,1959,192,3767,8623,5
johen,446,3069,334,3252,1522,8623,5
shote,2206,927,1426,1385,2679,8623,5
sulka,2206,1824,1603,628,2362,8623,5
treks,1264,1543,1421,628,3767,8623,5
fayme,847,4103,381,612,2679,8622,5
karou,789,4103,2201,1282,247,8622,5
yomer,225,3069,885,3252,1190,8621,5
metin,1225,2863,1048,1963,1522,8621,5
muire,1225,1824,1668,1225,2679,8621,5
fargo,847,4103,2201,612,857,8620,5
jolty,446,3069,1603,1385,2116,8619,5
flots,847,1193,1426,1385,3767,8618,5
helsa,844,2863,1603,945,2362,8617,5
soldi,2206,3069,1603,829,910,8617,5
downe,1128,3069,349,1391,2679,8616,5
hankt,844,4103,1757,628,1284,8616,5
learn,1046,2863,1959,1225,1522,8615,5
sokil,2206,3069,406,1963,971,8615,5
tilde,1264,2239,1603,829,2679,8614,5
eakly,693,4103,406,1295,2116,8613,5
korwa,789,3069,2201,192,2362,8613,5
urnae,420,1543,1757,2214,2679,8613,5
haunt,844,4103,990,1391,1284,8612,5
leaky,1046,2863,1959,628,2116,8612,5
limer,1046,2239,885,3252,1190,8612,5
trogs,1264,1543,1426,612,3767,8612,5
blare,1555,1193,1959,1225,2679,8611,5
goura,965,3069,990,1225,2362,8611,5
heady,844,2863,1959,829,2116,8611,5
jocks,446,3069,701,628,3767,8611,5
arums,1698,1543,990,612,3767,8610,5
loxia,1046,3069,170,1963,2362,8610,5
rifts,948,2239,271,1385,3767,8610,5
worky,596,3069,2201,628,2116,8610,5
snite,2206,671,1668,1385,2679,8609,5
tiber,1264,2239,664,3252,1190,8609,5
arcus,1698,1543,701,899,3767,8608,5
furan,847,1824,2201,2214,1522,8608,5
kophs,789,3069,560,423,3767,8608,5
urbas,420,1543,664,2214,3767,8608,5
abret,1698,172,2201,3252,1284,8607,5
klaus,789,1193,1959,899,3767,8607,5
mangi,1225,4103,1757,612,910,8607,5
wiled,596,2239,1603,3252,917,8607,5
beast,1555,2863,1959,945,1284,8606,5
bulse,1555,1824,1603,945,2679,8606,5
louty,1046,3069,990,1385,2116,8606,5
muset,1225,1824,1021,3252,1284,8606,5
necks,647,2863,701,628,3767,8606,5
phaet,1184,927,1959,3252,1284,8606,5
altus,1698,1193,1048,899,3767,8605,5
slait,2206,1193,1959,1963,1284,8605,5
alifs,1698,1193,1668,278,3767,8604,5
amens,1698,327,1421,1391,3767,8604,5
foamy,847,3069,1959,612,2116,8603,5
kalif,789,4103,1603,1963,145,8603,5
nobel,647,3069,664,3252,971,8603,5
roved,948,3069,417,3252,917,8603,5
luite,1046,1824,1668,1385,2679,8602,5
grous,965,1543,1426,899,3767,8600,5
hoagy,844,3069,1959,612,2116,8600,5
irons,473,1543,1426,1391,3767,8600,5
polky,1184,3069,1603,628,2116,8600,5
shade,2206,927,1959,829,2679,8600,5
monza,1225,3069,1757,186,2362,8599,5
ticks,1264,2239,701,628,3767,8599,5
lyrae,1046,458,2201,2214,2679,8598,5
medan,1225,2863,774,2214,1522,8598,5
sivan,2206,2239,417,2214,1522,8598,5
bowse,1555,3069,349,945,2679,8597,5
gauby,965,4103,990,423,2116,8597,5
talco,1264,4103,1603,770,857,8597,5
earsh,693,4103,2201,945,654,8596,5
point,1184,3069,1668,1391,1284,8596,5
polje,1184,3069,1603,61,2679,8596,5
waist,596,4103,1668,945,1284,8596,5
henad,844,2863,1757,2214,917,8595,5
rabid,948,4103,664,1963,917,8595,5
retan,948,2863,1048,2214,1522,8595,5
sithe,2206,2239,1048,423,2679,8595,5
wormy,596,3069,2201,612,2116,8594,5
dipus,1128,2239,560,899,3767,8593,5
joela,446,3069,1421,1295,2362,8593,5
neola,647,2863,1426,1295,2362,8593,5
nevus,647,2863,417,899,3767,8593,5
serov,2206,2863,2201,1282,41,8593,5
tango,1264,4103,1757,612,857,8593,5
yenta,225,2863,1757,1385,2362,8592,5
lando,1046,4103,1757,829,857,8592,5
poxed,1184,3069,170,3252,917,8592,5
douar,1128,3069,990,2214,1190,8591,5
pieta,1184,2239,1421,1385,2362,8591,5
louin,1046,3069,990,1963,1522,8590,5
mopan,1225,3069,560,2214,1522,8590,5
voice,404,3069,1668,770,2679,8590,5
caxon,1512,4103,170,1282,1522,8589,5
draws,1128,1543,1959,192,3767,8589,5
rowel,948,3069,349,3252,971,8589,5
scler,2206,338,1603,3252,1190,8589,5
tyrus,1264,458,2201,899,3767,8589,5
brote,1555,1543,1426,1385,2679,8588,5
gator,965,4103,1048,1282,1190,8588,5
jayem,446,4103,381,3252,406,8588,5
gnars,965,671,1959,1225,3767,8587,5
jabez,446,4103,664,3252,122,8587,5
bunce,1555,1824,1757,770,2679,8585,5
gesan,965,2863,1021,2214,1522,8585,5
pavid,1184,4103,417,1963,917,8584,5
sanyu,2206,4103,1757,271,247,8584,5
vitae,404,2239,1048,2214,2679,8584,5
mexia,1225,2863,170,1963,2362,8583,5
volny,404,3069,1603,1391,2116,8583,5
goldy,965,3069,1603,829,2116,8582,5
salbu,2206,4103,1603,423,247,8582,5
valor,404,4103,1603,1282,1190,8582,5
cruet,1512,1543,990,3252,1284,8581,5
dpans,1128,336,1959,1391,3767,8581,5
kermy,789,2863,2201,612,2116,8581,5
auger,1698,1824,616,3252,1190,8580,5
loric,1046,3069,2201,1963,300,8579,5
narco,647,4103,2201,770,857,8578,5
rolfe,948,3069,1603,278,2679,8577,5
sampo,2206,4103,885,526,857,8577,5
cosma,1512,3069,1021,612,2362,8576,5
arpen,1698,1543,560,3252,1522,8575,5
yuria,225,1824,2201,1963,2362,8575,5
milde,1225,2239,1603,829,2679,8575,5
serum,2206,2863,2201,899,406,8575,5
slide,2206,1193,1668,829,2679,8575,5
garum,965,4103,2201,899,406,8574,5
lamby,1046,4103,885,423,2116,8573,5
lehay,1046,2863,334,2214,2116,8573,5
sound,2206,3069,990,1391,917,8573,5
cohla,1512,3069,334,1295,2362,8572,5
luhey,1046,1824,334,3252,2116,8572,5
polak,1184,3069,1603,2214,502,8572,5
bevan,1555,2863,417,2214,1522,8571,5
sedgy,2206,2863,774,612,2116,8571,5
semih,2206,2863,885,1963,654,8571,5
spane,2206,336,1959,1391,2679,8571,5
burka,1555,1824,2201,628,2362,8570,5
zoila,176,3069,1668,1295,2362,8570,5
ayers,1698,458,1421,1225,3767,8569,5
bused,1555,1824,1021,3252,917,8569,5
vined,404,2239,1757,3252,917,8569,5
woady,596,3069,1959,829,2116,8569,5
clare,1512,1193,1959,1225,2679,8568,5
combe,1512,3069,885,423,2679,8568,5
delma,1128,2863,1603,612,2362,8568,5
denio,1128,2863,1757,1963,857,8568,5
yarth,225,4103,2201,1385,654,8568,5
machy,1225,4103,701,423,2116,8568,5
milty,1225,2239,1603,1385,2116,8568,5
rinse,948,2239,1757,945,2679,8568,5
signy,2206,2239,616,1391,2116,8568,5
const,1512,3069,1757,945,1284,8567,5
heida,844,2863,1668,829,2362,8566,5
pangi,1184,4103,1757,612,910,8566,5
brade,1555,1543,1959,829,2679,8565,5
saugh,2206,4103,990,612,654,8565,5
spate,2206,336,1959,1385,2679,8565,5
pried,1184,1543,1668,3252,917,8564,5
sitao,2206,2239,1048,2214,857,8564,5
iambe,473,4103,885,423,2679,8563,5
jonme,446,3069,1757,612,2679,8563,5
junet,446,1824,1757,3252,1284,8563,5
kolbe,789,3069,1603,423,2679,8563,5
slape,2206,1193,1959,526,2679,8563,5
welty,596,2863,1603,1385,2116,8563,5
tauli,1264,4103,990,1295,910,8562,5
kurta,789,1824,2201,1385,2362,8561,5
pasol,1184,4103,1021,1282,971,8561,5
sloan,2206,1193,1426,2214,1522,8561,5
tiger,1264,2239,616,3252,1190,8561,5
volin,404,3069,1603,1963,1522,8561,5
beaut,1555,2863,1959,899,1284,8560,5
bowra,1555,3069,349,1225,2362,8560,5
micks,1225,2239,701,628,3767,8560,5
revay,948,2863,417,2214,2116,8558,5
slued,2206,1193,990,3252,917,8558,5
bumps,1555,1824,885,526,3767,8557,5
timed,1264,2239,885,3252,917,8557,5
racon,948,4103,701,1282,1522,8556,5
agios,1698,139,1668,1282,3767,8554,5
burga,1555,1824,2201,612,2362,8554,5
burma,1555,1824,2201,612,2362,8554,5
mango,1225,4103,1757,612,857,8554,5
shina,2206,927,1668,1391,2362,8554,5
buena,1555,1824,1421,1391,2362,8553,5
cedar,1512,2863,774,2214,1190,8553,5
hovel,844,3069,417,3252,971,8553,5
nache,647,4103,701,423,2679,8553,5
doyle,1128,3069,381,1295,2679,8552,5
crone,1512,1543,1426,1391,2679,8551,5
cumay,1512,1824,885,2214,2116,8551,5
duroy,1128,1824,2201,1282,2116,8551,5
tinge,1264,2239,1757,612,2679,8551,5
zings,176,2239,1757,612,3767,8551,5
pasto,1184,4103,1021,1385,857,8550,5
seami,2206,2863,1959,612,910,8550,5
durex,1128,1824,2201,3252,144,8549,5
garbo,965,4103,2201,423,857,8549,5
perni,1184,2863,2201,1391,910,8549,5
shita,2206,927,1668,1385,2362,8548,5
bizet,1555,2239,217,3252,1284,8547,5
lemna,1046,2863,885,1391,2362,8547,5
randi,948,4103,1757,829,910,8547,5
couma,1512,3069,990,612,2362,8545,5
dimps,1128,2239,885,526,3767,8545,5
pbxes,1184,172,170,3252,3767,8545,5
trine,1264,1543,1668,1391,2679,8545,5
benim,1555,2863,1757,1963,406,8544,5
ruled,948,1824,1603,3252,917,8544,5
balkh,1555,4103,1603,628,654,8543,5
conli,1512,3069,1757,1295,910,8543,5
leant,1046,2863,1959,1391,1284,8543,5
linty,1046,2239,1757,1385,2116,8543,5
oiled,532,2239,1603,3252,917,8543,5
bidle,1555,2239,774,1295,2679,8542,5
brain,1555,1543,1959,1963,1522,8542,5
renga,948,2863,1757,612,2362,8542,5
stale,2206,403,1959,1295,2679,8542,5
diena,1128,2239,1421,1391,2362,8541,5
navew,647,4103,417,3252,122,8541,5
codal,1512,3069,774,2214,971,8540,5
diota,1128,2239,1426,1385,2362,8540,5
sudan,2206,1824,774,2214,1522,8540,5
muter,1225,1824,1048,3252,1190,8539,5
zymes,176,458,885,3252,3767,8538,5
gatun,965,4103,1048,899,1522,8537,5
grane,965,1543,1959,1391,2679,8537,5
kileh,789,2239,1603,3252,654,8537,5
buteo,1555,1824,1048,3252,857,8536,5
gabon,965,4103,664,1282,1522,8536,5
jambe,446,4103,885,423,2679,8536,5
necia,647,2863,701,1963,2362,8536,5
ofris,532,73,2201,1963,3767,8536,5
rosat,948,3069,1021,2214,1284,8536,5
rowed,948,3069,349,3252,917,8535,5
gibus,965,2239,664,899,3767,8534,5
morth,1225,3069,2201,1385,654,8534,5
arise,1698,1543,1668,945,2679,8533,5
kenai,789,2863,1757,2214,910,8533,5
shole,2206,927,1426,1295,2679,8533,5
begat,1555,2863,616,2214,1284,8532,5
kinta,789,2239,1757,1385,2362,8532,5
progs,1184,1543,1426,612,3767,8532,5
proms,1184,1543,1426,612,3767,8532,5
chous,1512,927,1426,899,3767,8531,5
grate,965,1543,1959,1385,2679,8531,5
leman,1046,2863,885,2214,1522,8530,5
siwan,2206,2239,349,2214,1522,8530,5
dealt,1128,2863,1959,1295,1284,8529,5
dribs,1128,1543,1668,423,3767,8529,5
lumen,1046,1824,885,3252,1522,8529,5
dinar,1128,2239,1757,2214,1190,8528,5
foxer,847,3069,170,3252,1190,8528,5
matlo,1225,4103,1048,1295,857,8528,5
minke,1225,2239,1757,628,2679,8528,5
betsy,1555,2863,1048,945,2116,8527,5
house,844,3069,990,945,2679,8527,5
togue,1264,3069,616,899,2679,8527,5
gouty,965,3069,990,1385,2116,8525,5
detin,1128,2863,1048,1963,1522,8524,5
argus,1698,1543,616,899,3767,8523,5
biped,1555,2239,560,3252,917,8523,5
rosin,948,3069,1021,1963,1522,8523,5
bolti,1555,3069,1603,1385,910,8522,5
czars,1512,59,1959,1225,3767,8522,5
licet,1046,2239,701,3252,1284,8522,5
boist,1555,3069,1668,945,1284,8521,5
cordi,1512,3069,2201,829,910,8521,5
crany,1512,1543,1959,1391,2116,8521,5
posit,1184,3069,1021,1963,1284,8521,5
ripen,948,2239,560,3252,1522,8521,5
belap,1555,2863,1603,2214,285,8520,5
beard,1555,2863,1959,1225,917,8519,5
begin,1555,2863,616,1963,1522,8519,5
brina,1555,1543,1668,1391,2362,8519,5
cista,1512,2239,1021,1385,2362,8519,5
fault,847,4103,990,1295,1284,8519,5
picks,1184,2239,701,628,3767,8519,5
dobla,1128,3069,664,1295,2362,8518,5
kiter,789,2239,1048,3252,1190,8518,5
gaivn,965,4103,1668,259,1522,8517,5
karch,789,4103,2201,770,654,8517,5
palco,1184,4103,1603,770,857,8517,5
gluey,965,1193,990,3252,2116,8516,5
hault,844,4103,990,1295,1284,8516,5
slice,2206,1193,1668,770,2679,8516,5
cahot,1512,4103,334,1282,1284,8515,5
julie,446,1824,1603,1963,2679,8515,5
peart,1184,2863,1959,1225,1284,8515,5
simal,2206,2239,885,2214,971,8515,5
brita,1555,1543,1668,1385,2362,8513,5
lapon,1046,4103,560,1282,1522,8513,5
mayon,1225,4103,381,1282,1522,8513,5
artel,1698,1543,1048,3252,971,8512,5
dabih,1128,4103,664,1963,654,8512,5
jodel,446,3069,774,3252,971,8512,5
minge,1225,2239,1757,612,2679,8512,5
muser,1225,1824,1021,3252,1190,8512,5
punta,1184,1824,1757,1385,2362,8512,5
axils,1698,83,1668,1295,3767,8511,5
biome,1555,2239,1426,612,2679,8511,5
mopla,1225,3069,560,1295,2362,8511,5
bocal,1555,3069,701,2214,971,8510,5
clogs,1512,1193,1426,612,3767,8510,5
dicer,1128,2239,701,3252,1190,8510,5
yoder,225,3069,774,3252,1190,8510,5
magot,1225,4103,616,1282,1284,8510,5
couve,1512,3069,990,259,2679,8509,5
fakir,847,4103,406,1963,1190,8509,5
mainz,1225,4103,1668,1391,122,8509,5
pyrus,1184,458,2201,899,3767,8509,5
pitys,1184,2239,1048,271,3767,8509,5
waird,596,4103,1668,1225,917,8509,5
afret,1698,73,2201,3252,1284,8508,5
anlet,1698,671,1603,3252,1284,8508,5
haori,844,4103,1426,1225,910,8508,5
piste,1184,2239,1021,1385,2679,8508,5
bifer,1555,2239,271,3252,1190,8507,5
brace,1555,1543,1959,770,2679,8506,5
fogle,847,3069,616,1295,2679,8506,5
senci,2206,2863,1757,770,910,8506,5
grays,965,1543,1959,271,3767,8505,5
felda,847,2863,1603,829,2362,8504,5
hogle,844,3069,616,1295,2679,8503,5
shaly,2206,927,1959,1295,2116,8503,5
tabor,1264,4103,664,1282,1190,8503,5
brian,1555,1543,1668,2214,1522,8502,5
helda,844,2863,1603,829,2362,8501,5
cajon,1512,4103,81,1282,1522,8500,5
marji,1225,4103,2201,61,910,8500,5
purge,1184,1824,2201,612,2679,8500,5
crain,1512,1543,1959,1963,1522,8499,5
petar,1184,2863,1048,2214,1190,8499,5
ginep,965,2239,1757,3252,285,8498,5
goric,965,3069,2201,1963,300,8498,5
reamy,948,2863,1959,612,2116,8498,5
temin,1264,2863,885,1963,1522,8497,5
melon,1225,2863,1603,1282,1522,8495,5
gerik,965,2863,2201,1963,502,8494,5
kiefs,789,2239,1421,278,3767,8494,5
cohue,1512,3069,334,899,2679,8493,5
tauri,1264,4103,990,1225,910,8492,5
rapid,948,4103,560,1963,917,8491,5
alroy,1698,1193,2201,1282,2116,8490,5
cedry,1512,2863,774,1225,2116,8490,5
shaef,2206,927,1959,3252,145,8489,5
behan,1555,2863,334,2214,1522,8488,5
hoked,844,3069,406,3252,917,8488,5
tedra,1264,2863,774,1225,2362,8488,5
dreks,1128,1543,1421,628,3767,8487,5
plier,1184,1193,1668,3252,1190,8487,5
sieva,2206,2239,1421,259,2362,8487,5
aloed,1698,1193,1426,3252,917,8486,5
ireos,473,1543,1421,1282,3767,8486,5
tosca,1264,3069,1021,770,2362,8486,5
eamon,693,4103,885,1282,1522,8485,5
howel,844,3069,349,3252,971,8485,5
yoven,225,3069,417,3252,1522,8485,5
neisa,647,2863,1668,945,2362,8485,5
tecla,1264,2863,701,1295,2362,8485,5
farhi,847,4103,2201,423,910,8484,5
pecan,1184,2863,701,2214,1522,8484,5
brows,1555,1543,1426,192,3767,8483,5
covin,1512,3069,417,1963,1522,8483,5
horim,844,3069,2201,1963,406,8483,5
sitka,2206,2239,1048,628,2362,8483,5
curdy,1512,1824,2201,829,2116,8482,5
fujis,847,1824,81,1963,3767,8482,5
pauli,1184,4103,990,1295,910,8482,5
tobin,1264,3069,664,1963,1522,8482,5
harbi,844,4103,2201,423,910,8481,5
scran,2206,338,2201,2214,1522,8481,5
blite,1555,1193,1668,1385,2679,8480,5
korun,789,3069,2201,899,1522,8480,5
volar,404,3069,1603,2214,1190,8480,5
joule,446,3069,990,1295,2679,8479,5
kathy,789,4103,1048,423,2116,8479,5
tegan,1264,2863,616,2214,1522,8479,5
brews,1555,1543,1421,192,3767,8478,5
festa,847,2863,1021,1385,2362,8478,5
gawsy,965,4103,349,945,2116,8478,5
metry,1225,2863,1048,1225,2116,8477,5
piute,1184,2239,990,1385,2679,8477,5
scale,2206,338,1959,1295,2679,8477,5
bepat,1555,2863,560,2214,1284,8476,5
liven,1046,2239,417,3252,1522,8476,5
melba,1225,2863,1603,423,2362,8476,5
bucks,1555,1824,701,628,3767,8475,5
curve,1512,1824,2201,259,2679,8475,5
gitel,965,2239,1048,3252,971,8475,5
hesta,844,2863,1021,1385,2362,8475,5
spale,2206,336,1959,1295,2679,8475,5
splay,2206,336,1603,2214,2116,8475,5
autre,1698,1824,1048,1225,2679,8474,5
cadiz,1512,4103,774,1963,122,8474,5
ornie,532,1543,1757,1963,2679,8474,5
sambo,2206,4103,885,423,857,8474,5
yeuks,225,2863,990,628,3767,8473,5
orvas,532,1543,417,2214,3767,8473,5
quads,93,1824,1959,829,3767,8472,5
stare,2206,403,1959,1225,2679,8472,5
dachy,1128,4103,701,423,2116,8471,5
dregs,1128,1543,1421,612,3767,8471,5
nizey,647,2239,217,3252,2116,8471,5
pinge,1184,2239,1757,612,2679,8471,5
wafty,596,4103,271,1385,2116,8471,5
fator,847,4103,1048,1282,1190,8470,5
grips,965,1543,1668,526,3767,8469,5
laing,1046,4103,1668,1391,261,8469,5
chane,1512,927,1959,1391,2679,8468,5
pyins,1184,458,1668,1391,3767,8468,5
logan,1046,3069,616,2214,1522,8467,5
lurex,1046,1824,2201,3252,144,8467,5
mahon,1225,4103,334,1282,1522,8466,5
catso,1512,4103,1048,945,857,8465,5
liken,1046,2239,406,3252,1522,8465,5
prine,1184,1543,1668,1391,2679,8465,5
rocta,948,3069,701,1385,2362,8465,5
foldy,847,3069,1603,829,2116,8464,5
gorst,965,3069,2201,945,1284,8464,5
bornu,1555,3069,2201,1391,247,8463,5
deion,1128,2863,1668,1282,1522,8463,5
dicks,1128,2239,701,628,3767,8463,5
limps,1046,2239,885,526,3767,8463,5
shore,2206,927,1426,1225,2679,8463,5
anous,1698,671,1426,899,3767,8461,5
somni,2206,3069,885,1391,910,8461,5
swane,2206,226,1959,1391,2679,8461,5
becry,1555,2863,701,1225,2116,8460,5
taich,1264,4103,1668,770,654,8459,5
novia,647,3069,417,1963,2362,8458,5
timne,1264,2239,885,1391,2679,8458,5
aigre,1698,2239,616,1225,2679,8457,5
botha,1555,3069,1048,423,2362,8457,5
rozel,948,3069,217,3252,971,8457,5
norby,647,3069,2201,423,2116,8456,5
deric,1128,2863,2201,1963,300,8455,5
mizen,1225,2239,217,3252,1522,8455,5
boyce,1555,3069,381,770,2679,8454,5
henka,844,2863,1757,628,2362,8454,5
loxed,1046,3069,170,3252,917,8454,5
pelon,1184,2863,1603,1282,1522,8454,5
cindy,1512,2239,1757,829,2116,8453,5
ficus,847,2239,701,899,3767,8453,5
mauri,1225,4103,990,1225,910,8453,5
skier,2206,137,1668,3252,1190,8453,5
davon,1128,4103,417,1282,1522,8452,5
dymas,1128,458,885,2214,3767,8452,5
rinde,948,2239,1757,829,2679,8452,5
divus,1128,2239,417,899,3767,8450,5
acers,1698,338,1421,1225,3767,8449,5
wotan,596,3069,1048,2214,1522,8449,5
dobra,1128,3069,664,1225,2362,8448,5
gisel,965,2239,1021,3252,971,8448,5
apers,1698,336,1421,1225,3767,8447,5
herby,844,2863,2201,423,2116,8447,5
laund,1046,4103,990,1391,917,8447,5
mosca,1225,3069,1021,770,2362,8447,5
peban,1184,2863,664,2214,1522,8447,5
pogue,1184,3069,616,899,2679,8447,5
kelda,789,2863,1603,829,2362,8446,5
loury,1046,3069,990,1225,2116,8446,5
stied,2206,403,1668,3252,917,8446,5
baulk,1555,4103,990,1295,502,8445,5
cemal,1512,2863,885,2214,971,8445,5
noisy,647,3069,1668,945,2116,8445,5
cogit,1512,3069,616,1963,1284,8444,5
sinto,2206,2239,1757,1385,857,8444,5
abets,1698,172,1421,1385,3767,8443,5
celik,1512,2863,1603,1963,502,8443,5
cline,1512,1193,1668,1391,2679,8443,5
detar,1128,2863,1048,2214,1190,8443,5
cuber,1512,1824,664,3252,1190,8442,5
vaudy,404,4103,990,829,2116,8442,5
veiny,404,2863,1668,1391,2116,8442,5
crows,1512,1543,1426,192,3767,8440,5
jakin,446,4103,406,1963,1522,8440,5
megan,1225,2863,616,2214,1522,8440,5
alden,1698,1193,774,3252,1522,8439,5
talmo,1264,4103,1603,612,857,8439,5
begar,1555,2863,616,2214,1190,8438,5
benic,1555,2863,1757,1963,300,8438,5
maltz,1225,4103,1603,1385,122,8438,5
sikra,2206,2239,406,1225,2362,8438,5
clite,1512,1193,1668,1385,2679,8437,5
frigs,847,1543,1668,612,3767,8437,5
gulfs,965,1824,1603,278,3767,8437,5
chays,1512,927,1959,271,3767,8436,5
kudos,789,1824,774,1282,3767,8436,5
crews,1512,1543,1421,192,3767,8435,5
dansk,1128,4103,1757,945,502,8435,5
mural,1225,1824,2201,2214,971,8435,5
woibe,596,3069,1668,423,2679,8435,5
bemad,1555,2863,885,2214,917,8434,5
fabio,847,4103,664,1963,857,8434,5
goban,965,3069,664,2214,1522,8434,5
khios,789,927,1668,1282,3767,8433,5
ponja,1184,3069,1757,61,2362,8433,5
saqib,2206,4103,32,1963,129,8433,5
spiel,2206,336,1668,3252,971,8433,5
reman,948,2863,885,2214,1522,8432,5
gilse,965,2239,1603,945,2679,8431,5
guile,965,1824,1668,1295,2679,8431,5
rumen,948,1824,885,3252,1522,8431,5
zerda,176,2863,2201,829,2362,8431,5
dotal,1128,3069,1048,2214,971,8430,5
ohley,532,927,1603,3252,2116,8430,5
pilar,1184,2239,1603,2214,1190,8430,5
rowte,948,3069,349,1385,2679,8430,5
paulo,1184,4103,990,1295,857,8429,5
decan,1128,2863,701,2214,1522,8428,5
langi,1046,4103,1757,612,910,8428,5
moyna,1225,3069,381,1391,2362,8428,5
palki,1184,4103,1603,628,910,8428,5
boche,1555,3069,701,423,2679,8427,5
centi,1512,2863,1757,1385,910,8427,5
byers,1555,458,1421,1225,3767,8426,5
karbi,789,4103,2201,423,910,8426,5
ahems,1698,927,1421,612,3767,8425,5
befan,1555,2863,271,2214,1522,8425,5
xyris,36,458,2201,1963,3767,8425,5
clops,1512,1193,1426,526,3767,8424,5
lweis,1046,226,1421,1963,3767,8423,5
podex,1184,3069,774,3252,144,8423,5
somic,2206,3069,885,1963,300,8423,5
junks,446,1824,1757,628,3767,8422,5
agons,1698,139,1426,1391,3767,8421,5
mawky,1225,4103,349,628,2116,8421,5
cornu,1512,3069,2201,1391,247,8420,5
binah,1555,2239,1757,2214,654,8419,5
firca,847,2239,2201,770,2362,8419,5
taipo,1264,4103,1668,526,857,8418,5
towan,1264,3069,349,2214,1522,8418,5
diose,1128,2239,1426,945,2679,8417,5
moshe,1225,3069,1021,423,2679,8417,5
beath,1555,2863,1959,1385,654,8416,5
fiore,847,2239,1426,1225,2679,8416,5
mitre,1225,2239,1048,1225,2679,8416,5
canzo,1512,4103,1757,186,857,8415,5
dinge,1128,2239,1757,612,2679,8415,5
donau,1128,3069,1757,2214,247,8415,5
tumer,1264,1824,885,3252,1190,8415,5
honky,844,3069,1757,628,2116,8414,5
frate,847,1543,1959,1385,2679,8413,5
hearn,844,2863,1959,1225,1522,8413,5
lantz,1046,4103,1757,1385,122,8413,5
awols,1698,226,1426,1295,3767,8412,5
fendy,847,2863,1757,829,2116,8412,5
minda,1225,2239,1757,829,2362,8412,5
knars,789,671,1959,1225,3767,8411,5
boyar,1555,3069,381,2214,1190,8409,5
dhaks,1128,927,1959,628,3767,8409,5
hendy,844,2863,1757,829,2116,8409,5
mirky,1225,2239,2201,628,2116,8409,5
monax,1225,3069,1757,2214,144,8409,5
debna,1128,2863,664,1391,2362,8408,5
mixen,1225,2239,170,3252,1522,8408,5
fouty,847,3069,990,1385,2116,8407,5
leahy,1046,2863,1959,423,2116,8407,5
scare,2206,338,1959,1225,2679,8407,5
sourd,2206,3069,990,1225,917,8407,5
wenda,596,2863,1757,829,2362,8407,5
acred,1698,338,2201,3252,917,8406,5
plane,1184,1193,1959,1391,2679,8406,5
posca,1184,3069,1021,770,2362,8406,5
zonar,176,3069,1757,2214,1190,8406,5
genio,965,2863,1757,1963,857,8405,5
spare,2206,336,1959,1225,2679,8405,5
urien,420,1543,1668,3252,1522,8405,5
lexia,1046,2863,170,1963,2362,8404,5
avens,1698,126,1421,1391,3767,8403,5
caulk,1512,4103,990,1295,502,8402,5
butle,1555,1824,1048,1295,2679,8401,5
gurly,965,1824,2201,1295,2116,8401,5
iover,473,3069,417,3252,1190,8401,5
romeu,948,3069,885,3252,247,8401,5
chips,1512,927,1668,526,3767,8400,5
cohin,1512,3069,334,1963,1522,8400,5
dogra,1128,3069,616,1225,2362,8400,5
mauro,1225,4103,990,1225,857,8400,5
plate,1184,1193,1959,1385,2679,8400,5
purda,1184,1824,2201,829,2362,8400,5
plods,1184,1193,1426,829,3767,8399,5
shake,2206,927,1959,628,2679,8399,5
fluey,847,1193,990,3252,2116,8398,5
gerim,965,2863,2201,1963,406,8398,5
hadnt,844,4103,774,1391,1284,8396,5
wonga,596,3069,1757,612,2362,8396,5
given,965,2239,417,3252,1522,8395,5
noway,647,3069,349,2214,2116,8395,5
pokan,1184,3069,406,2214,1522,8395,5
wasnt,596,4103,1021,1391,1284,8395,5
hacky,844,4103,701,628,2116,8392,5
kerby,789,2863,2201,423,2116,8392,5
dogue,1128,3069,616,899,2679,8391,5
liber,1046,2239,664,3252,1190,8391,5
sudra,2206,1824,774,1225,2362,8391,5
wraps,596,1543,1959,526,3767,8391,5
brise,1555,1543,1668,945,2679,8390,5
drops,1128,1543,1426,526,3767,8390,5
yocks,225,3069,701,628,3767,8390,5
jerid,446,2863,2201,1963,917,8390,5
secam,2206,2863,701,2214,406,8390,5
bosky,1555,3069,1021,628,2116,8389,5
goyle,965,3069,381,1295,2679,8389,5
torsi,1264,3069,2201,945,910,8389,5
ladik,1046,4103,774,1963,502,8388,5
shira,2206,927,1668,1225,2362,8388,5
strue,2206,403,2201,899,2679,8388,5
alone,1698,1193,1426,1391,2679,8387,5
benld,1555,2863,1757,1295,917,8387,5
frays,847,1543,1959,271,3767,8387,5
citra,1512,2239,1048,1225,2362,8386,5
rmats,948,327,1959,1385,3767,8386,5
servo,2206,2863,2201,259,857,8386,5
bowly,1555,3069,349,1295,2116,8384,5
maynt,1225,4103,381,1391,1284,8384,5
tousy,1264,3069,990,945,2116,8384,5
coign,1512,3069,1668,612,1522,8383,5
shame,2206,927,1959,612,2679,8383,5
widen,596,2239,774,3252,1522,8383,5
gimps,965,2239,885,526,3767,8382,5
sugan,2206,1824,616,2214,1522,8382,5
alter,1698,1193,1048,3252,1190,8381,5
licks,1046,2239,701,628,3767,8381,5
mirak,1225,2239,2201,2214,502,8381,5
peavy,1184,2863,1959,259,2116,8381,5
pawky,1184,4103,349,628,2116,8380,5
zoril,176,3069,2201,1963,971,8380,5
arneb,1698,1543,1757,3252,129,8379,5
iache,473,4103,701,423,2679,8379,5
spied,2206,336,1668,3252,917,8379,5
flags,847,1193,1959,612,3767,8378,5
flams,847,1193,1959,612,3767,8378,5
ioxus,473,3069,170,899,3767,8378,5
riven,948,2239,417,3252,1522,8378,5
sulky,2206,1824,1603,628,2116,8377,5
niter,647,2239,1048,3252,1190,8376,5
lango,1046,4103,1757,612,857,8375,5
cento,1512,2863,1757,1385,857,8374,5
jason,446,4103,1021,1282,1522,8374,5
plays,1184,1193,1959,271,3767,8374,5
sophy,2206,3069,560,423,2116,8374,5
suint,2206,1824,1668,1391,1284,8373,5
hotly,844,3069,1048,1295,2116,8372,5
bezan,1555,2863,217,2214,1522,8371,5
lyrus,1046,458,2201,899,3767,8371,5
pinda,1184,2239,1757,829,2362,8371,5
taluk,1264,4103,1603,899,502,8371,5
hurty,844,1824,2201,1385,2116,8370,5
lavon,1046,4103,417,1282,1522,8370,5
mesua,1225,2863,1021,899,2362,8370,5
biked,1555,2239,406,3252,917,8369,5
rogan,948,3069,616,2214,1522,8369,5
zebus,176,2863,664,899,3767,8369,5
jamil,446,4103,885,1963,971,8368,5
basom,1555,4103,1021,1282,406,8367,5
kilan,789,2239,1603,2214,1522,8367,5
jabir,446,4103,664,1963,1190,8366,5
skate,2206,137,1959,1385,2679,8366,5
axons,1698,83,1426,1391,3767,8365,5
goury,965,3069,990,1225,2116,8365,5
pinal,1184,2239,1757,2214,971,8365,5
seoul,2206,2863,1426,899,971,8365,5
swale,2206,226,1959,1295,2679,8365,5
brake,1555,1543,1959,628,2679,8364,5
yuhas,225,1824,334,2214,3767,8364,5
kosin,789,3069,1021,1963,1522,8364,5
joker,446,3069,406,3252,1190,8363,5
potsy,1184,3069,1048,945,2116,8362,5
sequa,2206,2863,32,899,2362,8362,5
tiver,1264,2239,417,3252,1190,8362,5
waspy,596,4103,1021,526,2116,8362,5
bourn,1555,3069,990,1225,1522,8361,5
katun,789,4103,1048,899,1522,8361,5
gauzy,965,4103,990,186,2116,8360,5
limbs,1046,2239,885,423,3767,8360,5
luter,1046,1824,1048,3252,1190,8360,5
modge,1225,3069,774,612,2679,8359,5
palmo,1184,4103,1603,612,857,8359,5
caput,1512,4103,560,899,1284,8358,5
dizen,1128,2239,217,3252,1522,8358,5
kearn,789,2863,1959,1225,1522,8358,5
kyats,789,458,1959,1385,3767,8358,5
slime,2206,1193,1668,612,2679,8358,5
tawpy,1264,4103,349,526,2116,8358,5
alefs,1698,1193,1421,278,3767,8357,5
chaws,1512,927,1959,192,3767,8357,5
curio,1512,1824,2201,1963,857,8357,5
vitus,404,2239,1048,899,3767,8357,5
dauri,1128,4103,990,1225,910,8356,5
novel,647,3069,417,3252,971,8356,5
petua,1184,2863,1048,899,2362,8356,5
rotge,948,3069,1048,612,2679,8356,5
tenor,1264,2863,1757,1282,1190,8356,5
verpa,404,2863,2201,526,2362,8356,5
aloys,1698,1193,1426,271,3767,8355,5
kendy,789,2863,1757,829,2116,8354,5
noble,647,3069,664,1295,2679,8354,5
obias,532,172,1668,2214,3767,8353,5
throe,1264,927,2201,1282,2679,8353,5
tonic,1264,3069,1757,1963,300,8353,5
benjy,1555,2863,1757,61,2116,8352,5
duole,1128,1824,1426,1295,2679,8352,5
junia,446,1824,1757,1963,2362,8352,5
penza,1184,2863,1757,186,2362,8352,5
coapt,1512,3069,1959,526,1284,8350,5
mazon,1225,4103,217,1282,1522,8349,5
whins,596,927,1668,1391,3767,8349,5
brage,1555,1543,1959,612,2679,8348,5
brame,1555,1543,1959,612,2679,8348,5
ravid,948,4103,417,1963,917,8348,5
sengi,2206,2863,1757,612,910,8348,5
medin,1225,2863,774,1963,1522,8347,5
raoul,948,4103,1426,899,971,8347,5
stine,2206,403,1668,1391,2679,8347,5
strep,2206,403,2201,3252,285,8347,5
comid,1512,3069,885,1963,917,8346,5
forst,847,3069,2201,945,1284,8346,5
hofei,844,3069,271,3252,910,8346,5
monti,1225,3069,1757,1385,910,8346,5
nexus,647,2863,170,899,3767,8346,5
veily,404,2863,1668,1295,2116,8346,5
mousy,1225,3069,990,945,2116,8345,5
piety,1184,2239,1421,1385,2116,8345,5
cilka,1512,2239,1603,628,2362,8344,5
retin,948,2863,1048,1963,1522,8344,5
horst,844,3069,2201,945,1284,8343,5
liger,1046,2239,616,3252,1190,8343,5
sachi,2206,4103,701,423,910,8343,5
whits,596,927,1668,1385,3767,8343,5
azons,1698,59,1426,1391,3767,8341,5
nikos,647,2239,406,1282,3767,8341,5
taxon,1264,4103,170,1282,1522,8341,5
walth,596,4103,1603,1385,654,8341,5
cunit,1512,1824,1757,1963,1284,8340,5
pohna,1184,3069,334,1391,2362,8340,5
dolby,1128,3069,1603,423,2116,8339,5
limed,1046,2239,885,3252,917,8339,5
dural,1128,1824,2201,2214,971,8338,5
powan,1184,3069,349,2214,1522,8338,5
joram,446,3069,2201,2214,406,8336,5
culex,1512,1824,1603,3252,144,8335,5
karyl,789,4103,2201,271,971,8335,5
calvo,1512,4103,1603,259,857,8334,5
banjo,1555,4103,1757,61,857,8333,5
linge,1046,2239,1757,612,2679,8333,5
luser,1046,1824,1021,3252,1190,8333,5
resty,948,2863,1021,1385,2116,8333,5
bortz,1555,3069,2201,1385,122,8332,5
nerva,647,2863,2201,259,2362,8332,5
aldus,1698,1193,774,899,3767,8331,5
blase,1555,1193,1959,945,2679,8331,5
loiza,1046,3069,1668,186,2362,8331,5
melfa,1225,2863,1603,278,2362,8331,5
aegir,1698,2863,616,1963,1190,8330,5
bouak,1555,3069,990,2214,502,8330,5
chiel,1512,927,1668,3252,971,8330,5
lanch,1046,4103,1757,770,654,8330,5
lifen,1046,2239,271,3252,1522,8330,5
resat,948,2863,1021,2214,1284,8330,5
alben,1698,1193,664,3252,1522,8329,5
arlin,1698,1543,1603,1963,1522,8329,5
heman,844,2863,885,2214,1522,8328,5
merth,1225,2863,2201,1385,654,8328,5
bunda,1555,1824,1757,829,2362,8327,5
copal,1512,3069,560,2214,971,8326,5
lebna,1046,2863,664,1391,2362,8326,5
nidus,647,2239,774,899,3767,8326,5
gerti,965,2863,2201,1385,910,8324,5
warch,596,4103,2201,770,654,8324,5
gomar,965,3069,885,2214,1190,8323,5
sloat,2206,1193,1426,2214,1284,8323,5
forli,847,3069,2201,1295,910,8322,5
crake,1512,1543,1959,628,2679,8321,5
metal,1225,2863,1048,2214,971,8321,5
polik,1184,3069,1603,1963,502,8321,5
redan,948,2863,774,2214,1522,8321,5
sidhe,2206,2239,774,423,2679,8321,5
sprue,2206,336,2201,899,2679,8321,5
tinsy,1264,2239,1757,945,2116,8321,5
bevin,1555,2863,417,1963,1522,8320,5
divet,1128,2239,417,3252,1284,8320,5
heidy,844,2863,1668,829,2116,8320,5
piave,1184,2239,1959,259,2679,8320,5
tombe,1264,3069,885,423,2679,8320,5
jagir,446,4103,616,1963,1190,8318,5
podge,1184,3069,774,612,2679,8318,5
resin,948,2863,1021,1963,1522,8317,5
zamir,176,4103,885,1963,1190,8317,5
kafir,789,4103,271,1963,1190,8316,5
kelsy,789,2863,1603,945,2116,8316,5
twins,1264,226,1668,1391,3767,8316,5
monic,1225,3069,1757,1963,300,8314,5
palch,1184,4103,1603,770,654,8314,5
zorah,176,3069,2201,2214,654,8314,5
hoban,844,3069,664,2214,1522,8313,5
donax,1128,3069,1757,2214,144,8312,5
gimel,965,2239,885,3252,971,8312,5
melva,1225,2863,1603,259,2362,8312,5
renky,948,2863,1757,628,2116,8312,5
shona,2206,927,1426,1391,2362,8312,5
sodic,2206,3069,774,1963,300,8312,5
vogel,404,3069,616,3252,971,8312,5
douai,1128,3069,990,2214,910,8311,5
gelid,965,2863,1603,1963,917,8311,5
capri,1512,4103,560,1225,910,8310,5
giber,965,2239,664,3252,1190,8310,5
huile,844,1824,1668,1295,2679,8310,5
kotar,789,3069,1048,2214,1190,8310,5
loupe,1046,3069,990,526,2679,8310,5
nasby,647,4103,1021,423,2116,8310,5
prase,1184,1543,1959,945,2679,8310,5
vache,404,4103,701,423,2679,8310,5
bumfs,1555,1824,885,278,3767,8309,5
jehus,446,2863,334,899,3767,8309,5
jolda,446,3069,1603,829,2362,8309,5
leban,1046,2863,664,2214,1522,8309,5
leoma,1046,2863,1426,612,2362,8309,5
logue,1046,3069,616,899,2679,8309,5
nakir,647,4103,406,1963,1190,8309,5
shide,2206,927,1668,829,2679,8309,5
gilty,965,2239,1603,1385,2116,8308,5
heapy,844,2863,1959,526,2116,8308,5
luben,1046,1824,664,3252,1522,8308,5
shiny,2206,927,1668,1391,2116,8308,5
aldie,1698,1193,774,1963,2679,8307,5
howfs,844,3069,349,278,3767,8307,5
shena,2206,927,1421,1391,2362,8307,5
basco,1555,4103,1021,770,857,8306,5
jower,446,3069,349,3252,1190,8306,5
latif,1046,4103,1048,1963,145,8305,5
corgi,1512,3069,2201,612,910,8304,5
nelda,647,2863,1603,829,2362,8304,5
pousy,1184,3069,990,945,2116,8304,5
south,2206,3069,990,1385,654,8304,5
cetid,1512,2863,1048,1963,917,8303,5
trone,1264,1543,1426,1391,2679,8303,5
chare,1512,927,1959,1225,2679,8302,5
leroi,1046,2863,2201,1282,910,8302,5
vimen,404,2239,885,3252,1522,8302,5
thier,1264,927,1668,3252,1190,8301,5
acids,1698,338,1668,829,3767,8300,5
arvie,1698,1543,417,1963,2679,8300,5
gluts,965,1193,990,1385,3767,8300,5
hider,844,2239,774,3252,1190,8299,5
beild,1555,2863,1668,1295,917,8298,5
yonit,225,3069,1757,1963,1284,8298,5
mpret,1225,336,2201,3252,1284,8298,5
rouge,948,3069,990,612,2679,8298,5
wiser,596,2239,1021,3252,1190,8298,5
shape,2206,927,1959,526,2679,8297,5
tilda,1264,2239,1603,829,2362,8297,5
dirgy,1128,2239,2201,612,2116,8296,5
nurse,647,1824,2201,945,2679,8296,5
slave,2206,1193,1959,259,2679,8296,5
aylet,1698,458,1603,3252,1284,8295,5
armed,1698,1543,885,3252,917,8295,5
binky,1555,2239,1757,628,2116,8295,5
boxty,1555,3069,170,1385,2116,8295,5
jerba,446,2863,2201,423,2362,8295,5
sware,2206,226,1959,1225,2679,8295,5
mesal,1225,2863,1021,2214,971,8294,5
pylos,1184,458,1603,1282,3767,8294,5
tabic,1264,4103,664,1963,300,8294,5
bakst,1555,4103,406,945,1284,8293,5
godin,965,3069,774,1963,1522,8293,5
gomez,965,3069,885,3252,122,8293,5
kinde,789,2239,1757,829,2679,8293,5
krips,789,1543,1668,526,3767,8293,5
flaps,847,1193,1959,526,3767,8292,5
arose,1698,1543,1426,945,2679,8291,5
yodel,225,3069,774,3252,971,8291,5
gyrus,965,458,2201,899,3767,8290,5
shean,2206,927,1421,2214,1522,8290,5
amids,1698,327,1668,829,3767,8289,5
arkie,1698,1543,406,1963,2679,8289,5
diety,1128,2239,1421,1385,2116,8289,5
haldi,844,4103,1603,829,910,8289,5
khets,789,927,1421,1385,3767,8289,5
clase,1512,1193,1959,945,2679,8288,5
nowel,647,3069,349,3252,971,8288,5
denby,1128,2863,1757,423,2116,8287,5
perth,1184,2863,2201,1385,654,8287,5
ludie,1046,1824,774,1963,2679,8286,5
woman,596,3069,885,2214,1522,8286,5
yowie,225,3069,349,1963,2679,8285,5
labor,1046,4103,664,1282,1190,8285,5
uayeb,420,4103,381,3252,129,8285,5
byrne,1555,458,2201,1391,2679,8284,5
helga,844,2863,1603,612,2362,8284,5
xurel,36,1824,2201,3252,971,8284,5
ariew,1698,1543,1668,3252,122,8283,5
ricks,948,2239,701,628,3767,8283,5
thous,1264,927,1426,899,3767,8283,5
rabot,948,4103,664,1282,1284,8281,5
rugae,948,1824,616,2214,2679,8281,5
subra,2206,1824,664,1225,2362,8281,5
volpe,404,3069,1603,526,2679,8281,5
hurly,844,1824,2201,1295,2116,8280,5
knits,789,671,1668,1385,3767,8280,5
petal,1184,2863,1048,2214,971,8280,5
spine,2206,336,1668,1391,2679,8280,5
bingy,1555,2239,1757,612,2116,8279,5
corpl,1512,3069,2201,526,971,8279,5
latro,1046,4103,1048,1225,857,8279,5
soluk,2206,3069,1603,899,502,8279,5
broek,1555,1543,1426,3252,502,8278,5
nesta,647,2863,1021,1385,2362,8278,5
gerip,965,2863,2201,1963,285,8277,5
kalvn,789,4103,1603,259,1522,8276,5
mulse,1225,1824,1603,945,2679,8276,5
rodin,948,3069,774,1963,1522,8276,5
bluet,1555,1193,990,3252,1284,8274,5
bride,1555,1543,1668,829,2679,8274,5
lauri,1046,4103,990,1225,910,8274,5
luian,1046,1824,1668,2214,1522,8274,5
spite,2206,336,1668,1385,2679,8274,5
trade,1264,1543,1959,829,2679,8274,5
tzars,1264,59,1959,1225,3767,8274,5
velar,404,2863,1603,2214,1190,8274,5
briny,1555,1543,1668,1391,2116,8273,5
bulge,1555,1824,1603,612,2679,8273,5
shlep,2206,927,1603,3252,285,8273,5
sulfa,2206,1824,1603,278,2362,8273,5
bapct,1555,4103,560,770,1284,8272,5
brena,1555,1543,1421,1391,2362,8272,5
slipe,2206,1193,1668,526,2679,8272,5
veron,404,2863,2201,1282,1522,8272,5
cowry,1512,3069,349,1225,2116,8271,5
piker,1184,2239,406,3252,1190,8271,5
troys,1264,1543,1426,271,3767,8271,5
beton,1555,2863,1048,1282,1522,8270,5
pursy,1184,1824,2201,945,2116,8270,5
bakli,1555,4103,406,1295,910,8269,5
cruel,1512,1543,990,3252,971,8268,5
eosin,693,3069,1021,1963,1522,8268,5
hoyle,844,3069,381,1295,2679,8268,5
domal,1128,3069,885,2214,971,8267,5
metad,1225,2863,1048,2214,917,8267,5
mowse,1225,3069,349,945,2679,8267,5
fasti,847,4103,1021,1385,910,8266,5
kiths,789,2239,1048,423,3767,8266,5
muted,1225,1824,1048,3252,917,8266,5
punty,1184,1824,1757,1385,2116,8266,5
treys,1264,1543,1421,271,3767,8266,5
tumps,1264,1824,885,526,3767,8266,5
fiona,847,2239,1426,1391,2362,8265,5
hogan,844,3069,616,2214,1522,8265,5
smite,2206,327,1668,1385,2679,8265,5
axels,1698,83,1421,1295,3767,8264,5
bowge,1555,3069,349,612,2679,8264,5
vower,404,3069,349,3252,1190,8264,5
folky,847,3069,1603,628,2116,8263,5
yerga,225,2863,2201,612,2362,8263,5
turma,1264,1824,2201,612,2362,8263,5
ulnae,420,1193,1757,2214,2679,8263,5
leafy,1046,2863,1959,278,2116,8262,5
moyra,1225,3069,381,1225,2362,8262,5
firma,847,2239,2201,612,2362,8261,5
paxon,1184,4103,170,1282,1522,8261,5
agnus,1698,139,1757,899,3767,8260,5
alums,1698,1193,990,612,3767,8260,5
capiz,1512,4103,560,1963,122,8260,5
absey,1698,172,1021,3252,2116,8259,5
recta,948,2863,701,1385,2362,8259,5
washy,596,4103,1021,423,2116,8259,5
alcus,1698,1193,701,899,3767,8258,5
golva,965,3069,1603,259,2362,8258,5
yodhs,225,3069,774,423,3767,8258,5
koban,789,3069,664,2214,1522,8258,5
milda,1225,2239,1603,829,2362,8258,5
jenda,446,2863,1757,829,2362,8257,5
jovia,446,3069,417,1963,2362,8257,5
burnt,1555,1824,2201,1391,1284,8255,5
foxed,847,3069,170,3252,917,8255,5
quags,93,1824,1959,612,3767,8255,5
sikar,2206,2239,406,2214,1190,8255,5
finly,847,2239,1757,1295,2116,8254,5
jerky,446,2863,2201,628,2116,8254,5
peano,1184,2863,1959,1391,857,8254,5
dorsi,1128,3069,2201,945,910,8253,5
modal,1225,3069,774,2214,971,8253,5
phuts,1184,927,990,1385,3767,8253,5
welda,596,2863,1603,829,2362,8253,5
whils,596,927,1668,1295,3767,8253,5
ganof,965,4103,1757,1282,145,8252,5
guser,965,1824,1021,3252,1190,8252,5
tirza,1264,2239,2201,186,2362,8252,5
stile,2206,403,1668,1295,2679,8251,5
train,1264,1543,1959,1963,1522,8251,5
agers,1698,139,1421,1225,3767,8250,5
rotal,948,3069,1048,2214,971,8250,5
shice,2206,927,1668,770,2679,8250,5
bohme,1555,3069,334,612,2679,8249,5
fairm,847,4103,1668,1225,406,8249,5
ganch,965,4103,1757,770,654,8249,5
ayous,1698,458,1426,899,3767,8248,5
akers,1698,137,1421,1225,3767,8248,5
konya,789,3069,1757,271,2362,8248,5
count,1512,3069,990,1391,1284,8246,5
rauli,948,4103,990,1295,910,8246,5
flics,847,1193,1668,770,3767,8245,5
kited,789,2239,1048,3252,917,8245,5
seitz,2206,2863,1668,1385,122,8244,5
leavy,1046,2863,1959,259,2116,8243,5
scrat,2206,338,2201,2214,1284,8243,5
debra,1128,2863,664,1225,2362,8242,5
secor,2206,2863,701,1282,1190,8242,5
talck,1264,4103,1603,770,502,8242,5
jalur,446,4103,1603,899,1190,8241,5
laich,1046,4103,1668,770,654,8241,5
rimed,948,2239,885,3252,917,8241,5
sievy,2206,2239,1421,259,2116,8241,5
sprat,2206,336,2201,2214,1284,8241,5
mesad,1225,2863,1021,2214,917,8240,5
ozias,532,59,1668,2214,3767,8240,5
pombe,1184,3069,885,423,2679,8240,5
apics,1698,336,1668,770,3767,8239,5
fowle,847,3069,349,1295,2679,8239,5
mused,1225,1824,1021,3252,917,8239,5
ardel,1698,1543,774,3252,971,8238,5
blote,1555,1193,1426,1385,2679,8238,5
galop,965,4103,1603,1282,285,8238,5
avers,1698,126,1421,1225,3767,8237,5
litre,1046,2239,1048,1225,2679,8237,5
arsle,1698,1543,1021,1295,2679,8236,5
ickes,473,338,406,3252,3767,8236,5
rayon,948,4103,381,1282,1522,8236,5
zowie,176,3069,349,1963,2679,8236,5
bejan,1555,2863,81,2214,1522,8235,5
pulse,1184,1824,1603,945,2679,8235,5
ringe,948,2239,1757,612,2679,8235,5
bizel,1555,2239,217,3252,971,8234,5
nowed,647,3069,349,3252,917,8234,5
linda,1046,2239,1757,829,2362,8233,5
festy,847,2863,1021,1385,2116,8232,5
ranch,948,4103,1757,770,654,8232,5
derth,1128,2863,2201,1385,654,8231,5
mowra,1225,3069,349,1225,2362,8230,5
sagum,2206,4103,616,899,406,8230,5
scrin,2206,338,2201,1963,1522,8230,5
crena,1512,1543,1421,1391,2362,8229,5
moudy,1225,3069,990,829,2116,8229,5
poind,1184,3069,1668,1391,917,8229,5
taopi,1264,4103,1426,526,910,8229,5
autem,1698,1824,1048,3252,406,8228,5
siroc,2206,2239,2201,1282,300,8228,5
trina,1264,1543,1668,1391,2362,8228,5
fried,847,1543,1668,3252,917,8227,5
cupay,1512,1824,560,2214,2116,8226,5
diver,1128,2239,417,3252,1190,8226,5
alpen,1698,1193,560,3252,1522,8225,5
wolfe,596,3069,1603,278,2679,8225,5
dogly,1128,3069,616,1295,2116,8224,5
murga,1225,1824,2201,612,2362,8224,5
creta,1512,1543,1421,1385,2362,8223,5
pozna,1184,3069,217,1391,2362,8223,5
prone,1184,1543,1426,1391,2679,8223,5
rosal,948,3069,1021,2214,971,8223,5
slyer,2206,1193,381,3252,1190,8222,5
albus,1698,1193,664,899,3767,8221,5
jayme,446,4103,381,612,2679,8221,5
lauro,1046,4103,990,1225,857,8221,5
thane,1264,927,1959,1391,2679,8220,5
crape,1512,1543,1959,526,2679,8219,5
godly,965,3069,774,1295,2116,8219,5
yakin,225,4103,406,1963,1522,8219,5
jarmo,446,4103,2201,612,857,8219,5
zeona,176,2863,1426,1391,2362,8218,5
finew,847,2239,1757,3252,122,8217,5
lamut,1046,4103,885,899,1284,8217,5
prote,1184,1543,1426,1385,2679,8217,5
semic,2206,2863,885,1963,300,8217,5
gamic,965,4103,885,1963,300,8216,5
lepta,1046,2863,560,1385,2362,8216,5
login,1046,3069,616,1963,1522,8216,5
lusia,1046,1824,1021,1963,2362,8216,5
shola,2206,927,1426,1295,2362,8216,5
blade,1555,1193,1959,829,2679,8215,5
brice,1555,1543,1668,770,2679,8215,5
diker,1128,2239,406,3252,1190,8215,5
gouda,965,3069,990,829,2362,8215,5
trace,1264,1543,1959,770,2679,8215,5
venda,404,2863,1757,829,2362,8215,5
jaunt,446,4103,990,1391,1284,8214,5
orlet,532,1543,1603,3252,1284,8214,5
plied,1184,1193,1668,3252,917,8214,5
punce,1184,1824,1757,770,2679,8214,5
zerma,176,2863,2201,612,2362,8214,5
fasto,847,4103,1021,1385,857,8213,5
fouke,847,3069,990,628,2679,8213,5
lucie,1046,1824,701,1963,2679,8213,5
mirza,1225,2239,2201,186,2362,8213,5
sirop,2206,2239,2201,1282,285,8213,5
woldy,596,3069,1603,829,2116,8213,5
crean,1512,1543,1421,2214,1522,8212,5
podal,1184,3069,774,2214,971,8212,5
shily,2206,927,1668,1295,2116,8212,5
byzas,1555,458,217,2214,3767,8211,5
bothy,1555,3069,1048,423,2116,8211,5
dyaus,1128,458,1959,899,3767,8211,5
lanum,1046,4103,1757,899,406,8211,5
reban,948,2863,664,2214,1522,8211,5
rogue,948,3069,616,899,2679,8211,5
shela,2206,927,1421,1295,2362,8211,5
ruben,948,1824,664,3252,1522,8210,5
giron,965,2239,2201,1282,1522,8209,5
venal,404,2863,1757,2214,971,8209,5
stroy,2206,403,2201,1282,2116,8208,5
kiona,789,2239,1426,1391,2362,8207,5
magic,1225,4103,616,1963,300,8207,5
snore,2206,671,1426,1225,2679,8207,5
blaeu,1555,1193,1959,3252,247,8206,5
wolve,596,3069,1603,259,2679,8206,5
glims,965,1193,1668,612,3767,8205,5
roast,948,3069,1959,945,1284,8205,5
gabor,965,4103,664,1282,1190,8204,5
buaze,1555,1824,1959,186,2679,8203,5
buyer,1555,1824,381,3252,1190,8202,5
copsy,1512,3069,560,945,2116,8202,5
pearl,1184,2863,1959,1225,971,8202,5
clone,1512,1193,1426,1391,2679,8201,5
audre,1698,1824,774,1225,2679,8200,5
lowan,1046,3069,349,2214,1522,8200,5
polab,1184,3069,1603,2214,129,8199,5
werby,596,2863,2201,423,2116,8199,5
eblis,693,172,1603,1963,3767,8198,5
julia,446,1824,1603,1963,2362,8198,5
kyars,789,458,1959,1225,3767,8198,5
lemar,1046,2863,885,2214,1190,8198,5
pisek,1184,2239,1021,3252,502,8198,5
profs,1184,1543,1426,278,3767,8198,5
simah,2206,2239,885,2214,654,8198,5
albie,1698,1193,664,1963,2679,8197,5
deriv,1128,2863,2201,1963,41,8196,5
gobat,965,3069,664,2214,1284,8196,5
kieta,789,2239,1421,1385,2362,8196,5
padri,1184,4103,774,1225,910,8196,5
aguey,1698,139,990,3252,2116,8195,5
clote,1512,1193,1426,1385,2679,8195,5
frogs,847,1543,1426,612,3767,8195,5
axers,1698,83,1421,1225,3767,8194,5
hilde,844,2239,1603,829,2679,8194,5
tuber,1264,1824,664,3252,1190,8194,5
boult,1555,3069,990,1295,1284,8193,5
felid,847,2863,1603,1963,917,8193,5
gauri,965,4103,990,1225,910,8193,5
shune,2206,927,990,1391,2679,8193,5
zonda,176,3069,1757,829,2362,8193,5
blain,1555,1193,1959,1963,1522,8192,5
fiber,847,2239,664,3252,1190,8192,5
trows,1264,1543,1426,192,3767,8192,5
wilek,596,2239,1603,3252,502,8192,5
coque,1512,3069,32,899,2679,8191,5
moist,1225,3069,1668,945,1284,8191,5
ratib,948,4103,1048,1963,129,8191,5
girba,965,2239,2201,423,2362,8190,5
pirot,1184,2239,2201,1282,1284,8190,5
tekla,1264,2863,406,1295,2362,8190,5
flabs,847,1193,1959,423,3767,8189,5
pekan,1184,2863,406,2214,1522,8189,5
towny,1264,3069,349,1391,2116,8189,5
byrle,1555,458,2201,1295,2679,8188,5
youre,225,3069,990,1225,2679,8188,5
roald,948,3069,1959,1295,917,8188,5
rudie,948,1824,774,1963,2679,8188,5
shute,2206,927,990,1385,2679,8187,5
trews,1264,1543,1421,192,3767,8187,5
zonal,176,3069,1757,2214,971,8187,5
hadik,844,4103,774,1963,502,8186,5
lazio,1046,4103,217,1963,857,8186,5
preys,1184,1543,1421,271,3767,8186,5
lohan,1046,3069,334,2214,1522,8185,5
spile,2206,336,1668,1295,2679,8184,5
strew,2206,403,2201,3252,122,8184,5
tucks,1264,1824,701,628,3767,8184,5
lobar,1046,3069,664,2214,1190,8183,5
purga,1184,1824,2201,612,2362,8183,5
solum,2206,3069,1603,899,406,8183,5
whirs,596,927,1668,1225,3767,8183,5
mayor,1225,4103,381,1282,1190,8181,5
quids,93,1824,1668,829,3767,8181,5
stire,2206,403,1668,1225,2679,8181,5
bluer,1555,1193,990,3252,1190,8180,5
falco,847,4103,1603,770,857,8180,5
lodge,1046,3069,774,612,2679,8180,5
noric,647,3069,2201,1963,300,8180,5
pabst,1184,4103,664,945,1284,8180,5
pisan,1184,2239,1021,2214,1522,8180,5
regna,948,2863,616,1391,2362,8180,5
skied,2206,137,1668,3252,917,8180,5
dulse,1128,1824,1603,945,2679,8179,5
hicks,844,2239,701,628,3767,8179,5
mirac,1225,2239,2201,2214,300,8179,5
outen,532,1824,1048,3252,1522,8178,5
pasul,1184,4103,1021,899,971,8178,5
airth,1698,2239,2201,1385,654,8177,5
chine,1512,927,1668,1391,2679,8177,5
snary,2206,671,1959,1225,2116,8177,5
supra,2206,1824,560,1225,2362,8177,5
tekoa,1264,2863,406,1282,2362,8177,5
fango,847,4103,1757,612,857,8176,5
sirtf,2206,2239,2201,1385,145,8176,5
trugs,1264,1543,990,612,3767,8176,5
bahut,1555,4103,334,899,1284,8175,5
gleds,965,1193,1421,829,3767,8175,5
heart,844,2863,1959,1225,1284,8175,5
smile,2206,327,1668,1295,2679,8175,5
wodan,596,3069,774,2214,1522,8175,5
namby,647,4103,885,423,2116,8174,5
onley,532,671,1603,3252,2116,8174,5
thurs,1264,927,990,1225,3767,8173,5
amvis,1698,327,417,1963,3767,8172,5
clade,1512,1193,1959,829,2679,8172,5
vaunt,404,4103,990,1391,1284,8172,5
clefs,1512,1193,1421,278,3767,8171,5
reoil,948,2863,1426,1963,971,8171,5
dowse,1128,3069,349,945,2679,8170,5
swine,2206,226,1668,1391,2679,8170,5
cloys,1512,1193,1426,271,3767,8169,5
cubed,1512,1824,664,3252,917,8169,5
faust,847,4103,990,945,1284,8169,5
legoa,1046,2863,616,1282,2362,8169,5
mehta,1225,2863,334,1385,2362,8169,5
cothy,1512,3069,1048,423,2116,8168,5
giule,965,2239,990,1295,2679,8168,5
jeida,446,2863,1668,829,2362,8168,5
drone,1128,1543,1426,1391,2679,8167,5
kirve,789,2239,2201,259,2679,8167,5
haust,844,4103,990,945,1284,8166,5
lousy,1046,3069,990,945,2116,8166,5
mindy,1225,2239,1757,829,2116,8166,5
robin,948,3069,664,1963,1522,8166,5
wonky,596,3069,1757,628,2116,8166,5
begad,1555,2863,616,2214,917,8165,5
rodez,948,3069,774,3252,122,8165,5
amlet,1698,327,1603,3252,1284,8164,5
macri,1225,4103,701,1225,910,8164,5
abnet,1698,172,1757,3252,1284,8163,5
brief,1555,1543,1668,3252,145,8163,5
regan,948,2863,616,2214,1522,8163,5
uinta,420,2239,1757,1385,2362,8163,5
luise,1046,1824,1668,945,2679,8162,5
rugen,948,1824,616,3252,1522,8162,5
weaky,596,2863,1959,628,2116,8162,5
douma,1128,3069,990,612,2362,8161,5
gawky,965,4103,349,628,2116,8161,5
wendy,596,2863,1757,829,2116,8161,5
puget,1184,1824,616,3252,1284,8160,5
brahe,1555,1543,1959,423,2679,8159,5
brune,1555,1543,990,1391,2679,8158,5
chops,1512,927,1426,526,3767,8158,5
dunce,1128,1824,1757,770,2679,8158,5
phigs,1184,927,1668,612,3767,8158,5
hakon,844,4103,406,1282,1522,8157,5
behar,1555,2863,334,2214,1190,8156,5
forth,847,3069,2201,1385,654,8156,5
purdy,1184,1824,2201,829,2116,8154,5
tovar,1264,3069,417,2214,1190,8154,5
debat,1128,2863,664,2214,1284,8153,5
gabun,965,4103,664,899,1522,8153,5
brute,1555,1543,990,1385,2679,8152,5
fauld,847,4103,990,1295,917,8152,5
flier,847,1193,1668,3252,1190,8150,5
algie,1698,1193,616,1963,2679,8149,5
hauld,844,4103,990,1295,917,8149,5
zandt,176,4103,1757,829,1284,8149,5
brose,1555,1543,1426,945,2679,8148,5
razid,948,4103,217,1963,917,8148,5
vinta,404,2239,1757,1385,2362,8147,5
acier,1698,338,1668,3252,1190,8146,5
csnet,1512,341,1757,3252,1284,8146,5
hyrie,844,458,2201,1963,2679,8145,5
mucks,1225,1824,701,628,3767,8145,5
zayin,176,4103,381,1963,1522,8145,5
devan,1128,2863,417,2214,1522,8144,5
liver,1046,2239,417,3252,1190,8144,5
rawky,948,4103,349,628,2116,8144,5
sugat,2206,1824,616,2214,1284,8144,5
wacky,596,4103,701,628,2116,8144,5
snake,2206,671,1959,628,2679,8143,5
wrafs,596,1543,1959,278,3767,8143,5
yoker,225,3069,406,3252,1190,8142,5
wando,596,4103,1757,829,857,8142,5
cosby,1512,3069,1021,423,2116,8141,5
disna,1128,2239,1021,1391,2362,8141,5
kelcy,789,2863,1603,770,2116,8141,5
jonah,446,3069,1757,2214,654,8140,5
payor,1184,4103,381,1282,1190,8140,5
phane,1184,927,1959,1391,2679,8140,5
rivet,948,2239,417,3252,1284,8140,5
aedon,1698,2863,774,1282,1522,8139,5
elaps,693,1193,1959,526,3767,8138,5
yaird,225,4103,1668,1225,917,8138,5
donut,1128,3069,1757,899,1284,8137,5
wesla,596,2863,1021,1295,2362,8137,5
desai,1128,2863,1021,2214,910,8136,5
freia,847,1543,1421,1963,2362,8136,5
gamut,965,4103,885,899,1284,8136,5
moniz,1225,3069,1757,1963,122,8136,5
zawde,176,4103,349,829,2679,8136,5
faqir,847,4103,32,1963,1190,8135,5
virge,404,2239,2201,612,2679,8135,5
geoid,965,2863,1426,1963,917,8134,5
simon,2206,2239,885,1282,1522,8134,5
actos,1698,338,1048,1282,3767,8133,5
blows,1555,1193,1426,192,3767,8133,5
liker,1046,2239,406,3252,1190,8133,5
fagot,847,4103,616,1282,1284,8132,5
kilty,789,2239,1603,1385,2116,8132,5
krems,789,1543,1421,612,3767,8132,5
sloke,2206,1193,1426,628,2679,8132,5
usnea,420,341,1757,3252,2362,8132,5
aptos,1698,336,1048,1282,3767,8131,5
hinge,844,2239,1757,612,2679,8131,5
batch,1555,4103,1048,770,654,8130,5
dumps,1128,1824,885,526,3767,8130,5
helio,844,2863,1603,1963,857,8130,5
murid,1225,1824,2201,1963,917,8130,5
manuf,1225,4103,1757,899,145,8129,5
poucy,1184,3069,990,770,2116,8129,5
sergu,2206,2863,2201,612,247,8129,5
aizle,1698,2239,217,1295,2679,8128,5
ioved,473,3069,417,3252,917,8128,5
durga,1128,1824,2201,612,2362,8127,5
prole,1184,1543,1426,1295,2679,8127,5
duena,1128,1824,1421,1391,2362,8126,5
suent,2206,1824,1421,1391,1284,8126,5
bilgy,1555,2239,1603,612,2116,8125,5
pelag,1184,2863,1603,2214,261,8125,5
pindy,1184,2239,1757,829,2116,8125,5
awner,1698,226,1757,3252,1190,8123,5
demit,1128,2863,885,1963,1284,8123,5
locke,1046,3069,701,628,2679,8123,5
tamul,1264,4103,885,899,971,8122,5
quiet,93,1824,1668,3252,1284,8121,5
teryn,1264,2863,2201,271,1522,8121,5
ideas,473,245,1421,2214,3767,8120,5
nazir,647,4103,217,1963,1190,8120,5
cupel,1512,1824,560,3252,971,8119,5
gowan,965,3069,349,2214,1522,8119,5
screw,2206,338,2201,3252,122,8119,5
wagon,596,4103,616,1282,1522,8119,5
macur,1225,4103,701,899,1190,8118,5
cajun,1512,4103,81,899,1522,8117,5
denim,1128,2863,1757,1963,406,8117,5
felon,847,2863,1603,1282,1522,8117,5
sprew,2206,336,2201,3252,122,8117,5
sixty,2206,2239,170,1385,2116,8116,5
cowal,1512,3069,349,2214,971,8115,5
drain,1128,1543,1959,1963,1522,8115,5
simba,2206,2239,885,423,2362,8115,5
dalbo,1128,4103,1603,423,857,8114,5
dinka,1128,2239,1757,628,2362,8114,5
josue,446,3069,1021,899,2679,8114,5
spire,2206,336,1668,1225,2679,8114,5
loath,1046,3069,1959,1385,654,8113,5
cidra,1512,2239,774,1225,2362,8112,5
legra,1046,2863,616,1225,2362,8112,5
melun,1225,2863,1603,899,1522,8112,5
prows,1184,1543,1426,192,3767,8112,5
arced,1698,1543,701,3252,917,8111,5
macro,1225,4103,701,1225,857,8111,5
bunga,1555,1824,1757,612,2362,8110,5
becka,1555,2863,701,628,2362,8109,5
medit,1225,2863,774,1963,1284,8109,5
powny,1184,3069,349,1391,2116,8109,5
thaws,1264,927,1959,192,3767,8109,5
turio,1264,1824,2201,1963,857,8109,5
bewry,1555,2863,349,1225,2116,8108,5
birdt,1555,2239,2201,829,1284,8108,5
irous,473,1543,1426,899,3767,8108,5
menic,1225,2863,1757,1963,300,8108,5
alder,1698,1193,774,3252,1190,8107,5
herod,844,2863,2201,1282,917,8107,5
hogue,844,3069,616,899,2679,8107,5
lucet,1046,1824,701,3252,1284,8107,5
mincy,1225,2239,1757,770,2116,8107,5
bisme,1555,2239,1021,612,2679,8106,5
byous,1555,458,1426,899,3767,8105,5
crose,1512,1543,1426,945,2679,8105,5
stone,2206,403,1426,1391,2679,8105,5
feuar,847,2863,990,2214,1190,8104,5
mcpas,1225,338,560,2214,3767,8104,5
pucks,1184,1824,701,628,3767,8104,5
pablo,1184,4103,664,1295,857,8103,5
teind,1264,2863,1668,1391,917,8103,5
pagod,1184,4103,616,1282,917,8102,5
rowan,948,3069,349,2214,1522,8102,5
slaky,2206,1193,1959,628,2116,8102,5
whens,596,927,1421,1391,3767,8102,5
hoast,844,3069,1959,945,1284,8101,5
yoghs,225,3069,616,423,3767,8100,5
iosep,473,3069,1021,3252,285,8100,5
fiora,847,2239,1426,1225,2362,8099,5
mitra,1225,2239,1048,1225,2362,8099,5
aphis,1698,336,334,1963,3767,8098,5
orate,532,1543,1959,1385,2679,8098,5
least,1046,2863,1959,945,1284,8097,5
moche,1225,3069,701,423,2679,8097,5
munge,1225,1824,1757,612,2679,8097,5
rilke,948,2239,1603,628,2679,8097,5
myers,1225,458,1421,1225,3767,8096,5
whets,596,927,1421,1385,3767,8096,5
worst,596,3069,2201,945,1284,8095,5
einar,693,2239,1757,2214,1190,8093,5
filar,847,2239,1603,2214,1190,8093,5
judos,446,1824,774,1282,3767,8093,5
mikel,1225,2239,406,3252,971,8093,5
turon,1264,1824,2201,1282,1522,8093,5
drina,1128,1543,1668,1391,2362,8092,5
fumet,847,1824,885,3252,1284,8092,5
lacto,1046,4103,701,1385,857,8092,5
tyred,1264,458,2201,3252,917,8092,5
borgh,1555,3069,2201,612,654,8091,5
gibel,965,2239,664,3252,971,8091,5
herut,844,2863,2201,899,1284,8091,5
hiera,844,2239,1421,1225,2362,8091,5
kotal,789,3069,1048,2214,971,8091,5
decoy,1128,2863,701,1282,2116,8090,5
hilar,844,2239,1603,2214,1190,8090,5
janok,446,4103,1757,1282,502,8090,5
joked,446,3069,406,3252,917,8090,5
kyrie,789,458,2201,1963,2679,8090,5
month,1225,3069,1757,1385,654,8090,5
ahoys,1698,927,1426,271,3767,8089,5
gazon,965,4103,217,1282,1522,8089,5
guary,965,1824,1959,1225,2116,8089,5
humet,844,1824,885,3252,1284,8089,5
minah,1225,2239,1757,2214,654,8089,5
choel,1512,927,1426,3252,971,8088,5
lyons,1046,458,1426,1391,3767,8088,5
lowse,1046,3069,349,945,2679,8088,5
supat,2206,1824,560,2214,1284,8088,5
corum,1512,3069,2201,899,406,8087,5
jowel,446,3069,349,3252,971,8087,5
luted,1046,1824,1048,3252,917,8087,5
rohan,948,3069,334,2214,1522,8087,5
romal,948,3069,885,2214,971,8087,5
meath,1225,2863,1959,1385,654,8086,5
nervy,647,2863,2201,259,2116,8086,5
tomah,1264,3069,885,2214,654,8086,5
clews,1512,1193,1421,192,3767,8085,5
doesn,1128,3069,1421,945,1522,8085,5
hiper,844,2239,560,3252,1190,8085,5
tepoy,1264,2863,560,1282,2116,8085,5
tudel,1264,1824,774,3252,971,8085,5
ohaus,532,927,1959,899,3767,8084,5
uraei,420,1543,1959,3252,910,8084,5
fidel,847,2239,774,3252,971,8083,5
laigh,1046,4103,1668,612,654,8083,5
nurly,647,1824,2201,1295,2116,8083,5
adlet,1698,245,1603,3252,1284,8082,5
dirac,1128,2239,2201,2214,300,8082,5
faurd,847,4103,990,1225,917,8082,5
kerst,789,2863,2201,945,1284,8082,5
kolva,789,3069,1603,259,2362,8082,5
rodge,948,3069,774,612,2679,8082,5
bahur,1555,4103,334,899,1190,8081,5
bespy,1555,2863,1021,526,2116,8081,5
blaew,1555,1193,1959,3252,122,8081,5
bundy,1555,1824,1757,829,2116,8081,5
chile,1512,927,1668,1295,2679,8081,5
guise,965,1824,1668,945,2679,8081,5
argel,1698,1543,616,3252,971,8080,5
court,1512,3069,990,1225,1284,8080,5
hidel,844,2239,774,3252,971,8080,5
resit,948,2863,1021,1963,1284,8079,5
blore,1555,1193,1426,1225,2679,8078,5
rubie,948,1824,664,1963,2679,8078,5
world,596,3069,2201,1295,917,8078,5
hemin,844,2863,885,1963,1522,8077,5
kesar,789,2863,1021,2214,1190,8077,5
curby,1512,1824,2201,423,2116,8076,5
dewan,1128,2863,349,2214,1522,8076,5
mixer,1225,2239,170,3252,1190,8076,5
stade,2206,403,1959,829,2679,8076,5
vault,404,4103,990,1295,1284,8076,5
skite,2206,137,1668,1385,2679,8075,5
yerba,225,2863,2201,423,2362,8074,5
swile,2206,226,1668,1295,2679,8074,5
brike,1555,1543,1668,628,2679,8073,5
brisa,1555,1543,1668,945,2362,8073,5
josep,446,3069,1021,3252,285,8073,5
lohse,1046,3069,334,945,2679,8073,5
bauch,1555,4103,990,770,654,8072,5
maidu,1225,4103,1668,829,247,8072,5
punke,1184,1824,1757,628,2679,8072,5
bengt,1555,2863,1757,612,1284,8071,5
lubet,1046,1824,664,3252,1284,8070,5
tourn,1264,3069,990,1225,1522,8070,5
abner,1698,172,1757,3252,1190,8069,5
evros,693,126,2201,1282,3767,8069,5
flane,847,1193,1959,1391,2679,8069,5
sabzi,2206,4103,664,186,910,8069,5
wazir,596,4103,217,1963,1190,8069,5
boryl,1555,3069,2201,271,971,8067,5
shode,2206,927,1426,829,2679,8067,5
bosun,1555,3069,1021,899,1522,8066,5
sizar,2206,2239,217,2214,1190,8066,5
hecla,844,2863,701,1295,2362,8065,5
joyed,446,3069,381,3252,917,8065,5
safko,2206,4103,271,628,857,8065,5
gelya,965,2863,1603,271,2362,8064,5
giver,965,2239,417,3252,1190,8063,5
brule,1555,1543,990,1295,2679,8062,5
levan,1046,2863,417,2214,1522,8062,5
demal,1128,2863,885,2214,971,8061,5
velda,404,2863,1603,829,2362,8061,5
ality,1698,1193,1668,1385,2116,8060,5
citua,1512,2239,1048,899,2362,8060,5
debar,1128,2863,664,2214,1190,8059,5
faruq,847,4103,2201,899,9,8059,5
niota,647,2239,1426,1385,2362,8059,5
thoer,1264,927,1426,3252,1190,8059,5
byler,1555,458,1603,3252,1190,8058,5
fural,847,1824,2201,2214,971,8057,5
milka,1225,2239,1603,628,2362,8057,5
riced,948,2239,701,3252,917,8057,5
shoat,2206,927,1426,2214,1284,8057,5
snoek,2206,671,1426,3252,502,8057,5
trame,1264,1543,1959,612,2679,8057,5
apods,1698,336,1426,829,3767,8056,5
lepra,1046,2863,560,1225,2362,8056,5
poche,1184,3069,701,423,2679,8056,5
siang,2206,2239,1959,1391,261,8056,5
hokan,844,3069,406,2214,1522,8055,5
thare,1264,927,1959,1225,2679,8054,5
ardys,1698,1543,774,271,3767,8053,5
deify,1128,2863,1668,278,2116,8053,5
digne,1128,2239,616,1391,2679,8053,5
downy,1128,3069,349,1391,2116,8053,5
dulat,1128,1824,1603,2214,1284,8053,5
feint,847,2863,1668,1391,1284,8053,5
snide,2206,671,1668,829,2679,8053,5
stain,2206,403,1959,1963,1522,8053,5
lirot,1046,2239,2201,1282,1284,8052,5
pikel,1184,2239,406,3252,971,8052,5
sheat,2206,927,1421,2214,1284,8052,5
wited,596,2239,1048,3252,917,8052,5
drews,1128,1543,1421,192,3767,8051,5
gavot,965,4103,417,1282,1284,8051,5
tildy,1264,2239,1603,829,2116,8051,5
wider,596,2239,774,3252,1190,8051,5
komsa,789,3069,885,945,2362,8050,5
sugar,2206,1824,616,2214,1190,8050,5
volga,404,3069,1603,612,2362,8050,5
lopez,1046,3069,560,3252,122,8049,5
sercq,2206,2863,2201,770,9,8049,5
ducks,1128,1824,701,628,3767,8048,5
lumps,1046,1824,885,526,3767,8048,5
medal,1225,2863,774,2214,971,8047,5
ahmet,1698,927,885,3252,1284,8046,5
vowel,404,3069,349,3252,971,8045,5
piman,1184,2239,885,2214,1522,8044,5
retal,948,2863,1048,2214,971,8044,5
cunye,1512,1824,1757,271,2679,8043,5
viole,404,2239,1426,1295,2679,8043,5
ameds,1698,327,1421,829,3767,8042,5
yodle,225,3069,774,1295,2679,8042,5
kenya,789,2863,1757,271,2362,8042,5
lisan,1046,2239,1021,2214,1522,8042,5
heavy,844,2863,1959,259,2116,8041,5
hutia,844,1824,1048,1963,2362,8041,5
snape,2206,671,1959,526,2679,8041,5
wince,596,2239,1757,770,2679,8041,5
cagui,1512,4103,616,899,910,8040,5
drugs,1128,1543,990,612,3767,8040,5
drums,1128,1543,990,612,3767,8040,5
hawky,844,4103,349,628,2116,8040,5
scone,2206,338,1426,1391,2679,8040,5
sunol,2206,1824,1757,1282,971,8040,5
tiraz,1264,2239,2201,2214,122,8040,5
irate,473,1543,1959,1385,2679,8039,5
miked,1225,2239,406,3252,917,8039,5
naldo,647,4103,1603,829,857,8039,5
cundy,1512,1824,1757,829,2116,8038,5
himne,844,2239,885,1391,2679,8038,5
knots,789,671,1426,1385,3767,8038,5
flays,847,1193,1959,271,3767,8037,5
gibed,965,2239,664,3252,917,8037,5
hamli,844,4103,885,1295,910,8037,5
shady,2206,927,1959,829,2116,8037,5
tiple,1264,2239,560,1295,2679,8037,5
atmos,1698,403,885,1282,3767,8035,5
jasik,446,4103,1021,1963,502,8035,5
kilar,789,2239,1603,2214,1190,8035,5
sigma,2206,2239,616,612,2362,8035,5
vesta,404,2863,1021,1385,2362,8035,5
birth,1555,2239,2201,1385,654,8034,5
cahiz,1512,4103,334,1963,122,8034,5
scote,2206,338,1426,1385,2679,8034,5
decry,1128,2863,701,1225,2116,8033,5
eilat,693,2239,1603,2214,1284,8033,5
elvis,693,1193,417,1963,3767,8033,5
jowed,446,3069,349,3252,917,8033,5
kiron,789,2239,2201,1282,1522,8033,5
slant,2206,1193,1959,1391,1284,8033,5
texan,1264,2863,170,2214,1522,8033,5
vigen,404,2239,616,3252,1522,8033,5
bicep,1555,2239,701,3252,285,8032,5
cimex,1512,2239,885,3252,144,8032,5
mohar,1225,3069,334,2214,1190,8032,5
nesty,647,2863,1021,1385,2116,8032,5
wurly,596,1824,2201,1295,2116,8032,5
hinda,844,2239,1757,829,2362,8031,5
lotah,1046,3069,1048,2214,654,8031,5
lunar,1046,1824,1757,2214,1190,8031,5
mourn,1225,3069,990,1225,1522,8031,5
lovat,1046,3069,417,2214,1284,8030,5
runty,948,1824,1757,1385,2116,8030,5
shave,2206,927,1959,259,2679,8030,5
slope,2206,1193,1426,526,2679,8030,5
tunal,1264,1824,1757,2214,971,8030,5
cesya,1512,2863,1021,271,2362,8029,5
kaimo,789,4103,1668,612,857,8029,5
nicer,647,2239,701,3252,1190,8029,5
viral,404,2239,2201,2214,971,8029,5
final,847,2239,1757,2214,971,8028,5
lotze,1046,3069,1048,186,2679,8028,5
dumbs,1128,1824,885,423,3767,8027,5
luteo,1046,1824,1048,3252,857,8027,5
nardu,647,4103,2201,829,247,8027,5
shure,2206,927,990,1225,2679,8027,5
bozal,1555,3069,217,2214,971,8026,5
rigel,948,2239,616,3252,971,8026,5
wised,596,2239,1021,3252,917,8025,5
coryl,1512,3069,2201,271,971,8024,5
avner,1698,126,1757,3252,1190,8023,5
sidon,2206,2239,774,1282,1522,8023,5
smote,2206,327,1426,1385,2679,8023,5
tigre,1264,2239,616,1225,2679,8023,5
views,404,2239,1421,192,3767,8023,5
chase,1512,927,1959,945,2679,8022,5
koali,789,3069,1959,1295,910,8022,5
glare,965,1193,1959,1225,2679,8021,5
bernj,1555,2863,2201,1391,10,8020,5
prise,1184,1543,1668,945,2679,8019,5
secno,2206,2863,701,1391,857,8018,5
jabon,446,4103,664,1282,1522,8017,5
kauri,789,4103,990,1225,910,8017,5
naish,647,4103,1668,945,654,8017,5
stace,2206,403,1959,770,2679,8017,5
turgy,1264,1824,2201,612,2116,8017,5
geast,965,2863,1959,945,1284,8016,5
linga,1046,2239,1757,612,2362,8016,5
rusel,948,1824,1021,3252,971,8016,5
cyler,1512,458,1603,3252,1190,8015,5
roath,948,3069,1959,1385,654,8015,5
tasco,1264,4103,1021,770,857,8015,5
bewit,1555,2863,349,1963,1284,8014,5
blake,1555,1193,1959,628,2679,8014,5
crime,1512,1543,1668,612,2679,8014,5
hoard,844,3069,1959,1225,917,8014,5
bagdi,1555,4103,616,829,910,8013,5
liesa,1046,2239,1421,945,2362,8013,5
wimps,596,2239,885,526,3767,8013,5
abuts,1698,172,990,1385,3767,8012,5
fanum,847,4103,1757,899,406,8012,5
anile,1698,671,1668,1295,2679,8011,5
batum,1555,4103,1048,899,406,8011,5
ulvas,420,1193,417,2214,3767,8011,5
ruths,948,1824,1048,423,3767,8010,5
vicus,404,2239,701,899,3767,8010,5
voraz,404,3069,2201,2214,122,8010,5
ablet,1698,172,1603,3252,1284,8009,5
borup,1555,3069,2201,899,285,8009,5
spade,2206,336,1959,829,2679,8009,5
stole,2206,403,1426,1295,2679,8009,5
taxor,1264,4103,170,1282,1190,8009,5
alice,1698,1193,1668,770,2679,8008,5
bearm,1555,2863,1959,1225,406,8008,5
orale,532,1543,1959,1295,2679,8008,5
wiota,596,2239,1426,1385,2362,8008,5
braye,1555,1543,1959,271,2679,8007,5
divel,1128,2239,417,3252,971,8007,5
pulex,1184,1824,1603,3252,144,8007,5
verby,404,2863,2201,423,2116,8007,5
nerti,647,2863,2201,1385,910,8006,5
pedal,1184,2863,774,2214,971,8006,5
besot,1555,2863,1021,1282,1284,8005,5
clary,1512,1193,1959,1225,2116,8005,5
comby,1512,3069,885,423,2116,8005,5
dimna,1128,2239,885,1391,2362,8005,5
slive,2206,1193,1668,259,2679,8005,5
dulce,1128,1824,1603,770,2679,8004,5
furca,847,1824,2201,770,2362,8004,5
kegan,789,2863,616,2214,1522,8004,5
loyde,1046,3069,381,829,2679,8004,5
swire,2206,226,1668,1225,2679,8004,5
tegua,1264,2863,616,899,2362,8004,5
chloe,1512,927,1603,1282,2679,8003,5
flocs,847,1193,1426,770,3767,8003,5
winly,596,2239,1757,1295,2116,8003,5
basov,1555,4103,1021,1282,41,8002,5
brady,1555,1543,1959,829,2116,8002,5
flips,847,1193,1668,526,3767,8001,5
dukie,1128,1824,406,1963,2679,8000,5
piura,1184,2239,990,1225,2362,8000,5
cyane,1512,458,1959,1391,2679,7999,5
dyers,1128,458,1421,1225,3767,7999,5
reast,948,2863,1959,945,1284,7999,5
blame,1555,1193,1959,612,2679,7998,5
dogal,1128,3069,616,2214,971,7998,5
fumer,847,1824,885,3252,1190,7998,5
gilda,965,2239,1603,829,2362,7998,5
grote,965,1543,1426,1385,2679,7998,5
lifer,1046,2239,271,3252,1190,7998,5
piked,1184,2239,406,3252,917,7998,5
tulsa,1264,1824,1603,945,2362,7998,5
alber,1698,1193,664,3252,1190,7997,5
ceorl,1512,2863,1426,1225,971,7997,5
yurta,225,1824,2201,1385,2362,7997,5
menlo,1225,2863,1757,1295,857,7997,5
munda,1225,1824,1757,829,2362,7997,5
cathi,1512,4103,1048,423,910,7996,5
nador,647,4103,774,1282,1190,7996,5
redly,948,2863,774,1295,2116,7996,5
brave,1555,1543,1959,259,2679,7995,5
tophe,1264,3069,560,423,2679,7995,5
jacky,446,4103,701,628,2116,7994,5
lewan,1046,2863,349,2214,1522,7994,5
murky,1225,1824,2201,628,2116,7994,5
hilsa,844,2239,1603,945,2362,7993,5
huila,844,1824,1668,1295,2362,7993,5
mulry,1225,1824,1603,1225,2116,7993,5
telic,1264,2863,1603,1963,300,7993,5
bexar,1555,2863,170,2214,1190,7992,5
dinah,1128,2239,1757,2214,654,7992,5
scrit,2206,338,2201,1963,1284,7992,5
brail,1555,1543,1959,1963,971,7991,5
jasun,446,4103,1021,899,1522,7991,5
symer,2206,458,885,3252,1190,7991,5
tylus,1264,458,1603,899,3767,7991,5
vowed,404,3069,349,3252,917,7991,5
sprit,2206,336,2201,1963,1284,7990,5
death,1128,2863,1959,1385,654,7989,5
adler,1698,245,1603,3252,1190,7988,5
caupo,1512,4103,990,526,857,7988,5
crony,1512,1543,1426,1391,2116,7988,5
plebs,1184,1193,1421,423,3767,7988,5
rozek,948,3069,217,3252,502,7988,5
toxin,1264,3069,170,1963,1522,7988,5
waldo,596,4103,1603,829,857,7988,5
busra,1555,1824,1021,1225,2362,7987,5
lindy,1046,2239,1757,829,2116,7987,5
zenda,176,2863,1757,829,2362,7987,5
auric,1698,1824,2201,1963,300,7986,5
desma,1128,2863,1021,612,2362,7986,5
djins,1128,32,1668,1391,3767,7986,5
keavy,789,2863,1959,259,2116,7986,5
misty,1225,2239,1021,1385,2116,7986,5
segni,2206,2863,616,1391,910,7986,5
spain,2206,336,1959,1963,1522,7986,5
trona,1264,1543,1426,1391,2362,7986,5
urate,420,1543,1959,1385,2679,7986,5
cital,1512,2239,1048,2214,971,7984,5
contg,1512,3069,1757,1385,261,7984,5
ryots,948,458,1426,1385,3767,7984,5
suzan,2206,1824,217,2214,1522,7983,5
nicks,647,2239,701,628,3767,7982,5
triny,1264,1543,1668,1391,2116,7982,5
fodge,847,3069,774,612,2679,7981,5
rilda,948,2239,1603,829,2362,7981,5
torsk,1264,3069,2201,945,502,7981,5
westy,596,2863,1021,1385,2116,7981,5
giher,965,2239,334,3252,1190,7980,5
nugae,647,1824,616,2214,2679,7980,5
relot,948,2863,1603,1282,1284,7980,5
croat,1512,1543,1426,2214,1284,7979,5
yechs,225,2863,701,423,3767,7979,5
hodge,844,3069,774,612,2679,7978,5
rabic,948,4103,664,1963,300,7978,5
lebar,1046,2863,664,2214,1190,7977,5
tunca,1264,1824,1757,770,2362,7977,5
aglet,1698,139,1603,3252,1284,7976,5
wried,596,1543,1668,3252,917,7976,5
finca,847,2239,1757,770,2362,7975,5
grade,965,1543,1959,829,2679,7975,5
koyan,789,3069,381,2214,1522,7975,5
alvus,1698,1193,417,899,3767,7974,5
creat,1512,1543,1421,2214,1284,7974,5
hubie,844,1824,664,1963,2679,7974,5
mpers,1225,336,1421,1225,3767,7974,5
pedir,1184,2863,774,1963,1190,7974,5
phare,1184,927,1959,1225,2679,7974,5
rupie,948,1824,560,1963,2679,7974,5
cebil,1512,2863,664,1963,971,7973,5
durio,1128,1824,2201,1963,857,7973,5
frase,847,1543,1959,945,2679,7973,5
bidar,1555,2239,774,2214,1190,7972,5
cafiz,1512,4103,271,1963,122,7971,5
clake,1512,1193,1959,628,2679,7971,5
ligne,1046,2239,616,1391,2679,7971,5
kopec,789,3069,560,3252,300,7970,5
bugle,1555,1824,616,1295,2679,7969,5
fedin,847,2863,774,1963,1522,7969,5
goudy,965,3069,990,829,2116,7969,5
jurat,446,1824,2201,2214,1284,7969,5
merci,1225,2863,2201,770,910,7969,5
payni,1184,4103,381,1391,910,7969,5
heazy,844,2863,1959,186,2116,7968,5
greys,965,1543,1421,271,3767,7967,5
hedin,844,2863,774,1963,1522,7966,5
lucks,1046,1824,701,628,3767,7966,5
mdacs,1225,245,1959,770,3767,7966,5
oriel,532,1543,1668,3252,971,7966,5
trued,1264,1543,990,3252,917,7966,5
chuet,1512,927,990,3252,1284,7965,5
guide,965,1824,1668,829,2679,7965,5
craye,1512,1543,1959,271,2679,7964,5
housy,844,3069,990,945,2116,7964,5
nerol,647,2863,2201,1282,971,7964,5
niela,647,2239,1421,1295,2362,7964,5
delim,1128,2863,1603,1963,406,7963,5
gloms,965,1193,1426,612,3767,7963,5
sidky,2206,2239,774,628,2116,7963,5
spina,2206,336,1668,1391,2362,7963,5
acned,1698,338,1757,3252,917,7962,5
delqa,1128,2863,1603,5,2362,7961,5
basho,1555,4103,1021,423,857,7959,5
dasht,1128,4103,1021,423,1284,7959,5
mount,1225,3069,990,1391,1284,7959,5
ciano,1512,2239,1959,1391,857,7958,5
flaws,847,1193,1959,192,3767,7958,5
hopin,844,3069,560,1963,1522,7958,5
shear,2206,927,1421,2214,1190,7958,5
torch,1264,3069,2201,770,654,7958,5
cuman,1512,1824,885,2214,1522,7957,5
dowly,1128,3069,349,1295,2116,7957,5
tirol,1264,2239,2201,1282,971,7957,5
alief,1698,1193,1668,3252,145,7956,5
gawby,965,4103,349,423,2116,7956,5
north,647,3069,2201,1385,654,7956,5
shyer,2206,927,381,3252,1190,7956,5
clame,1512,1193,1959,612,2679,7955,5
milpa,1225,2239,1603,526,2362,7955,5
sieur,2206,2239,1421,899,1190,7955,5
zurek,176,1824,2201,3252,502,7955,5
duper,1128,1824,560,3252,1190,7954,5
melic,1225,2863,1603,1963,300,7954,5
shram,2206,927,2201,2214,406,7954,5
topsy,1264,3069,560,945,2116,7954,5
crave,1512,1543,1959,259,2679,7952,5
grain,965,1543,1959,1963,1522,7952,5
kulan,789,1824,1603,2214,1522,7952,5
corvi,1512,3069,2201,259,910,7951,5
lurid,1046,1824,2201,1963,917,7951,5
sevik,2206,2863,417,1963,502,7951,5
alvie,1698,1193,417,1963,2679,7950,5
byran,1555,458,2201,2214,1522,7950,5
ferth,847,2863,2201,1385,654,7950,5
gunar,965,1824,1757,2214,1190,7950,5
hadst,844,4103,774,945,1284,7950,5
rumps,948,1824,885,526,3767,7950,5
space,2206,336,1959,770,2679,7950,5
alger,1698,1193,616,3252,1190,7949,5
depoy,1128,2863,560,1282,2116,7949,5
mingy,1225,2239,1757,612,2116,7949,5
notal,647,3069,1048,2214,971,7949,5
lotha,1046,3069,1048,423,2362,7948,5
scian,2206,338,1668,2214,1522,7948,5
uveas,420,126,1421,2214,3767,7948,5
welcy,596,2863,1603,770,2116,7948,5
teilo,1264,2863,1668,1295,857,7947,5
tobye,1264,3069,664,271,2679,7947,5
vapid,404,4103,560,1963,917,7947,5
wilde,596,2239,1603,829,2679,7946,5
fiver,847,2239,417,3252,1190,7945,5
geyan,965,2863,381,2214,1522,7945,5
loyce,1046,3069,381,770,2679,7945,5
reyna,948,2863,381,1391,2362,7945,5
boing,1555,3069,1668,1391,261,7944,5
niger,647,2239,616,3252,1190,7944,5
fetal,847,2863,1048,2214,971,7943,5
klips,789,1193,1668,526,3767,7943,5
krebs,789,1543,1421,423,3767,7943,5
remit,948,2863,885,1963,1284,7943,5
toque,1264,3069,32,899,2679,7943,5
hiver,844,2239,417,3252,1190,7942,5
spole,2206,336,1426,1295,2679,7942,5
alose,1698,1193,1426,945,2679,7941,5
betag,1555,2863,1048,2214,261,7941,5
strad,2206,403,2201,2214,917,7941,5
quate,93,1824,1959,1385,2679,7940,5
quods,93,1824,1426,829,3767,7939,5
store,2206,403,1426,1225,2679,7939,5
frden,847,1543,774,3252,1522,7938,5
jantu,446,4103,1757,1385,247,7938,5
mayst,1225,4103,381,945,1284,7938,5
pekin,1184,2863,406,1963,1522,7938,5
segol,2206,2863,616,1282,971,7938,5
braid,1555,1543,1959,1963,917,7937,5
drake,1128,1543,1959,628,2679,7937,5
theia,1264,927,1421,1963,2362,7937,5
befit,1555,2863,271,1963,1284,7936,5
campi,1512,4103,885,526,910,7936,5
coxal,1512,3069,170,2214,971,7936,5
evans,693,126,1959,1391,3767,7936,5
pesah,1184,2863,1021,2214,654,7936,5
gurdy,965,1824,2201,829,2116,7935,5
pasco,1184,4103,1021,770,857,7935,5
misce,1225,2239,1021,770,2679,7934,5
rinka,948,2239,1757,628,2362,7934,5
stila,2206,403,1668,1295,2362,7934,5
josef,446,3069,1021,3252,145,7933,5
pidan,1184,2239,774,2214,1522,7933,5
segno,2206,2863,616,1391,857,7933,5
radix,948,4103,774,1963,144,7932,5
hiker,844,2239,406,3252,1190,7931,5
wicks,596,2239,701,628,3767,7931,5
delaw,1128,2863,1603,2214,122,7930,5
cozad,1512,3069,217,2214,917,7929,5
fugie,847,1824,616,1963,2679,7929,5
thine,1264,927,1668,1391,2679,7929,5
cripe,1512,1543,1668,526,2679,7928,5
luger,1046,1824,616,3252,1190,7928,5
tisar,1264,2239,1021,2214,1190,7928,5
lynus,1046,458,1757,899,3767,7927,5
rospa,948,3069,1021,526,2362,7926,5
faxon,847,4103,170,1282,1522,7924,5
kapor,789,4103,560,1282,1190,7924,5
pinky,1184,2239,1757,628,2116,7924,5
septi,2206,2863,560,1385,910,7924,5
trice,1264,1543,1668,770,2679,7924,5
bliny,1555,1193,1668,1391,2116,7923,5
yokel,225,3069,406,3252,971,7923,5
bound,1555,3069,990,1391,917,7922,5
braze,1555,1543,1959,186,2679,7922,5
teloi,1264,2863,1603,1282,910,7922,5
basyl,1555,4103,1021,271,971,7921,5
bovid,1555,3069,417,1963,917,7921,5
drame,1128,1543,1959,612,2679,7921,5
fuage,847,1824,1959,612,2679,7921,5
sukin,2206,1824,406,1963,1522,7921,5
tyner,1264,458,1757,3252,1190,7921,5
tubed,1264,1824,664,3252,917,7921,5
litra,1046,2239,1048,1225,2362,7920,5
wiste,596,2239,1021,1385,2679,7920,5
cebid,1512,2863,664,1963,917,7919,5
yonah,225,3069,1757,2214,654,7919,5
sajou,2206,4103,81,1282,247,7919,5
loche,1046,3069,701,423,2679,7918,5
lunge,1046,1824,1757,612,2679,7918,5
wetly,596,2863,1048,1295,2116,7918,5
meaul,1225,2863,1959,899,971,7917,5
amiel,1698,327,1668,3252,971,7916,5
grace,965,1543,1959,770,2679,7916,5
riped,948,2239,560,3252,917,7916,5
abler,1698,172,1603,3252,1190,7915,5
dougy,1128,3069,990,612,2116,7915,5
fusel,847,1824,1021,3252,971,7915,5
mopsy,1225,3069,560,945,2116,7915,5
baugh,1555,4103,990,612,654,7914,5
quays,93,1824,1959,271,3767,7914,5
roist,948,3069,1668,945,1284,7914,5
scaly,2206,338,1959,1295,2116,7914,5
meson,1225,2863,1021,1282,1522,7913,5
relap,948,2863,1603,2214,285,7913,5
tajik,1264,4103,81,1963,502,7913,5
butin,1555,1824,1048,1963,1522,7912,5
curvy,1512,1824,2201,259,2116,7912,5
kbars,789,172,1959,1225,3767,7912,5
qophs,93,3069,560,423,3767,7912,5
regin,948,2863,616,1963,1522,7912,5
autry,1698,1824,1048,1225,2116,7911,5
bilac,1555,2239,1603,2214,300,7911,5
tuyer,1264,1824,381,3252,1190,7911,5
units,420,671,1668,1385,3767,7911,5
yerva,225,2863,2201,259,2362,7910,5
neoga,647,2863,1426,612,2362,7910,5
neoma,647,2863,1426,612,2362,7910,5
bidry,1555,2239,774,1225,2116,7909,5
stary,2206,403,1959,1225,2116,7909,5
wakon,596,4103,406,1282,1522,7909,5
youse,225,3069,990,945,2679,7908,5
lento,1046,2863,1757,1385,857,7908,5
blued,1555,1193,990,3252,917,7907,5
deino,1128,2863,1668,1391,857,7907,5
leath,1046,2863,1959,1385,654,7907,5
atoms,1698,403,1426,612,3767,7906,5
liman,1046,2239,885,2214,1522,7906,5
otley,532,403,1603,3252,2116,7906,5
chany,1512,927,1959,1391,2116,7905,5
chefs,1512,927,1421,278,3767,7905,5
duvet,1128,1824,417,3252,1284,7905,5
worth,596,3069,2201,1385,654,7905,5
hiram,844,2239,2201,2214,406,7904,5
mahto,1225,4103,334,1385,857,7904,5
bitsy,1555,2239,1048,945,2116,7903,5
flare,847,1193,1959,1225,2679,7903,5
pride,1184,1543,1668,829,2679,7903,5
tioga,1264,2239,1426,612,2362,7903,5
debit,1128,2863,664,1963,1284,7902,5
busty,1555,1824,1021,1385,2116,7901,5
coing,1512,3069,1668,1391,261,7901,5
diple,1128,2239,560,1295,2679,7901,5
walsh,596,4103,1603,945,654,7901,5
goyin,965,3069,381,1963,1522,7900,5
tempa,1264,2863,885,526,2362,7900,5
bugre,1555,1824,616,1225,2679,7899,5
gonif,965,3069,1757,1963,145,7899,5
ecrus,693,338,2201,899,3767,7898,5
feast,847,2863,1959,945,1284,7898,5
jatni,446,4103,1048,1391,910,7898,5
kelpy,789,2863,1603,526,2116,7897,5
orten,532,1543,1048,3252,1522,7897,5
slaby,2206,1193,1959,423,2116,7897,5
lucia,1046,1824,701,1963,2362,7896,5
misly,1225,2239,1021,1295,2116,7896,5
rewan,948,2863,349,2214,1522,7896,5
biont,1555,2239,1426,1391,1284,7895,5
delni,1128,2863,1603,1391,910,7895,5
enray,693,671,2201,2214,2116,7895,5
preta,1184,1543,1421,1385,2362,7895,5
coarb,1512,3069,1959,1225,129,7894,5
dunal,1128,1824,1757,2214,971,7894,5
honig,844,3069,1757,1963,261,7894,5
alper,1698,1193,560,3252,1190,7893,5
devin,1128,2863,417,1963,1522,7893,5
facto,847,4103,701,1385,857,7893,5
grows,965,1543,1426,192,3767,7893,5
tinya,1264,2239,1757,271,2362,7893,5
toshy,1264,3069,1021,423,2116,7893,5
viage,404,2239,1959,612,2679,7893,5
mobil,1225,3069,664,1963,971,7892,5
sepic,2206,2863,560,1963,300,7892,5
uglis,420,139,1603,1963,3767,7892,5
berck,1555,2863,2201,770,502,7891,5
disty,1128,2239,1021,1385,2116,7889,5
opals,532,336,1959,1295,3767,7889,5
rindy,948,2239,1757,829,2116,7889,5
zaque,176,4103,32,899,2679,7889,5
deist,1128,2863,1668,945,1284,7888,5
dowry,1128,3069,349,1225,2116,7887,5
fuder,847,1824,774,3252,1190,7887,5
haick,844,4103,1668,770,502,7887,5
kiver,789,2239,417,3252,1190,7887,5
lofty,1046,3069,271,1385,2116,7887,5
nudie,647,1824,774,1963,2679,7887,5
tewly,1264,2863,349,1295,2116,7887,5
bergh,1555,2863,2201,612,654,7885,5
clubs,1512,1193,990,423,3767,7885,5
gucks,965,1824,701,628,3767,7885,5
ketal,789,2863,1048,2214,971,7885,5
trela,1264,1543,1421,1295,2362,7885,5
campo,1512,4103,885,526,857,7883,5
chain,1512,927,1959,1963,1522,7883,5
agler,1698,139,1603,3252,1190,7882,5
gisla,965,2239,1021,1295,2362,7882,5
arvel,1698,1543,417,3252,971,7881,5
clide,1512,1193,1668,829,2679,7881,5
durgy,1128,1824,2201,612,2116,7881,5
major,1225,4103,81,1282,1190,7881,5
mothy,1225,3069,1048,423,2116,7881,5
bunky,1555,1824,1757,628,2116,7880,5
craze,1512,1543,1959,186,2679,7879,5
covid,1512,3069,417,1963,917,7878,5
heald,844,2863,1959,1295,917,7878,5
mnurs,1225,671,990,1225,3767,7878,5
porch,1184,3069,2201,770,654,7878,5
quips,93,1824,1668,526,3767,7878,5
decal,1128,2863,701,2214,971,7877,5
flied,847,1193,1668,3252,917,7877,5
glops,965,1193,1426,526,3767,7877,5
hilda,844,2239,1603,829,2362,7877,5
houma,844,3069,990,612,2362,7877,5
pirol,1184,2239,2201,1282,971,7877,5
ursae,420,1543,1021,2214,2679,7877,5
helot,844,2863,1603,1282,1284,7876,5
kofta,789,3069,271,1385,2362,7876,5
swain,2206,226,1959,1963,1522,7876,5
stake,2206,403,1959,628,2679,7875,5
bajri,1555,4103,81,1225,910,7874,5
rapic,948,4103,560,1963,300,7874,5
score,2206,338,1426,1225,2679,7874,5
sprad,2206,336,2201,2214,917,7874,5
cleta,1512,1193,1421,1385,2362,7873,5
leuma,1046,2863,990,612,2362,7873,5
reify,948,2863,1668,278,2116,7873,5
spore,2206,336,1426,1225,2679,7872,5
tepal,1264,2863,560,2214,971,7872,5
lived,1046,2239,417,3252,917,7871,5
milon,1225,2239,1603,1282,1522,7871,5
murva,1225,1824,2201,259,2362,7871,5
nedra,647,2863,774,1225,2362,7871,5
write,596,1543,1668,1385,2679,7871,5
tacso,1264,4103,701,945,857,7870,5
clape,1512,1193,1959,526,2679,7869,5
cutin,1512,1824,1048,1963,1522,7869,5
yoked,225,3069,406,3252,917,7869,5
nokta,647,3069,406,1385,2362,7869,5
dinky,1128,2239,1757,628,2116,7868,5
guily,965,1824,1668,1295,2116,7868,5
rucks,948,1824,701,628,3767,7868,5
atdrs,1698,403,774,1225,3767,7867,5
domba,1128,3069,885,423,2362,7867,5
gotha,965,3069,1048,423,2362,7867,5
oicks,532,2239,701,628,3767,7867,5
plote,1184,1193,1426,1385,2679,7867,5
rowty,948,3069,349,1385,2116,7867,5
slart,2206,1193,1959,1225,1284,7867,5
alike,1698,1193,1668,628,2679,7866,5
bungy,1555,1824,1757,612,2116,7864,5
clued,1512,1193,990,3252,917,7864,5
becky,1555,2863,701,628,2116,7863,5
moult,1225,3069,990,1295,1284,7863,5
smore,2206,327,1426,1225,2679,7863,5
clean,1512,1193,1421,2214,1522,7862,5
mafic,1225,4103,271,1963,300,7862,5
beryl,1555,2863,2201,271,971,7861,5
fused,847,1824,1021,3252,917,7861,5
whams,596,927,1959,612,3767,7861,5
blair,1555,1193,1959,1963,1190,7860,5
china,1512,927,1668,1391,2362,7860,5
comfy,1512,3069,885,278,2116,7860,5
jirga,446,2239,2201,612,2362,7860,5
liked,1046,2239,406,3252,917,7860,5
stage,2206,403,1959,612,2679,7859,5
joint,446,3069,1668,1391,1284,7858,5
myrle,1225,458,2201,1295,2679,7858,5
hyads,844,458,1959,829,3767,7857,5
merop,1225,2863,2201,1282,285,7856,5
puker,1184,1824,406,3252,1190,7856,5
repin,948,2863,560,1963,1522,7856,5
chita,1512,927,1668,1385,2362,7854,5
minya,1225,2239,1757,271,2362,7854,5
mosby,1225,3069,1021,423,2116,7854,5
pomak,1184,3069,885,2214,502,7854,5
quran,93,1824,2201,2214,1522,7854,5
uriel,420,1543,1668,3252,971,7854,5
libre,1046,2239,664,1225,2679,7853,5
lohar,1046,3069,334,2214,1190,7853,5
dingy,1128,2239,1757,612,2116,7852,5
enols,693,671,1426,1295,3767,7852,5
milha,1225,2239,1603,423,2362,7852,5
drubs,1128,1543,990,423,3767,7851,5
zoeal,176,3069,1421,2214,971,7851,5
awned,1698,226,1757,3252,917,7850,5
drona,1128,1543,1426,1391,2362,7850,5
quale,93,1824,1959,1295,2679,7850,5
orkey,532,1543,406,3252,2116,7849,5
vince,404,2239,1757,770,2679,7849,5
fiery,847,2239,1421,1225,2116,7848,5
genic,965,2863,1757,1963,300,7848,5
doest,1128,3069,1421,945,1284,7847,5
lagro,1046,4103,616,1225,857,7847,5
royce,948,3069,381,770,2679,7847,5
sizal,2206,2239,217,2214,971,7847,5
subir,2206,1824,664,1963,1190,7847,5
vakil,404,4103,406,1963,971,7847,5
amoks,1698,327,1426,628,3767,7846,5
humps,844,1824,885,526,3767,7846,5
outer,532,1824,1048,3252,1190,7846,5
paski,1184,4103,1021,628,910,7846,5
bapco,1555,4103,560,770,857,7845,5
flogs,847,1193,1426,612,3767,7845,5
jurez,446,1824,2201,3252,122,7845,5
luisa,1046,1824,1668,945,2362,7845,5
loewy,1046,3069,1421,192,2116,7844,5
price,1184,1543,1668,770,2679,7844,5
psoae,1184,341,1426,2214,2679,7844,5
sakdc,2206,4103,406,829,300,7844,5
scary,2206,338,1959,1225,2116,7844,5
velma,404,2863,1603,612,2362,7844,5
chian,1512,927,1668,2214,1522,7843,5
spary,2206,336,1959,1225,2116,7842,5
houve,844,3069,990,259,2679,7841,5
kansu,789,4103,1757,945,247,7841,5
mewar,1225,2863,349,2214,1190,7841,5
ploys,1184,1193,1426,271,3767,7841,5
emits,693,327,1668,1385,3767,7840,5
tayib,1264,4103,381,1963,129,7840,5
favor,847,4103,417,1282,1190,7839,5
konig,789,3069,1757,1963,261,7839,5
sharn,2206,927,1959,1225,1522,7839,5
syrma,2206,458,2201,612,2362,7839,5
giant,965,2239,1959,1391,1284,7838,5
lazor,1046,4103,217,1282,1190,7838,5
nagor,647,4103,616,1282,1190,7838,5
nitre,647,2239,1048,1225,2679,7838,5
platy,1184,1193,1959,1385,2116,7837,5
wiper,596,2239,560,3252,1190,7837,5
heiau,844,2863,1668,2214,247,7836,5
shaky,2206,927,1959,628,2116,7836,5
woald,596,3069,1959,1295,917,7836,5
bruta,1555,1543,990,1385,2362,7835,5
drape,1128,1543,1959,526,2679,7835,5
tunka,1264,1824,1757,628,2362,7835,5
adiel,1698,245,1668,3252,971,7834,5
ralph,948,4103,1603,526,654,7834,5
sintu,2206,2239,1757,1385,247,7834,5
genip,965,2863,1757,1963,285,7833,5
retma,948,2863,1048,612,2362,7833,5
shrap,2206,927,2201,2214,285,7833,5
vised,404,2239,1021,3252,917,7833,5
zelda,176,2863,1603,829,2362,7833,5
anser,1698,671,1021,3252,1190,7832,5
bloem,1555,1193,1426,3252,406,7832,5
hirza,844,2239,2201,186,2362,7832,5
argle,1698,1543,616,1295,2679,7831,5
broke,1555,1543,1426,628,2679,7831,5
kedar,789,2863,774,2214,1190,7830,5
pilon,1184,2239,1603,1282,1522,7830,5
sirup,2206,2239,2201,899,285,7830,5
lavic,1046,4103,417,1963,300,7829,5
tondi,1264,3069,1757,829,910,7829,5
girja,965,2239,2201,61,2362,7828,5
krone,789,1543,1426,1391,2679,7828,5
culpa,1512,1824,1603,526,2362,7827,5
linha,1046,2239,1757,423,2362,7827,5
rivel,948,2239,417,3252,971,7827,5
trasy,1264,1543,1959,945,2116,7827,5
hotze,844,3069,1048,186,2679,7826,5
incas,473,671,701,2214,3767,7826,5
wizen,596,2239,217,3252,1522,7826,5
chows,1512,927,1426,192,3767,7824,5
react,948,2863,1959,770,1284,7824,5
bayok,1555,4103,381,1282,502,7823,5
fuget,847,1824,616,3252,1284,7823,5
vasti,404,4103,1021,1385,910,7823,5
nalgo,647,4103,1603,612,857,7822,5
poult,1184,3069,990,1295,1284,7822,5
tilak,1264,2239,1603,2214,502,7822,5
bigly,1555,2239,616,1295,2116,7821,5
jahve,446,4103,334,259,2679,7821,5
plain,1184,1193,1959,1963,1522,7821,5
riant,948,2239,1959,1391,1284,7821,5
roche,948,3069,701,423,2679,7820,5
runge,948,1824,1757,612,2679,7820,5
chews,1512,927,1421,192,3767,7819,5
lycea,1046,458,701,3252,2362,7819,5
tunga,1264,1824,1757,612,2362,7819,5
ceryl,1512,2863,2201,271,971,7818,5
lunda,1046,1824,1757,829,2362,7818,5
refan,948,2863,271,2214,1522,7818,5
vatic,404,4103,1048,1963,300,7818,5
virga,404,2239,2201,612,2362,7818,5
agnel,1698,139,1757,3252,971,7817,5
clair,1512,1193,1959,1963,1190,7817,5
daijo,1128,4103,1668,61,857,7817,5
etuis,693,403,990,1963,3767,7816,5
pixel,1184,2239,170,3252,971,7816,5
brome,1555,1543,1426,612,2679,7815,5
dicta,1128,2239,701,1385,2362,7815,5
lurky,1046,1824,2201,628,2116,7815,5
sloka,2206,1193,1426,628,2362,7815,5
foist,847,3069,1668,945,1284,7813,5
yowed,225,3069,349,3252,917,7812,5
kitan,789,2239,1048,2214,1522,7812,5
luket,1046,1824,406,3252,1284,7812,5
olnay,532,1193,1757,2214,2116,7812,5
pesky,1184,2863,1021,628,2116,7812,5
hagno,844,4103,616,1391,857,7811,5
levin,1046,2863,417,1963,1522,7811,5
milky,1225,2239,1603,628,2116,7811,5
proem,1184,1543,1426,3252,406,7811,5
troue,1264,1543,1426,899,2679,7811,5
vieta,404,2239,1421,1385,2362,7811,5
ackey,1698,338,406,3252,2116,7810,5
hoist,844,3069,1668,945,1284,7810,5
lepry,1046,2863,560,1225,2116,7810,5
rento,948,2863,1757,1385,857,7810,5
burst,1555,1824,2201,945,1284,7809,5
shrag,2206,927,2201,2214,261,7809,5
waltz,596,4103,1603,1385,122,7809,5
bysen,1555,458,1021,3252,1522,7808,5
chugs,1512,927,990,612,3767,7808,5
chums,1512,927,990,612,3767,7808,5
debir,1128,2863,664,1963,1190,7808,5
heard,844,2863,1959,1225,917,7808,5
mazic,1225,4103,217,1963,300,7808,5
spake,2206,336,1959,628,2679,7808,5
listy,1046,2239,1021,1385,2116,7807,5
confr,1512,3069,1757,278,1190,7806,5
furil,847,1824,2201,1963,971,7806,5
towai,1264,3069,349,2214,910,7806,5
kevan,789,2863,417,2214,1522,7805,5
lowry,1046,3069,349,1225,2116,7805,5
prela,1184,1543,1421,1295,2362,7805,5
alfie,1698,1193,271,1963,2679,7804,5
patmo,1184,4103,1048,612,857,7804,5
athey,1698,403,334,3252,2116,7803,5
buraq,1555,1824,2201,2214,9,7803,5
mixed,1225,2239,170,3252,917,7803,5
pikle,1184,2239,406,1295,2679,7803,5
aloin,1698,1193,1426,1963,1522,7802,5
benco,1555,2863,1757,770,857,7802,5
focal,847,3069,701,2214,971,7802,5
beach,1555,2863,1959,770,654,7801,5
braky,1555,1543,1959,628,2116,7801,5
fatso,847,4103,1048,945,857,7800,5
grise,965,1543,1668,945,2679,7800,5
lawzy,1046,4103,349,186,2116,7800,5
match,1225,4103,1048,770,654,7800,5
neiva,647,2863,1668,259,2362,7799,5
depit,1128,2863,560,1963,1284,7798,5
maewo,1225,4103,1421,192,857,7798,5
murza,1225,1824,2201,186,2362,7798,5
desha,1128,2863,1021,423,2362,7797,5
mahri,1225,4103,334,1225,910,7797,5
spira,2206,336,1668,1225,2362,7797,5
tapul,1264,4103,560,899,971,7797,5
termo,1264,2863,2201,612,857,7797,5
gular,965,1824,1603,2214,1190,7796,5
meith,1225,2863,1668,1385,654,7795,5
slimy,2206,1193,1668,612,2116,7795,5
yearn,225,2863,1959,1225,1522,7794,5
kelby,789,2863,1603,423,2116,7794,5
scame,2206,338,1959,612,2679,7794,5
tuarn,1264,1824,1959,1225,1522,7794,5
utley,420,403,1603,3252,2116,7794,5
deign,1128,2863,1668,612,1522,7793,5
gyred,965,458,2201,3252,917,7793,5
renig,948,2863,1757,1963,261,7792,5
timar,1264,2239,885,2214,1190,7792,5
fleay,847,1193,1421,2214,2116,7791,5
jiber,446,2239,664,3252,1190,7791,5
nobly,647,3069,664,1295,2116,7791,5
novem,647,3069,417,3252,406,7791,5
vesty,404,2863,1021,1385,2116,7789,5
crosa,1512,1543,1426,945,2362,7788,5
drice,1128,1543,1668,770,2679,7788,5
findy,847,2239,1757,829,2116,7788,5
kurma,789,1824,2201,612,2362,7788,5
dogma,1128,3069,616,612,2362,7787,5
galvo,965,4103,1603,259,857,7787,5
minot,1225,2239,1757,1282,1284,7787,5
prune,1184,1543,990,1391,2679,7787,5
rafik,948,4103,271,1963,502,7787,5
whids,596,927,1668,829,3767,7787,5
legua,1046,2863,616,899,2362,7786,5
linky,1046,2239,1757,628,2116,7786,5
alure,1698,1193,990,1225,2679,7785,5
andie,1698,671,774,1963,2679,7785,5
kisan,789,2239,1021,2214,1522,7785,5
place,1184,1193,1959,770,2679,7785,5
gusle,965,1824,1021,1295,2679,7784,5
timex,1264,2239,885,3252,144,7784,5
could,1512,3069,990,1295,917,7783,5
cresa,1512,1543,1421,945,2362,7783,5
folic,847,3069,1603,1963,300,7782,5
linje,1046,2239,1757,61,2679,7782,5
reply,948,2863,560,1295,2116,7782,5
trike,1264,1543,1668,628,2679,7782,5
trisa,1264,1543,1668,945,2362,7782,5
foirl,847,3069,1668,1225,971,7780,5
mocha,1225,3069,701,423,2362,7780,5
munga,1225,1824,1757,612,2362,7780,5
quare,93,1824,1959,1225,2679,7780,5
insea,473,671,1021,3252,2362,7779,5
jabot,446,4103,664,1282,1284,7779,5
rasht,948,4103,1021,423,1284,7779,5
lahti,1046,4103,334,1385,910,7778,5
asine,1698,341,1668,1391,2679,7777,5
hemal,844,2863,885,2214,971,7777,5
ihlen,473,927,1603,3252,1522,7777,5
pasmo,1184,4103,1021,612,857,7777,5
prose,1184,1543,1426,945,2679,7777,5
thuds,1264,927,990,829,3767,7777,5
deqna,1128,2863,32,1391,2362,7776,5
frows,847,1543,1426,192,3767,7775,5
whaps,596,927,1959,526,3767,7775,5
bensh,1555,2863,1757,945,654,7774,5
globs,965,1193,1426,423,3767,7774,5
huber,844,1824,664,3252,1190,7774,5
junta,446,1824,1757,1385,2362,7774,5
vaish,404,4103,1668,945,654,7774,5
vinew,404,2239,1757,3252,122,7774,5
gorki,965,3069,2201,628,910,7773,5
mitua,1225,2239,1048,899,2362,7773,5
rived,948,2239,417,3252,917,7773,5
crome,1512,1543,1426,612,2679,7772,5
flite,847,1193,1668,1385,2679,7772,5
legit,1046,2863,616,1963,1284,7772,5
relax,948,2863,1603,2214,144,7772,5
cigar,1512,2239,616,2214,1190,7771,5
evars,693,126,1959,1225,3767,7770,5
hekla,844,2863,406,1295,2362,7770,5
lingy,1046,2239,1757,612,2116,7770,5
snail,2206,671,1959,1963,971,7770,5
anole,1698,671,1426,1295,2679,7769,5
bevil,1555,2863,417,1963,971,7769,5
bunya,1555,1824,1757,271,2362,7769,5
chore,1512,927,1426,1225,2679,7769,5
gerdi,965,2863,2201,829,910,7768,5
kenaf,789,2863,1757,2214,145,7768,5
kirby,789,2239,2201,423,2116,7768,5
fucks,847,1824,701,628,3767,7767,5
shant,2206,927,1959,1391,1284,7767,5
tyler,1264,458,1603,3252,1190,7767,5
curst,1512,1824,2201,945,1284,7766,5
stean,2206,403,1421,2214,1522,7766,5
threw,1264,927,2201,3252,122,7766,5
clune,1512,1193,990,1391,2679,7765,5
pusan,1184,1824,1021,2214,1522,7765,5
hucks,844,1824,701,628,3767,7764,5
shope,2206,927,1426,526,2679,7764,5
amine,1698,327,1668,1391,2679,7763,5
dawut,1128,4103,349,899,1284,7763,5
jerol,446,2863,2201,1282,971,7763,5
plows,1184,1193,1426,192,3767,7762,5
swore,2206,226,1426,1225,2679,7762,5
alhet,1698,1193,334,3252,1284,7761,5
doigt,1128,3069,1668,612,1284,7761,5
rubia,948,1824,664,1963,2362,7761,5
defat,1128,2863,271,2214,1284,7760,5
filao,847,2239,1603,2214,857,7760,5
clute,1512,1193,990,1385,2679,7759,5
flops,847,1193,1426,526,3767,7759,5
frugs,847,1543,990,612,3767,7759,5
lewty,1046,2863,349,1385,2116,7759,5
patch,1184,4103,1048,770,654,7759,5
porum,1184,3069,2201,899,406,7759,5
recit,948,2863,701,1963,1284,7759,5
rynds,948,458,1757,829,3767,7759,5
bedot,1555,2863,774,1282,1284,7758,5
edits,693,245,1668,1385,3767,7758,5
grame,965,1543,1959,612,2679,7758,5
amite,1698,327,1668,1385,2679,7757,5
plews,1184,1193,1421,192,3767,7757,5
squet,2206,25,990,3252,1284,7757,5
bourd,1555,3069,990,1225,917,7756,5
getid,965,2863,1048,1963,917,7756,5
close,1512,1193,1426,945,2679,7755,5
podgy,1184,3069,774,612,2116,7755,5
punka,1184,1824,1757,628,2362,7755,5
jahwe,446,4103,334,192,2679,7754,5
pilmy,1184,2239,1603,612,2116,7754,5
vouge,404,3069,990,612,2679,7754,5
ileus,473,1193,1421,899,3767,7753,5
krina,789,1543,1668,1391,2362,7753,5
phile,1184,927,1668,1295,2679,7753,5
sadhu,2206,4103,774,423,247,7753,5
bosix,1555,3069,1021,1963,144,7752,5
micra,1225,2239,701,1225,2362,7752,5
mundy,1225,1824,1757,829,2116,7751,5
rouky,948,3069,990,628,2116,7751,5
actus,1698,338,1048,899,3767,7750,5
alver,1698,1193,417,3252,1190,7750,5
drily,1128,1543,1668,1295,2116,7750,5
snipe,2206,671,1668,526,2679,7750,5
fabri,847,4103,664,1225,910,7749,5
cymae,1512,458,885,2214,2679,7748,5
fohat,847,3069,334,2214,1284,7748,5
spait,2206,336,1959,1963,1284,7748,5
pinot,1184,2239,1757,1282,1284,7746,5
plugs,1184,1193,990,612,3767,7746,5
plums,1184,1193,990,612,3767,7746,5
bmare,1555,327,1959,1225,2679,7745,5
holst,844,3069,1603,945,1284,7745,5
kenaz,789,2863,1757,2214,122,7745,5
dewar,1128,2863,349,2214,1190,7744,5
getah,965,2863,1048,2214,654,7744,5
shoal,2206,927,1426,2214,971,7744,5
atile,1698,403,1668,1295,2679,7743,5
lewin,1046,2863,349,1963,1522,7743,5
mrike,1225,1543,1668,628,2679,7743,5
towsy,1264,3069,349,945,2116,7743,5
behka,1555,2863,334,628,2362,7742,5
letha,1046,2863,1048,423,2362,7742,5
trode,1264,1543,1426,829,2679,7741,5
taupo,1264,4103,990,526,857,7740,5
chary,1512,927,1959,1225,2116,7739,5
punga,1184,1824,1757,612,2362,7739,5
sheal,2206,927,1421,2214,971,7739,5
shive,2206,927,1668,259,2679,7739,5
ambos,1698,327,664,1282,3767,7738,5
being,1555,2863,1668,1391,261,7738,5
mtier,1225,403,1668,3252,1190,7738,5
furze,847,1824,2201,186,2679,7737,5
gunda,965,1824,1757,829,2362,7737,5
cuban,1512,1824,664,2214,1522,7736,5
lozar,1046,3069,217,2214,1190,7736,5
derog,1128,2863,2201,1282,261,7735,5
rougy,948,3069,990,612,2116,7735,5
urled,420,1543,1603,3252,917,7735,5
shapy,2206,927,1959,526,2116,7734,5
visne,404,2239,1021,1391,2679,7734,5
nursy,647,1824,2201,945,2116,7733,5
afips,1698,73,1668,526,3767,7732,5
brant,1555,1543,1959,1391,1284,7732,5
nomad,647,3069,885,2214,917,7732,5
pasch,1184,4103,1021,770,654,7732,5
bugan,1555,1824,616,2214,1522,7731,5
wodge,596,3069,774,612,2679,7730,5
agiel,1698,139,1668,3252,971,7728,5
mazut,1225,4103,217,899,1284,7728,5
bulky,1555,1824,1603,628,2116,7726,5
huger,844,1824,616,3252,1190,7726,5
viola,404,2239,1426,1295,2362,7726,5
fumed,847,1824,885,3252,917,7725,5
geist,965,2863,1668,945,1284,7725,5
nigel,647,2239,616,3252,971,7725,5
namur,647,4103,885,899,1190,7724,5
hemad,844,2863,885,2214,917,7723,5
adrue,1698,245,2201,899,2679,7722,5
hakim,844,4103,406,1963,406,7722,5
kemal,789,2863,885,2214,971,7722,5
gruel,965,1543,990,3252,971,7721,5
stair,2206,403,1959,1963,1190,7721,5
fiant,847,2239,1959,1391,1284,7720,5
kebar,789,2863,664,2214,1190,7720,5
khafs,789,927,1959,278,3767,7720,5
kline,789,1193,1668,1391,2679,7720,5
funge,847,1824,1757,612,2679,7719,5
jalop,446,4103,1603,1282,285,7719,5
scena,2206,338,1421,1391,2362,7718,5
hiant,844,2239,1959,1391,1284,7717,5
pemba,1184,2863,885,423,2362,7717,5
spiny,2206,336,1668,1391,2116,7717,5
supai,2206,1824,560,2214,910,7714,5
arion,1698,1543,1668,1282,1522,7713,5
merch,1225,2863,2201,770,654,7713,5
knaps,789,671,1959,526,3767,7712,5
resid,948,2863,1021,1963,917,7712,5
synge,2206,458,1757,612,2679,7712,5
picra,1184,2239,701,1225,2362,7711,5
pohai,1184,3069,334,2214,910,7711,5
trady,1264,1543,1959,829,2116,7711,5
breda,1555,1543,1421,829,2362,7710,5
bulgy,1555,1824,1603,612,2116,7710,5
cidal,1512,2239,774,2214,971,7710,5
mathi,1225,4103,1048,423,910,7709,5
adlei,1698,245,1603,3252,910,7708,5
laski,1046,4103,1021,628,910,7708,5
reist,948,2863,1668,945,1284,7708,5
scape,2206,338,1959,526,2679,7708,5
abied,1698,172,1668,3252,917,7707,5
audly,1698,1824,774,1295,2116,7707,5
cumin,1512,1824,885,1963,1522,7706,5
votal,404,3069,1048,2214,971,7706,5
hinze,844,2239,1757,186,2679,7705,5
lenth,1046,2863,1757,1385,654,7705,5
sloid,2206,1193,1426,1963,917,7705,5
ayden,1698,458,774,3252,1522,7704,5
kenti,789,2863,1757,1385,910,7704,5
mirth,1225,2239,2201,1385,654,7704,5
soulx,2206,3069,990,1295,144,7704,5
trave,1264,1543,1959,259,2679,7704,5
datch,1128,4103,1048,770,654,7703,5
libna,1046,2239,664,1391,2362,7702,5
ousia,532,1824,1021,1963,2362,7702,5
klops,789,1193,1426,526,3767,7701,5
spued,2206,336,990,3252,917,7701,5
urine,420,1543,1668,1391,2679,7701,5
artly,1698,1543,1048,1295,2116,7700,5
sumba,2206,1824,885,423,2362,7700,5
trail,1264,1543,1959,1963,971,7700,5
inads,473,671,1959,829,3767,7699,5
spean,2206,336,1421,2214,1522,7699,5
alfet,1698,1193,271,3252,1284,7698,5
bulak,1555,1824,1603,2214,502,7698,5
fixer,847,2239,170,3252,1190,7698,5
naomi,647,4103,1426,612,910,7698,5
pocky,1184,3069,701,628,2116,7698,5
verst,404,2863,2201,945,1284,7697,5
oicel,532,2239,701,3252,971,7695,5
pacht,1184,4103,701,423,1284,7695,5
urite,420,1543,1668,1385,2679,7695,5
phase,1184,927,1959,945,2679,7694,5
wiver,596,2239,417,3252,1190,7694,5
jufts,446,1824,271,1385,3767,7693,5
merow,1225,2863,2201,1282,122,7693,5
minor,1225,2239,1757,1282,1190,7693,5
shraf,2206,927,2201,2214,145,7693,5
bekah,1555,2863,406,2214,654,7692,5
yapon,225,4103,560,1282,1522,7692,5
muncy,1225,1824,1757,770,2116,7692,5
nighs,647,2239,616,423,3767,7692,5
stola,2206,403,1426,1295,2362,7692,5
cesti,1512,2863,1021,1385,910,7691,5
joual,446,3069,990,2214,971,7690,5
shoad,2206,927,1426,2214,917,7690,5
strid,2206,403,2201,1963,917,7690,5
grubs,965,1543,990,423,3767,7688,5
henig,844,2863,1757,1963,261,7688,5
nuder,647,1824,774,3252,1190,7687,5
stela,2206,403,1421,1295,2362,7687,5
thone,1264,927,1426,1391,2679,7687,5
bonum,1555,3069,1757,899,406,7686,5
judie,446,1824,774,1963,2679,7686,5
laevo,1046,4103,1421,259,857,7686,5
prime,1184,1543,1668,612,2679,7686,5
tenso,1264,2863,1757,945,857,7686,5
sekiu,2206,2863,406,1963,247,7685,5
gride,965,1543,1668,829,2679,7684,5
madoc,1225,4103,774,1282,300,7684,5
depca,1128,2863,560,770,2362,7683,5
montu,1225,3069,1757,1385,247,7683,5
socht,2206,3069,701,423,1284,7683,5
turfy,1264,1824,2201,278,2116,7683,5
almeh,1698,1193,885,3252,654,7682,5
frise,847,1543,1668,945,2679,7682,5
medio,1225,2863,774,1963,857,7682,5
soulz,2206,3069,990,1295,122,7682,5
swage,2206,226,1959,612,2679,7682,5
adine,1698,245,1668,1391,2679,7681,5
lefty,1046,2863,271,1385,2116,7681,5
rovit,948,3069,417,1963,1284,7681,5
datuk,1128,4103,1048,899,502,7680,5
demon,1128,2863,885,1282,1522,7680,5
emirs,693,327,1668,1225,3767,7680,5
nouma,647,3069,990,612,2362,7680,5
tripe,1264,1543,1668,526,2679,7680,5
ahmed,1698,927,885,3252,917,7679,5
disme,1128,2239,1021,612,2679,7679,5
haydn,844,4103,381,829,1522,7679,5
kovar,789,3069,417,2214,1190,7679,5
omits,532,327,1668,1385,3767,7679,5
ovals,532,126,1959,1295,3767,7679,5
ptous,1184,403,1426,899,3767,7679,5
leapt,1046,2863,1959,526,1284,7678,5
aclys,1698,338,1603,271,3767,7677,5
yerxa,225,2863,2201,26,2362,7677,5
relic,948,2863,1603,1963,300,7677,5
shrab,2206,927,2201,2214,129,7677,5
greta,965,1543,1421,1385,2362,7676,5
morph,1225,3069,2201,526,654,7675,5
nodal,647,3069,774,2214,971,7675,5
obley,532,172,1603,3252,2116,7675,5
lodha,1046,3069,774,423,2362,7674,5
velon,404,2863,1603,1282,1522,7674,5
huron,844,1824,2201,1282,1522,7673,5
bloat,1555,1193,1426,2214,1284,7672,5
grape,965,1543,1959,526,2679,7672,5
perch,1184,2863,2201,770,654,7672,5
ringy,948,2239,1757,612,2116,7672,5
vocat,404,3069,701,2214,1284,7672,5
aubin,1698,1824,664,1963,1522,7671,5
hepar,844,2863,560,2214,1190,7671,5
shalt,2206,927,1959,1295,1284,7671,5
groan,965,1543,1426,2214,1522,7670,5
yince,225,2239,1757,770,2679,7670,5
cruse,1512,1543,990,945,2679,7669,5
hived,844,2239,417,3252,917,7669,5
bleat,1555,1193,1421,2214,1284,7667,5
creda,1512,1543,1421,829,2362,7667,5
culmy,1512,1824,1603,612,2116,7667,5
genro,965,2863,1757,1225,857,7667,5
vogue,404,3069,616,899,2679,7667,5
celom,1512,2863,1603,1282,406,7666,5
medon,1225,2863,774,1282,1522,7666,5
clime,1512,1193,1668,612,2679,7664,5
yomin,225,3069,885,1963,1522,7664,5
kosha,789,3069,1021,423,2362,7664,5
turvy,1264,1824,2201,259,2116,7664,5
dimly,1128,2239,885,1295,2116,7663,5
wolfy,596,3069,1603,278,2116,7662,5
anise,1698,671,1668,945,2679,7661,5
fiked,847,2239,406,3252,917,7661,5
sydel,2206,458,774,3252,971,7661,5
trial,1264,1543,1668,2214,971,7660,5
rubel,948,1824,664,3252,971,7659,5
spice,2206,336,1668,770,2679,7659,5
fecit,847,2863,701,1963,1284,7658,5
hiked,844,2239,406,3252,917,7658,5
adeps,1698,245,1421,526,3767,7657,5
cubla,1512,1824,664,1295,2362,7657,5
doeth,1128,3069,1421,1385,654,7657,5
erina,693,1543,1668,1391,2362,7657,5
rupia,948,1824,560,1963,2362,7657,5
broca,1555,1543,1426,770,2362,7656,5
crapy,1512,1543,1959,526,2116,7656,5
jural,446,1824,2201,2214,971,7656,5
broad,1555,1543,1426,2214,917,7655,5
lasko,1046,4103,1021,628,857,7655,5
luged,1046,1824,616,3252,917,7655,5
fibre,847,2239,664,1225,2679,7654,5
jecoa,446,2863,701,1282,2362,7654,5
spair,2206,336,1959,1963,1190,7654,5
beltu,1555,2863,1603,1385,247,7653,5
kinah,789,2239,1757,2214,654,7653,5
blady,1555,1193,1959,829,2116,7652,5
tracy,1264,1543,1959,770,2116,7652,5
angus,1698,671,616,899,3767,7651,5
bread,1555,1543,1421,2214,917,7650,5
vadim,404,4103,774,1963,406,7650,5
bsrec,1555,341,2201,3252,300,7649,5
numps,647,1824,885,526,3767,7649,5
quite,93,1824,1668,1385,2679,7649,5
roupy,948,3069,990,526,2116,7649,5
arlon,1698,1543,1603,1282,1522,7648,5
meshy,1225,2863,1021,423,2116,7648,5
roguy,948,3069,616,899,2116,7648,5
tyned,1264,458,1757,3252,917,7648,5
viron,404,2239,2201,1282,1522,7648,5
lehar,1046,2863,334,2214,1190,7647,5
taegu,1264,4103,1421,612,247,7647,5
biton,1555,2239,1048,1282,1522,7646,5
lesak,1046,2863,1021,2214,502,7646,5
ogren,532,139,2201,3252,1522,7646,5
chait,1512,927,1959,1963,1284,7645,5
rewin,948,2863,349,1963,1522,7645,5
sclat,2206,338,1603,2214,1284,7645,5
viper,404,2239,560,3252,1190,7645,5
gadso,965,4103,774,945,857,7644,5
retha,948,2863,1048,423,2362,7644,5
pewit,1184,2863,349,1963,1284,7643,5
splat,2206,336,1603,2214,1284,7643,5
ulane,420,1193,1959,1391,2679,7642,5
cunza,1512,1824,1757,186,2362,7641,5
erian,693,1543,1668,2214,1522,7640,5
frame,847,1543,1959,612,2679,7640,5
hyams,844,458,1959,612,3767,7640,5
bevon,1555,2863,417,1282,1522,7639,5
fetid,847,2863,1048,1963,917,7638,5
haulm,844,4103,990,1295,406,7638,5
relig,948,2863,1603,1963,261,7638,5
audry,1698,1824,774,1225,2116,7637,5
ligan,1046,2239,616,2214,1522,7637,5
myrna,1225,458,2201,1391,2362,7637,5
pegma,1184,2863,616,612,2362,7637,5
hazor,844,4103,217,1282,1190,7636,5
kisra,789,2239,1021,1225,2362,7636,5
leoni,1046,2863,1426,1391,910,7636,5
poach,1184,3069,1959,770,654,7636,5
sluit,2206,1193,990,1963,1284,7636,5
kaput,789,4103,560,899,1284,7635,5
thain,1264,927,1959,1963,1522,7635,5
yamun,225,4103,885,899,1522,7634,5
mazur,1225,4103,217,899,1190,7634,5
calyx,1512,4103,1603,271,144,7633,5
cumly,1512,1824,885,1295,2116,7632,5
foeti,847,3069,1421,1385,910,7632,5
joyan,446,3069,381,2214,1522,7632,5
tecon,1264,2863,701,1282,1522,7632,5
brize,1555,1543,1668,186,2679,7631,5
hildy,844,2239,1603,829,2116,7631,5
myrta,1225,458,2201,1385,2362,7631,5
pixys,1184,2239,170,271,3767,7631,5
prady,1184,1543,1959,829,2116,7631,5
sumak,2206,1824,885,2214,502,7631,5
tound,1264,3069,990,1391,917,7631,5
ahron,1698,927,2201,1282,1522,7630,5
leoti,1046,2863,1426,1385,910,7630,5
piano,1184,2239,1959,1391,857,7630,5
weald,596,2863,1959,1295,917,7630,5
wilda,596,2239,1603,829,2362,7629,5
wrote,596,1543,1426,1385,2679,7629,5
cigua,1512,2239,616,899,2362,7628,5
eolic,693,3069,1603,1963,300,7628,5
angie,1698,671,616,1963,2679,7627,5
hsien,844,341,1668,3252,1522,7627,5
iowan,473,3069,349,2214,1522,7627,5
mrida,1225,1543,1668,829,2362,7627,5
plage,1184,1193,1959,612,2679,7627,5
roque,948,3069,32,899,2679,7627,5
built,1555,1824,1668,1295,1284,7626,5
decil,1128,2863,701,1963,971,7626,5
haldu,844,4103,1603,829,247,7626,5
mulga,1225,1824,1603,612,2362,7626,5
tisbe,1264,2239,1021,423,2679,7626,5
cumar,1512,1824,885,2214,1190,7625,5
glade,965,1193,1959,829,2679,7625,5
grice,965,1543,1668,770,2679,7625,5
nedry,647,2863,774,1225,2116,7625,5
aloke,1698,1193,1426,628,2679,7624,5
cleat,1512,1193,1421,2214,1284,7624,5
kylen,789,458,1603,3252,1522,7624,5
hayti,844,4103,381,1385,910,7623,5
tuple,1264,1824,560,1295,2679,7622,5
unray,420,671,2201,2214,2116,7622,5
latch,1046,4103,1048,770,654,7621,5
lorum,1046,3069,2201,899,406,7621,5
sliwa,2206,1193,1668,192,2362,7621,5
hutre,844,1824,1048,1225,2679,7620,5
kanji,789,4103,1757,61,910,7620,5
bison,1555,2239,1021,1282,1522,7619,5
chubs,1512,927,990,423,3767,7619,5
funda,847,1824,1757,829,2362,7619,5
vegan,404,2863,616,2214,1522,7619,5
witan,596,2239,1048,2214,1522,7619,5
becap,1555,2863,701,2214,285,7618,5
tovah,1264,3069,417,2214,654,7618,5
gleys,965,1193,1421,271,3767,7617,5
lunka,1046,1824,1757,628,2362,7617,5
leith,1046,2863,1668,1385,654,7616,5
zelma,176,2863,1603,612,2362,7616,5
chide,1512,927,1668,829,2679,7615,5
dyane,1128,458,1959,1391,2679,7615,5
lfacs,1046,73,1959,770,3767,7615,5
zibet,176,2239,664,3252,1284,7615,5
claye,1512,1193,1959,271,2679,7614,5
ansel,1698,671,1021,3252,971,7613,5
chena,1512,927,1421,1391,2362,7613,5
reign,948,2863,1668,612,1522,7613,5
rhine,948,927,1668,1391,2679,7613,5
guyer,965,1824,381,3252,1190,7612,5
regal,948,2863,616,2214,971,7612,5
smily,2206,327,1668,1295,2116,7612,5
armin,1698,1543,885,1963,1522,7611,5
clein,1512,1193,1421,1963,1522,7611,5
piast,1184,2239,1959,945,1284,7611,5
couth,1512,3069,990,1385,654,7610,5
snoke,2206,671,1426,628,2679,7610,5
bekha,1555,2863,406,423,2362,7609,5
fisty,847,2239,1021,1385,2116,7608,5
blida,1555,1193,1668,829,2362,7607,5
cread,1512,1543,1421,2214,917,7607,5
feist,847,2863,1668,945,1284,7607,5
phone,1184,927,1426,1391,2679,7607,5
trica,1264,1543,1668,770,2362,7607,5
dwaps,1128,226,1959,526,3767,7606,5
livre,1046,2239,417,1225,2679,7606,5
mikan,1225,2239,406,2214,1522,7606,5
triad,1264,1543,1668,2214,917,7606,5
elops,693,1193,1426,526,3767,7605,5
vomit,404,3069,885,1963,1284,7605,5
drony,1128,1543,1426,1391,2116,7604,5
heist,844,2863,1668,945,1284,7604,5
ruely,948,1824,1421,1295,2116,7604,5
chape,1512,927,1959,526,2679,7603,5
suelo,2206,1824,1421,1295,857,7603,5
admen,1698,245,885,3252,1522,7602,5
clave,1512,1193,1959,259,2679,7602,5
jerib,446,2863,2201,1963,129,7602,5
johna,446,3069,334,1391,2362,7602,5
pulka,1184,1824,1603,628,2362,7601,5
uinal,420,2239,1757,2214,971,7601,5
welby,596,2863,1603,423,2116,7601,5
begot,1555,2863,616,1282,1284,7600,5
dital,1128,2239,1048,2214,971,7600,5
yahve,225,4103,334,259,2679,7600,5
ousel,532,1824,1021,3252,971,7600,5
twier,1264,226,1668,3252,1190,7600,5
bench,1555,2863,1757,770,654,7599,5
henri,844,2863,1757,1225,910,7599,5
kogai,789,3069,616,2214,910,7598,5
lemon,1046,2863,885,1282,1522,7598,5
rieka,948,2239,1421,628,2362,7598,5
scute,2206,338,990,1385,2679,7598,5
vafio,404,4103,271,1963,857,7598,5
amire,1698,327,1668,1225,2679,7597,5
atone,1698,403,1426,1391,2679,7597,5
zogan,176,3069,616,2214,1522,7597,5
exits,693,83,1668,1385,3767,7596,5
fecal,847,2863,701,2214,971,7596,5
loami,1046,3069,1959,612,910,7596,5
spute,2206,336,990,1385,2679,7596,5
swape,2206,226,1959,526,2679,7596,5
undis,420,671,774,1963,3767,7595,5
beitz,1555,2863,1668,1385,122,7593,5
deval,1128,2863,417,2214,971,7593,5
klebs,789,1193,1421,423,3767,7593,5
mecon,1225,2863,701,1282,1522,7593,5
gilba,965,2239,1603,423,2362,7592,5
mound,1225,3069,990,1391,917,7592,5
pilot,1184,2239,1603,1282,1284,7592,5
thole,1264,927,1426,1295,2679,7591,5
gluer,965,1193,990,3252,1190,7590,5
padou,1184,4103,774,1282,247,7590,5
runsy,948,1824,1757,945,2116,7590,5
pasho,1184,4103,1021,423,857,7588,5
dutra,1128,1824,1048,1225,2362,7587,5
finky,847,2239,1757,628,2116,7587,5
heild,844,2863,1668,1295,917,7587,5
vixen,404,2239,170,3252,1522,7587,5
anted,1698,671,1048,3252,917,7586,5
bstie,1555,341,1048,1963,2679,7586,5
duant,1128,1824,1959,1391,1284,7586,5
oxley,532,83,1603,3252,2116,7586,5
ander,1698,671,774,3252,1190,7585,5
brosy,1555,1543,1426,945,2116,7585,5
dashi,1128,4103,1021,423,910,7585,5
johan,446,3069,334,2214,1522,7585,5
vinal,404,2239,1757,2214,971,7585,5
datum,1128,4103,1048,899,406,7584,5
maugh,1225,4103,990,612,654,7584,5
mendi,1225,2863,1757,829,910,7584,5
plait,1184,1193,1959,1963,1284,7583,5
puked,1184,1824,406,3252,917,7583,5
royal,948,3069,381,2214,971,7583,5
sihon,2206,2239,334,1282,1522,7583,5
shrip,2206,927,2201,1963,285,7582,5
toyah,1264,3069,381,2214,654,7582,5
fount,847,3069,990,1391,1284,7581,5
fulke,847,1824,1603,628,2679,7581,5
lipan,1046,2239,560,2214,1522,7581,5
snaky,2206,671,1959,628,2116,7580,5
comdt,1512,3069,885,829,1284,7579,5
pyran,1184,458,2201,2214,1522,7579,5
purim,1184,1824,2201,1963,406,7578,5
phany,1184,927,1959,1391,2116,7577,5
tribe,1264,1543,1668,423,2679,7577,5
felic,847,2863,1603,1963,300,7576,5
slirt,2206,1193,1668,1225,1284,7576,5
tabog,1264,4103,664,1282,261,7574,5
blear,1555,1193,1421,2214,1190,7573,5
bruin,1555,1543,990,1963,1522,7573,5
comix,1512,3069,885,1963,144,7573,5
grief,965,1543,1668,3252,145,7573,5
levit,1046,2863,417,1963,1284,7573,5
outed,532,1824,1048,3252,917,7573,5
blaze,1555,1193,1959,186,2679,7572,5
lundy,1046,1824,1757,829,2116,7572,5
stoep,2206,403,1426,3252,285,7572,5
virgy,404,2239,2201,612,2116,7572,5
mordu,1225,3069,2201,829,247,7571,5
musty,1225,1824,1021,1385,2116,7571,5
thews,1264,927,1421,192,3767,7571,5
brion,1555,1543,1668,1282,1522,7570,5
readl,948,2863,1959,829,971,7570,5
tendo,1264,2863,1757,829,857,7570,5
teryl,1264,2863,2201,271,971,7570,5
whigs,596,927,1668,612,3767,7570,5
whims,596,927,1668,612,3767,7570,5
bezil,1555,2863,217,1963,971,7569,5
dicty,1128,2239,701,1385,2116,7569,5
frona,847,1543,1426,1391,2362,7569,5
oyens,532,458,1421,1391,3767,7569,5
bayou,1555,4103,381,1282,247,7568,5
drave,1128,1543,1959,259,2679,7568,5
matsu,1225,4103,1048,945,247,7568,5
stime,2206,403,1668,612,2679,7568,5
tepid,1264,2863,560,1963,917,7567,5
tryms,1264,1543,381,612,3767,7567,5
depuy,1128,2863,560,899,2116,7566,5
dynel,1128,458,1757,3252,971,7566,5
glace,965,1193,1959,770,2679,7566,5
bhola,1555,927,1426,1295,2362,7565,5
huave,844,1824,1959,259,2679,7565,5
arnot,1698,1543,1757,1282,1284,7564,5
drail,1128,1543,1959,1963,971,7564,5
frena,847,1543,1421,1391,2362,7564,5
lapsi,1046,4103,560,945,910,7564,5
wiped,596,2239,560,3252,917,7564,5
lesya,1046,2863,1021,271,2362,7563,5
avine,1698,126,1668,1391,2679,7562,5
fuchs,847,1824,701,423,3767,7562,5
hulme,844,1824,1603,612,2679,7562,5
juise,446,1824,1668,945,2679,7562,5
ounce,532,1824,1757,770,2679,7562,5
subah,2206,1824,664,2214,654,7562,5
bedim,1555,2863,774,1963,406,7561,5
digue,1128,2239,616,899,2679,7561,5
merck,1225,2863,2201,770,502,7561,5
zesty,176,2863,1021,1385,2116,7561,5
locky,1046,3069,701,628,2116,7560,5
thugs,1264,927,990,612,3767,7560,5
grose,965,1543,1426,945,2679,7558,5
gusta,965,1824,1021,1385,2362,7557,5
yursa,225,1824,2201,945,2362,7557,5
abrin,1698,172,2201,1963,1522,7556,5
bemol,1555,2863,885,1282,971,7556,5
linac,1046,2239,1757,2214,300,7556,5
nahor,647,4103,334,1282,1190,7556,5
rutan,948,1824,1048,2214,1522,7556,5
mergh,1225,2863,2201,612,654,7555,5
frape,847,1543,1959,526,2679,7554,5
gnaws,965,671,1959,192,3767,7554,5
kevin,789,2863,417,1963,1522,7554,5
pioxe,1184,2239,1426,26,2679,7554,5
axled,1698,83,1603,3252,917,7553,5
crude,1512,1543,990,829,2679,7553,5
dufay,1128,1824,271,2214,2116,7553,5
zineb,176,2239,1757,3252,129,7553,5
deink,1128,2863,1668,1391,502,7552,5
pliny,1184,1193,1668,1391,2116,7552,5
chair,1512,927,1959,1963,1190,7551,5
ledah,1046,2863,774,2214,654,7551,5
plena,1184,1193,1421,1391,2362,7551,5
pound,1184,3069,990,1391,917,7551,5
sclar,2206,338,1603,2214,1190,7551,5
sokul,2206,3069,406,899,971,7551,5
spiry,2206,336,1668,1225,2116,7551,5
sutor,2206,1824,1048,1282,1190,7550,5
deash,1128,2863,1959,945,654,7549,5
evils,693,126,1668,1295,3767,7549,5
keist,789,2863,1668,945,1284,7549,5
aroid,1698,1543,1426,1963,917,7547,5
bimah,1555,2239,885,2214,654,7547,5
numbs,647,1824,885,423,3767,7546,5
urase,420,1543,1959,945,2679,7546,5
fitly,847,2239,1048,1295,2116,7545,5
jiver,446,2239,417,3252,1190,7544,5
rompy,948,3069,885,526,2116,7544,5
audit,1698,1824,774,1963,1284,7543,5
glows,965,1193,1426,192,3767,7543,5
yurev,225,1824,2201,3252,41,7543,5
paugh,1184,4103,990,612,654,7543,5
pyxis,1184,458,170,1963,3767,7542,5
stony,2206,403,1426,1391,2116,7542,5
faxun,847,4103,170,899,1522,7541,5
kapur,789,4103,560,899,1190,7541,5
gatch,965,4103,1048,770,654,7540,5
gorum,965,3069,2201,899,406,7540,5
troke,1264,1543,1426,628,2679,7540,5
milor,1225,2239,1603,1282,1190,7539,5
vapor,404,4103,560,1282,1190,7539,5
aruke,1698,1543,990,628,2679,7538,5
krait,789,1543,1959,1963,1284,7538,5
pinax,1184,2239,1757,2214,144,7538,5
bruce,1555,1543,990,770,2679,7537,5
twigs,1264,226,1668,612,3767,7537,5
windy,596,2239,1757,829,2116,7537,5
gruys,965,1543,990,271,3767,7536,5
kumys,789,1824,885,271,3767,7536,5
libra,1046,2239,664,1225,2362,7536,5
tould,1264,3069,990,1295,917,7535,5
tresa,1264,1543,1421,945,2362,7535,5
mochy,1225,3069,701,423,2116,7534,5
mungy,1225,1824,1757,612,2116,7534,5
yahwe,225,4103,334,192,2679,7533,5
acone,1698,338,1426,1391,2679,7532,5
bihar,1555,2239,334,2214,1190,7532,5
phina,1184,927,1668,1391,2362,7532,5
tambo,1264,4103,885,423,857,7532,5
vinca,404,2239,1757,770,2362,7532,5
meryl,1225,2863,2201,271,971,7531,5
sough,2206,3069,990,612,654,7531,5
clear,1512,1193,1421,2214,1190,7530,5
flote,847,1193,1426,1385,2679,7530,5
gondi,965,3069,1757,829,910,7530,5
yauld,225,4103,990,1295,917,7530,5
lathi,1046,4103,1048,423,910,7530,5
lepsy,1046,2863,560,945,2116,7530,5
aster,1698,341,1048,3252,1190,7529,5
midge,1225,2239,774,612,2679,7529,5
clyer,1512,1193,381,3252,1190,7528,5
madox,1225,4103,774,1282,144,7528,5
shema,2206,927,1421,612,2362,7528,5
aubry,1698,1824,664,1225,2116,7527,5
video,404,2239,774,3252,857,7526,5
dewal,1128,2863,349,2214,971,7525,5
apter,1698,336,1048,3252,1190,7524,5
hoang,844,3069,1959,1391,261,7524,5
obits,532,172,1668,1385,3767,7524,5
oueta,532,1824,1421,1385,2362,7524,5
agrin,1698,139,2201,1963,1522,7523,5
ratch,948,4103,1048,770,654,7523,5
telyn,1264,2863,1603,271,1522,7523,5
alope,1698,1193,1426,526,2679,7522,5
chola,1512,927,1426,1295,2362,7522,5
raouf,948,4103,1426,899,145,7521,5
thore,1264,927,1426,1225,2679,7521,5
divan,1128,2239,417,2214,1522,7520,5
dubre,1128,1824,664,1225,2679,7520,5
gatow,965,4103,1048,1282,122,7520,5
olsen,532,1193,1021,3252,1522,7520,5
axine,1698,83,1668,1391,2679,7519,5
bagsc,1555,4103,616,945,300,7519,5
jibed,446,2239,664,3252,917,7518,5
manzu,1225,4103,1757,186,247,7518,5
reith,948,2863,1668,1385,654,7518,5
chela,1512,927,1421,1295,2362,7517,5
doing,1128,3069,1668,1391,261,7517,5
nogal,647,3069,616,2214,971,7517,5
spike,2206,336,1668,628,2679,7517,5
alife,1698,1193,1668,278,2679,7516,5
emacs,693,327,1959,770,3767,7516,5
first,847,2239,2201,945,1284,7516,5
stein,2206,403,1421,1963,1522,7515,5
axite,1698,83,1668,1385,2679,7513,5
hirst,844,2239,2201,945,1284,7513,5
krieg,789,1543,1668,3252,261,7513,5
radom,948,4103,774,1282,406,7513,5
rondi,948,3069,1757,829,910,7513,5
shaun,2206,927,1959,899,1522,7513,5
viced,404,2239,701,3252,917,7513,5
wisla,596,2239,1021,1295,2362,7513,5
feign,847,2863,1668,612,1522,7512,5
irone,473,1543,1426,1391,2679,7512,5
durax,1128,1824,2201,2214,144,7511,5
krona,789,1543,1426,1391,2362,7511,5
teach,1264,2863,1959,770,654,7510,5
ginza,965,2239,1757,186,2362,7509,5
punky,1184,1824,1757,628,2116,7509,5
neath,647,2863,1959,1385,654,7508,5
hugel,844,1824,616,3252,971,7507,5
stave,2206,403,1959,259,2679,7506,5
culot,1512,1824,1603,1282,1284,7505,5
lutra,1046,1824,1048,1225,2362,7505,5
chief,1512,927,1668,3252,145,7504,5
cimah,1512,2239,885,2214,654,7504,5
lehua,1046,2863,334,899,2362,7504,5
repad,948,2863,560,2214,917,7502,5
stail,2206,403,1959,1963,971,7502,5
atole,1698,403,1426,1295,2679,7501,5
iodal,473,3069,774,2214,971,7501,5
ardin,1698,1543,774,1963,1522,7500,5
norml,647,3069,2201,612,971,7500,5
skean,2206,137,1421,2214,1522,7500,5
fleys,847,1193,1421,271,3767,7499,5
kilah,789,2239,1603,2214,654,7499,5
broma,1555,1543,1426,612,2362,7498,5
loach,1046,3069,1959,770,654,7498,5
nixer,647,2239,170,3252,1190,7498,5
alive,1698,1193,1668,259,2679,7497,5
foxly,847,3069,170,1295,2116,7497,5
shove,2206,927,1426,259,2679,7497,5
lethy,1046,2863,1048,423,2116,7496,5
mould,1225,3069,990,1295,917,7496,5
azine,1698,59,1668,1391,2679,7495,5
slent,2206,1193,1421,1391,1284,7495,5
kunai,789,1824,1757,2214,910,7494,5
chute,1512,927,990,1385,2679,7493,5
pungy,1184,1824,1757,612,2116,7493,5
refly,948,2863,271,1295,2116,7493,5
kylie,789,458,1603,1963,2679,7492,5
pecky,1184,2863,701,628,2116,7492,5
gundy,965,1824,1757,829,2116,7491,5
haiku,844,4103,1668,628,247,7490,5
rebuy,948,2863,664,899,2116,7490,5
timbe,1264,2239,885,423,2679,7490,5
chose,1512,927,1426,945,2679,7489,5
colum,1512,3069,1603,899,406,7489,5
quire,93,1824,1668,1225,2679,7489,5
glore,965,1193,1426,1225,2679,7488,5
heidt,844,2863,1668,829,1284,7488,5
pilau,1184,2239,1603,2214,247,7487,5
anice,1698,671,1668,770,2679,7486,5
duple,1128,1824,560,1295,2679,7486,5
comdr,1512,3069,885,829,1190,7485,5
elroy,693,1193,2201,1282,2116,7485,5
mokha,1225,3069,406,423,2362,7485,5
athos,1698,403,334,1282,3767,7484,5
dowve,1128,3069,349,259,2679,7484,5
flain,847,1193,1959,1963,1522,7484,5
neoza,647,2863,1426,186,2362,7484,5
whips,596,927,1668,526,3767,7484,5
aymer,1698,458,885,3252,1190,7483,5
grike,965,1543,1668,628,2679,7483,5
irade,473,1543,1959,829,2679,7483,5
izars,473,59,1959,1225,3767,7483,5
hoult,844,3069,990,1295,1284,7482,5
stipe,2206,403,1668,526,2679,7482,5
bloke,1555,1193,1426,628,2679,7481,5
punak,1184,1824,1757,2214,502,7481,5
sexto,2206,2863,170,1385,857,7481,5
dolci,1128,3069,1603,770,910,7480,5
kitar,789,2239,1048,2214,1190,7480,5
acyls,1698,338,381,1295,3767,7479,5
agile,1698,139,1668,1295,2679,7479,5
craik,1512,1543,1959,1963,502,7479,5
hefty,844,2863,271,1385,2116,7479,5
levir,1046,2863,417,1963,1190,7479,5
orian,532,1543,1668,2214,1522,7479,5
zinke,176,2239,1757,628,2679,7479,5
braun,1555,1543,1959,899,1522,7478,5
kazim,789,4103,217,1963,406,7478,5
snapy,2206,671,1959,526,2116,7478,5
asben,1698,341,664,3252,1522,7477,5
ditsy,1128,2239,1048,945,2116,7476,5
spode,2206,336,1426,829,2679,7476,5
ariot,1698,1543,1668,1282,1284,7475,5
lucre,1046,1824,701,1225,2679,7475,5
dusty,1128,1824,1021,1385,2116,7474,5
musar,1225,1824,1021,2214,1190,7474,5
neuma,647,2863,990,612,2362,7474,5
amrit,1698,327,2201,1963,1284,7473,5
fluer,847,1193,990,3252,1190,7472,5
hesky,844,2863,1021,628,2116,7472,5
yadim,225,4103,774,1963,406,7471,5
jebat,446,2863,664,2214,1284,7471,5
meach,1225,2863,1959,770,654,7471,5
realm,948,2863,1959,1295,406,7471,5
aguie,1698,139,990,1963,2679,7469,5
brody,1555,1543,1426,829,2116,7469,5
eoith,693,3069,1668,1385,654,7469,5
lipse,1046,2239,560,945,2679,7469,5
amyls,1698,327,381,1295,3767,7468,5
singh,2206,2239,1757,612,654,7468,5
grime,965,1543,1668,612,2679,7467,5
gusla,965,1824,1021,1295,2362,7467,5
leash,1046,2863,1959,945,654,7467,5
slopy,2206,1193,1426,526,2116,7467,5
avile,1698,126,1668,1295,2679,7466,5
boyau,1555,3069,381,2214,247,7466,5
fulda,847,1824,1603,829,2362,7465,5
linja,1046,2239,1757,61,2362,7465,5
picry,1184,2239,701,1225,2116,7465,5
rauch,948,4103,990,770,654,7465,5
pruta,1184,1543,990,1385,2362,7464,5
lidar,1046,2239,774,2214,1190,7463,5
minto,1225,2239,1757,1385,857,7463,5
poilu,1184,3069,1668,1295,247,7463,5
sceat,2206,338,1421,2214,1284,7463,5
hulda,844,1824,1603,829,2362,7462,5
rocky,948,3069,701,628,2116,7462,5
tidal,1264,2239,774,2214,971,7462,5
nopal,647,3069,560,2214,971,7461,5
unred,420,671,2201,3252,917,7461,5
koval,789,3069,417,2214,971,7460,5
nubia,647,1824,664,1963,2362,7460,5
proke,1184,1543,1426,628,2679,7460,5
skice,2206,137,1668,770,2679,7460,5
broil,1555,1543,1426,1963,971,7458,5
glary,965,1193,1959,1225,2116,7458,5
kirst,789,2239,2201,945,1284,7458,5
mikra,1225,2239,406,1225,2362,7457,5
winze,596,2239,1757,186,2679,7457,5
nogai,647,3069,616,2214,910,7456,5
whale,596,927,1959,1295,2679,7456,5
begun,1555,2863,616,899,1522,7455,5
dhole,1128,927,1426,1295,2679,7455,5
flita,847,1193,1668,1385,2362,7455,5
presa,1184,1543,1421,945,2362,7455,5
skair,2206,137,1959,1963,1190,7455,5
cohby,1512,3069,334,423,2116,7454,5
stacy,2206,403,1959,770,2116,7454,5
trula,1264,1543,990,1295,2362,7454,5
kohua,789,3069,334,899,2362,7453,5
chora,1512,927,1426,1225,2362,7452,5
diwan,1128,2239,349,2214,1522,7452,5
kugel,789,1824,616,3252,971,7452,5
motif,1225,3069,1048,1963,145,7450,5
pigly,1184,2239,616,1295,2116,7450,5
sethi,2206,2863,1048,423,910,7450,5
ebons,693,172,1426,1391,3767,7449,5
gilpy,965,2239,1603,526,2116,7449,5
triga,1264,1543,1668,612,2362,7449,5
dabuh,1128,4103,664,899,654,7448,5
jumps,446,1824,885,526,3767,7448,5
lrida,1046,1543,1668,829,2362,7448,5
staid,2206,403,1959,1963,917,7448,5
chera,1512,927,1421,1225,2362,7447,5
opens,532,336,1421,1391,3767,7447,5
nohex,647,3069,334,3252,144,7446,5
thira,1264,927,1668,1225,2362,7446,5
belch,1555,2863,1603,770,654,7445,5
vitek,404,2239,1048,3252,502,7445,5
budge,1555,1824,774,612,2679,7444,5
chron,1512,927,2201,1282,1522,7444,5
girth,965,2239,2201,1385,654,7444,5
prome,1184,1543,1426,612,2679,7444,5
jouve,446,3069,990,259,2679,7443,5
demot,1128,2863,885,1282,1284,7442,5
knurs,789,671,990,1225,3767,7442,5
orcus,532,1543,701,899,3767,7442,5
ankus,1698,671,406,899,3767,7441,5
dulcy,1128,1824,1603,770,2116,7441,5
phore,1184,927,1426,1225,2679,7441,5
axmen,1698,83,885,3252,1522,7440,5
bedip,1555,2863,774,1963,285,7440,5
cimon,1512,2239,885,1282,1522,7440,5
dhows,1128,927,1426,192,3767,7440,5
normi,647,3069,2201,612,910,7439,5
spave,2206,336,1959,259,2679,7439,5
cloke,1512,1193,1426,628,2679,7438,5
jueta,446,1824,1421,1385,2362,7438,5
omens,532,327,1421,1391,3767,7438,5
trope,1264,1543,1426,526,2679,7438,5
dungy,1128,1824,1757,612,2116,7437,5
denom,1128,2863,1757,1282,406,7436,5
phila,1184,927,1668,1295,2362,7436,5
argue,1698,1543,616,899,2679,7435,5
lithe,1046,2239,1048,423,2679,7435,5
spail,2206,336,1959,1963,971,7435,5
deryl,1128,2863,2201,271,971,7434,5
fermi,847,2863,2201,612,910,7433,5
groat,965,1543,1426,2214,1284,7432,5
rifle,948,2239,271,1295,2679,7432,5
wylen,596,458,1603,3252,1522,7431,5
hermi,844,2863,2201,612,910,7430,5
peach,1184,2863,1959,770,654,7430,5
stram,2206,403,2201,2214,406,7430,5
snead,2206,671,1421,2214,917,7429,5
sumac,2206,1824,885,2214,300,7429,5
fusan,847,1824,1021,2214,1522,7428,5
kioga,789,2239,1426,612,2362,7428,5
mowha,1225,3069,349,423,2362,7428,5
anger,1698,671,616,3252,1190,7427,5
bield,1555,2239,1421,1295,917,7427,5
great,965,1543,1421,2214,1284,7427,5
snyed,2206,671,381,3252,917,7427,5
etwas,693,403,349,2214,3767,7426,5
feldt,847,2863,1603,829,1284,7426,5
kabul,789,4103,664,899,971,7426,5
lotic,1046,3069,1048,1963,300,7426,5
orsay,532,1543,1021,2214,2116,7426,5
smail,2206,327,1959,1963,971,7426,5
amole,1698,327,1426,1295,2679,7425,5
below,1555,2863,1603,1282,122,7425,5
fixed,847,2239,170,3252,917,7425,5
flows,847,1193,1426,192,3767,7425,5
nevat,647,2863,417,2214,1284,7425,5
altin,1698,1193,1048,1963,1522,7424,5
piotr,1184,2239,1426,1385,1190,7424,5
raupo,948,4103,990,526,857,7424,5
axile,1698,83,1668,1295,2679,7423,5
twale,1264,226,1959,1295,2679,7423,5
forum,847,3069,2201,899,406,7422,5
pinto,1184,2239,1757,1385,857,7422,5
shiva,2206,927,1668,259,2362,7422,5
unwas,420,671,349,2214,3767,7421,5
wived,596,2239,417,3252,917,7421,5
beaux,1555,2863,1959,899,144,7420,5
felix,847,2863,1603,1963,144,7420,5
flews,847,1193,1421,192,3767,7420,5
niple,647,2239,560,1295,2679,7420,5
birch,1555,2239,2201,770,654,7419,5
groin,965,1543,1426,1963,1522,7419,5
matzo,1225,4103,1048,186,857,7419,5
dacko,1128,4103,701,628,857,7417,5
filmy,847,2239,1603,612,2116,7417,5
helix,844,2863,1603,1963,144,7417,5
ouabe,532,1824,1959,423,2679,7417,5
dupre,1128,1824,560,1225,2679,7416,5
hertz,844,2863,2201,1385,122,7415,5
fiske,847,2239,1021,628,2679,7414,5
grein,965,1543,1421,1963,1522,7414,5
koeri,789,3069,1421,1225,910,7414,5
niobe,647,2239,1426,423,2679,7414,5
orlan,532,1543,1603,2214,1522,7414,5
reval,948,2863,417,2214,971,7413,5
grady,965,1543,1959,829,2116,7412,5
joist,446,3069,1668,945,1284,7412,5
wilga,596,2239,1603,612,2362,7412,5
wilma,596,2239,1603,612,2362,7412,5
ledgy,1046,2863,774,612,2116,7411,5
vista,404,2239,1021,1385,2362,7411,5
bemix,1555,2863,885,1963,144,7410,5
creil,1512,1543,1421,1963,971,7410,5
julep,446,1824,1603,3252,285,7410,5
mudra,1225,1824,774,1225,2362,7410,5
ruble,948,1824,664,1295,2679,7410,5
subak,2206,1824,664,2214,502,7410,5
lishe,1046,2239,1021,423,2679,7408,5
kulda,789,1824,1603,829,2362,7407,5
neist,647,2863,1668,945,1284,7407,5
quote,93,1824,1426,1385,2679,7407,5
wynds,596,458,1757,829,3767,7407,5
cumal,1512,1824,885,2214,971,7406,5
nigre,647,2239,616,1225,2679,7406,5
grave,965,1543,1959,259,2679,7405,5
kemah,789,2863,885,2214,654,7405,5
laugh,1046,4103,990,612,654,7405,5
rashi,948,4103,1021,423,910,7405,5
broid,1555,1543,1426,1963,917,7404,5
hibla,844,2239,664,1295,2362,7404,5
mosur,1225,3069,1021,899,1190,7404,5
zuian,176,1824,1668,2214,1522,7404,5
duyne,1128,1824,381,1391,2679,7403,5
klina,789,1193,1668,1391,2362,7403,5
oyers,532,458,1421,1225,3767,7403,5
myops,1225,458,1426,526,3767,7402,5
tupek,1264,1824,560,3252,502,7402,5
durno,1128,1824,2201,1391,857,7401,5
grail,965,1543,1959,1963,971,7401,5
mahdi,1225,4103,334,829,910,7401,5
regma,948,2863,616,612,2362,7401,5
tachi,1264,4103,701,423,910,7401,5
roach,948,3069,1959,770,654,7400,5
shawy,2206,927,1959,192,2116,7400,5
bepun,1555,2863,560,899,1522,7399,5
metic,1225,2863,1048,1963,300,7399,5
chime,1512,927,1668,612,2679,7398,5
detax,1128,2863,1048,2214,144,7397,5
slath,2206,1193,1959,1385,654,7397,5
ardeb,1698,1543,774,3252,129,7396,5
hemon,844,2863,885,1282,1522,7396,5
kouza,789,3069,990,186,2362,7396,5
bruke,1555,1543,990,628,2679,7395,5
brusa,1555,1543,990,945,2362,7395,5
icons,473,338,1426,1391,3767,7395,5
yogin,225,3069,616,1963,1522,7395,5
spial,2206,336,1668,2214,971,7395,5
polki,1184,3069,1603,628,910,7394,5
ruman,948,1824,885,2214,1522,7393,5
shani,2206,927,1959,1391,910,7393,5
kowal,789,3069,349,2214,971,7392,5
lusty,1046,1824,1021,1385,2116,7392,5
split,2206,336,1603,1963,1284,7392,5
navig,647,4103,417,1963,261,7391,5
ducan,1128,1824,701,2214,1522,7389,5
metol,1225,2863,1048,1282,971,7389,5
redon,948,2863,774,1282,1522,7389,5
tical,1264,2239,701,2214,971,7389,5
aulic,1698,1824,1603,1963,300,7388,5
drome,1128,1543,1426,612,2679,7388,5
yulan,225,1824,1603,2214,1522,7388,5
staio,2206,403,1959,1963,857,7388,5
egads,693,139,1959,829,3767,7387,5
juice,446,1824,1668,770,2679,7387,5
spacy,2206,336,1959,770,2116,7387,5
krute,789,1543,990,1385,2679,7386,5
liard,1046,2239,1959,1225,917,7386,5
whare,596,927,1959,1225,2679,7386,5
pilaf,1184,2239,1603,2214,145,7385,5
buyse,1555,1824,381,945,2679,7384,5
urina,420,1543,1668,1391,2362,7384,5
dwane,1128,226,1959,1391,2679,7383,5
durst,1128,1824,2201,945,1284,7382,5
gripe,965,1543,1668,526,2679,7381,5
posix,1184,3069,1021,1963,144,7381,5
spaid,2206,336,1959,1963,917,7381,5
diact,1128,2239,1959,770,1284,7380,5
tigua,1264,2239,616,899,2362,7380,5
bhave,1555,927,1959,259,2679,7379,5
bohun,1555,3069,334,899,1522,7379,5
brume,1555,1543,990,612,2679,7379,5
faulx,847,4103,990,1295,144,7379,5
jehan,446,2863,334,2214,1522,7379,5
meuni,1225,2863,990,1391,910,7379,5
cloit,1512,1193,1426,1963,1284,7378,5
cueva,1512,1824,1421,259,2362,7378,5
urita,420,1543,1668,1385,2362,7378,5
hermo,844,2863,2201,612,857,7377,5
goldi,965,3069,1603,829,910,7376,5
jakun,446,4103,406,899,1522,7376,5
queys,93,1824,1421,271,3767,7376,5
story,2206,403,1426,1225,2116,7376,5
deach,1128,2863,1959,770,654,7374,5
armit,1698,1543,885,1963,1284,7373,5
aspen,1698,341,560,3252,1522,7373,5
fundy,847,1824,1757,829,2116,7373,5
cizar,1512,2239,217,2214,1190,7372,5
mesic,1225,2863,1021,1963,300,7372,5
reink,948,2863,1668,1391,502,7372,5
terzo,1264,2863,2201,186,857,7371,5
volti,404,3069,1603,1385,910,7371,5
fayth,847,4103,381,1385,654,7370,5
flore,847,1193,1426,1225,2679,7370,5
kusan,789,1824,1021,2214,1522,7370,5
liwan,1046,2239,349,2214,1522,7370,5
dubna,1128,1824,664,1391,2362,7369,5
prima,1184,1543,1668,612,2362,7369,5
plzen,1184,1193,217,3252,1522,7368,5
arnim,1698,1543,1757,1963,406,7367,5
fiume,847,2239,990,612,2679,7367,5
spear,2206,336,1421,2214,1190,7367,5
techy,1264,2863,701,423,2116,7367,5
urian,420,1543,1668,2214,1522,7367,5
aluin,1698,1193,990,1963,1522,7366,5
andel,1698,671,774,3252,971,7366,5
phira,1184,927,1668,1225,2362,7366,5
brand,1555,1543,1959,1391,917,7365,5
frike,847,1543,1668,628,2679,7365,5
mordv,1225,3069,2201,829,41,7365,5
scram,2206,338,2201,2214,406,7365,5
spyer,2206,336,381,3252,1190,7365,5
troca,1264,1543,1426,770,2362,7365,5
fauch,847,4103,990,770,654,7364,5
norsk,647,3069,2201,945,502,7364,5
troad,1264,1543,1426,2214,917,7364,5
xeric,36,2863,2201,1963,300,7363,5
machi,1225,4103,701,423,910,7362,5
pilaw,1184,2239,1603,2214,122,7362,5
vrita,404,1543,1668,1385,2362,7362,5
phage,1184,927,1959,612,2679,7361,5
abote,1698,172,1426,1385,2679,7360,5
exons,693,83,1426,1391,3767,7360,5
keith,789,2863,1668,1385,654,7359,5
tread,1264,1543,1421,2214,917,7359,5
vocal,404,3069,701,2214,971,7359,5
cheat,1512,927,1421,2214,1284,7358,5
hocky,844,3069,701,628,2116,7358,5
lomax,1046,3069,885,2214,144,7358,5
smear,2206,327,1421,2214,1190,7358,5
smaze,2206,327,1959,186,2679,7357,5
johny,446,3069,334,1391,2116,7356,5
smyer,2206,327,381,3252,1190,7356,5
alric,1698,1193,2201,1963,300,7355,5
boucl,1555,3069,990,770,971,7355,5
chafe,1512,927,1959,278,2679,7355,5
lochy,1046,3069,701,423,2116,7355,5
lungy,1046,1824,1757,612,2116,7355,5
rebid,948,2863,664,1963,917,7355,5
lecky,1046,2863,701,628,2116,7354,5
topau,1264,3069,560,2214,247,7354,5
cahow,1512,4103,334,1282,122,7353,5
gracy,965,1543,1959,770,2116,7353,5
piert,1184,2239,1421,1225,1284,7353,5
crowe,1512,1543,1426,192,2679,7352,5
kinot,789,2239,1757,1282,1284,7351,5
sweat,2206,226,1421,2214,1284,7351,5
artsy,1698,1543,1048,945,2116,7350,5
odets,532,245,1421,1385,3767,7350,5
sklar,2206,137,1603,2214,1190,7350,5
suing,2206,1824,1668,1391,261,7350,5
kibla,789,2239,664,1295,2362,7349,5
lepid,1046,2863,560,1963,917,7349,5
ribat,948,2239,664,2214,1284,7349,5
clima,1512,1193,1668,612,2362,7347,5
wasco,596,4103,1021,770,857,7347,5
croze,1512,1543,1426,186,2679,7346,5
datsw,1128,4103,1048,945,122,7346,5
gilby,965,2239,1603,423,2116,7346,5
lenci,1046,2863,1757,770,910,7346,5
domic,1128,3069,885,1963,300,7345,5
hymns,844,458,885,1391,3767,7345,5
joyce,446,3069,381,770,2679,7345,5
pcdos,1184,338,774,1282,3767,7345,5
droit,1128,1543,1426,1963,1284,7344,5
ephas,693,336,334,2214,3767,7344,5
linzy,1046,2239,1757,186,2116,7344,5
afire,1698,73,1668,1225,2679,7343,5
rebah,948,2863,664,2214,654,7343,5
tsine,1264,341,1668,1391,2679,7343,5
argin,1698,1543,616,1963,1522,7342,5
devil,1128,2863,417,1963,971,7342,5
penki,1184,2863,1757,628,910,7342,5
spica,2206,336,1668,770,2362,7342,5
stoke,2206,403,1426,628,2679,7342,5
aumil,1698,1824,885,1963,971,7341,5
flary,847,1193,1959,1225,2116,7340,5
naevi,647,4103,1421,259,910,7340,5
pridy,1184,1543,1668,829,2116,7340,5
facom,847,4103,701,1282,406,7339,5
guyed,965,1824,381,3252,917,7339,5
sheba,2206,927,1421,423,2362,7339,5
proal,1184,1543,1426,2214,971,7338,5
quina,93,1824,1668,1391,2362,7338,5
arent,1698,1543,1421,1391,1284,7337,5
cavum,1512,4103,417,899,406,7337,5
ferox,847,2863,2201,1282,144,7337,5
fibra,847,2239,664,1225,2362,7337,5
manqu,1225,4103,1757,5,247,7337,5
owens,532,226,1421,1391,3767,7337,5
rithe,948,2239,1048,423,2679,7337,5
chave,1512,927,1959,259,2679,7336,5
ghain,965,927,1959,1963,1522,7336,5
nazim,647,4103,217,1963,406,7336,5
unlie,420,671,1603,1963,2679,7336,5
bruit,1555,1543,990,1963,1284,7335,5
glide,965,1193,1668,829,2679,7334,5
medor,1225,2863,774,1282,1190,7334,5
retag,948,2863,1048,2214,261,7334,5
agone,1698,139,1426,1391,2679,7333,5
ailyn,1698,2239,1603,271,1522,7333,5
graze,965,1543,1959,186,2679,7332,5
quita,93,1824,1668,1385,2362,7332,5
vrows,404,1543,1426,192,3767,7332,5
zirak,176,2239,2201,2214,502,7332,5
ambie,1698,327,664,1963,2679,7331,5
imray,473,327,2201,2214,2116,7331,5
typos,1264,458,560,1282,3767,7331,5
elain,693,1193,1959,1963,1522,7330,5
dunam,1128,1824,1757,2214,406,7329,5
jegar,446,2863,616,2214,1190,7329,5
refit,948,2863,271,1963,1284,7329,5
wendt,596,2863,1757,829,1284,7329,5
anime,1698,671,1668,612,2679,7328,5
gowdy,965,3069,349,829,2116,7328,5
yerth,225,2863,2201,1385,654,7328,5
juger,446,1824,616,3252,1190,7328,5
ldmts,1046,245,885,1385,3767,7328,5
gizeh,965,2239,217,3252,654,7327,5
firth,847,2239,2201,1385,654,7326,5
stome,2206,403,1426,612,2679,7326,5
swure,2206,226,990,1225,2679,7326,5
ilmen,473,1193,885,3252,1522,7325,5
nevoy,647,2863,417,1282,2116,7325,5
orage,532,1543,1959,612,2679,7325,5
seugh,2206,2863,990,612,654,7325,5
swail,2206,226,1959,1963,971,7325,5
erlin,693,1543,1603,1963,1522,7324,5
pcnfs,1184,338,1757,278,3767,7324,5
perdu,1184,2863,2201,829,247,7324,5
ceibo,1512,2863,1668,423,857,7323,5
monck,1225,3069,1757,770,502,7323,5
mouth,1225,3069,990,1385,654,7323,5
ohare,532,927,1959,1225,2679,7322,5
antre,1698,671,1048,1225,2679,7321,5
betsi,1555,2863,1048,945,910,7321,5
wingy,596,2239,1757,612,2116,7320,5
orsel,532,1543,1021,3252,971,7319,5
auloi,1698,1824,1603,1282,910,7317,5
bsmet,1555,341,885,3252,1284,7317,5
glued,965,1193,990,3252,917,7317,5
musit,1225,1824,1021,1963,1284,7317,5
nepit,647,2863,560,1963,1284,7317,5
crazy,1512,1543,1959,186,2116,7316,5
recon,948,2863,701,1282,1522,7316,5
glean,965,1193,1421,2214,1522,7315,5
locap,1046,3069,701,2214,285,7315,5
round,948,3069,990,1391,917,7315,5
starn,2206,403,1959,1225,1522,7315,5
wride,596,1543,1668,829,2679,7315,5
bepaw,1555,2863,560,2214,122,7314,5
briza,1555,1543,1668,186,2362,7314,5
yonic,225,3069,1757,1963,300,7314,5
sulci,2206,1824,1603,770,910,7313,5
fetwa,847,2863,1048,192,2362,7312,5
clive,1512,1193,1668,259,2679,7311,5
gusty,965,1824,1021,1385,2116,7311,5
rowdy,948,3069,349,829,2116,7311,5
astel,1698,341,1048,3252,971,7310,5
gopak,965,3069,560,2214,502,7310,5
pesto,1184,2863,1021,1385,857,7310,5
shirt,2206,927,1668,1225,1284,7310,5
gerbo,965,2863,2201,423,857,7309,5
macho,1225,4103,701,423,857,7309,5
pical,1184,2239,701,2214,971,7309,5
sochi,2206,3069,701,423,910,7309,5
spory,2206,336,1426,1225,2116,7309,5
sprot,2206,336,2201,1282,1284,7309,5
strap,2206,403,2201,2214,285,7309,5
tisha,1264,2239,1021,423,2362,7309,5
outre,532,1824,1048,1225,2679,7308,5
sidur,2206,2239,774,899,1190,7308,5
tench,1264,2863,1757,770,654,7308,5
bevor,1555,2863,417,1282,1190,7307,5
corfu,1512,3069,2201,278,247,7307,5
lucan,1046,1824,701,2214,1522,7307,5
ardme,1698,1543,774,612,2679,7306,5
flake,847,1193,1959,628,2679,7306,5
kauch,789,4103,990,770,654,7306,5
shorn,2206,927,1426,1225,1522,7306,5
tavgi,1264,4103,417,612,910,7306,5
drant,1128,1543,1959,1391,1284,7305,5
pleny,1184,1193,1421,1391,2116,7305,5
rutin,948,1824,1048,1963,1522,7305,5
swipe,2206,226,1668,526,2679,7305,5
trude,1264,1543,990,829,2679,7305,5
dugan,1128,1824,616,2214,1522,7304,5
jamul,446,4103,885,899,971,7304,5
anode,1698,671,1426,829,2679,7303,5
boldu,1555,3069,1603,829,247,7303,5
gosip,965,3069,1021,1963,285,7303,5
hafiz,844,4103,271,1963,122,7303,5
becut,1555,2863,701,899,1284,7302,5
syble,2206,458,664,1295,2679,7302,5
skime,2206,137,1668,612,2679,7302,5
elita,693,1193,1668,1385,2362,7301,5
hinau,844,2239,1757,2214,247,7301,5
ploat,1184,1193,1426,2214,1284,7301,5
setup,2206,2863,1048,899,285,7301,5
eacso,693,4103,701,945,857,7299,5
wylie,596,458,1603,1963,2679,7299,5
enlay,693,671,1603,2214,2116,7297,5
recha,948,2863,701,423,2362,7297,5
pleat,1184,1193,1421,2214,1284,7296,5
rhina,948,927,1668,1391,2362,7296,5
stagy,2206,403,1959,612,2116,7296,5
unics,420,671,1668,770,3767,7296,5
distn,1128,2239,1021,1385,1522,7295,5
kedah,789,2863,774,2214,654,7294,5
rafiq,948,4103,271,1963,9,7294,5
rusty,948,1824,1021,1385,2116,7294,5
ancel,1698,671,701,3252,971,7293,5
miaul,1225,2239,1959,899,971,7293,5
ocnus,532,338,1757,899,3767,7293,5
ghole,965,927,1426,1295,2679,7292,5
leach,1046,2863,1959,770,654,7292,5
mensk,1225,2863,1757,945,502,7292,5
elian,693,1193,1668,2214,1522,7290,5
flame,847,1193,1959,612,2679,7290,5
gunky,965,1824,1757,628,2116,7290,5
zebra,176,2863,664,1225,2362,7290,5
human,844,1824,885,2214,1522,7289,5
iters,473,403,1421,1225,3767,7289,5
pumex,1184,1824,885,3252,144,7289,5
sharl,2206,927,1959,1225,971,7288,5
dwale,1128,226,1959,1295,2679,7287,5
arpin,1698,1543,560,1963,1522,7286,5
brast,1555,1543,1959,945,1284,7286,5
gambi,965,4103,885,423,910,7286,5
higra,844,2239,616,1225,2362,7286,5
wopsy,596,3069,560,945,2116,7286,5
druse,1128,1543,990,945,2679,7285,5
syman,2206,458,885,2214,1522,7285,5
strag,2206,403,2201,2214,261,7285,5
alroi,1698,1193,2201,1282,910,7284,5
bukat,1555,1824,406,2214,1284,7283,5
frail,847,1543,1959,1963,971,7283,5
inlet,473,671,1603,3252,1284,7283,5
foehn,847,3069,1421,423,1522,7282,5
bedur,1555,2863,774,899,1190,7281,5
opers,532,336,1421,1225,3767,7281,5
pricy,1184,1543,1668,770,2116,7281,5
scuta,2206,338,990,1385,2362,7281,5
creon,1512,1543,1421,1282,1522,7280,5
gemot,965,2863,885,1282,1284,7279,5
sputa,2206,336,990,1385,2362,7279,5
trion,1264,1543,1668,1282,1522,7279,5
rusin,948,1824,1021,1963,1522,7278,5
vitra,404,2239,1048,1225,2362,7278,5
axone,1698,83,1426,1391,2679,7277,5
drive,1128,1543,1668,259,2679,7277,5
kerch,789,2863,2201,770,654,7277,5
maghi,1225,4103,616,423,910,7277,5
scoke,2206,338,1426,628,2679,7277,5
snoga,2206,671,1426,612,2362,7277,5
buist,1555,1824,1668,945,1284,7276,5
compt,1512,3069,885,526,1284,7276,5
yeast,225,2863,1959,945,1284,7276,5
splad,2206,336,1603,2214,917,7276,5
sudor,2206,1824,774,1282,1190,7276,5
jowly,446,3069,349,1295,2116,7275,5
piton,1184,2239,1048,1282,1522,7275,5
spoke,2206,336,1426,628,2679,7275,5
wifed,596,2239,271,3252,917,7275,5
adore,1698,245,1426,1225,2679,7273,5
genom,965,2863,1757,1282,406,7273,5
kathi,789,4103,1048,423,910,7273,5
lhary,1046,927,1959,1225,2116,7273,5
olden,532,1193,774,3252,1522,7273,5
pengo,1184,2863,1757,612,857,7273,5
avrit,1698,126,2201,1963,1284,7272,5
omers,532,327,1421,1225,3767,7272,5
pibal,1184,2239,664,2214,971,7272,5
alfeo,1698,1193,271,3252,857,7271,5
jived,446,2239,417,3252,917,7271,5
glair,965,1193,1959,1963,1190,7270,5
misha,1225,2239,1021,423,2362,7270,5
newly,647,2863,349,1295,2116,7270,5
verso,404,2863,2201,945,857,7270,5
amsel,1698,327,1021,3252,971,7269,5
weird,596,2863,1668,1225,917,7269,5
betso,1555,2863,1048,945,857,7268,5
jowar,446,3069,349,2214,1190,7268,5
birck,1555,2239,2201,770,502,7267,5
miche,1225,2239,701,423,2679,7267,5
smoke,2206,327,1426,628,2679,7266,5
vento,404,2863,1757,1385,857,7266,5
dachi,1128,4103,701,423,910,7265,5
liuka,1046,2239,990,628,2362,7265,5
zonic,176,3069,1757,1963,300,7265,5
newar,647,2863,349,2214,1190,7263,5
sugih,2206,1824,616,1963,654,7263,5
alody,1698,1193,1426,829,2116,7262,5
bmews,1555,327,1421,192,3767,7262,5
shiau,2206,927,1668,2214,247,7262,5
skeat,2206,137,1421,2214,1284,7262,5
after,1698,73,1048,3252,1190,7261,5
fugle,847,1824,616,1295,2679,7261,5
guion,965,1824,1668,1282,1522,7261,5
keout,789,2863,1426,899,1284,7261,5
whine,596,927,1668,1391,2679,7261,5
prize,1184,1543,1668,186,2679,7260,5
build,1555,1824,1668,1295,917,7259,5
donum,1128,3069,1757,899,406,7259,5
wersh,596,2863,2201,945,654,7259,5
sidth,2206,2239,774,1385,654,7258,5
clead,1512,1193,1421,2214,917,7257,5
rimal,948,2239,885,2214,971,7257,5
swear,2206,226,1421,2214,1190,7257,5
thief,1264,927,1668,3252,145,7256,5
jelab,446,2863,1603,2214,129,7255,5
musal,1225,1824,1021,2214,971,7255,5
nepal,647,2863,560,2214,971,7255,5
probe,1184,1543,1426,423,2679,7255,5
rahul,948,4103,334,899,971,7255,5
white,596,927,1668,1385,2679,7255,5
desto,1128,2863,1021,1385,857,7254,5
acted,1698,338,1048,3252,917,7253,5
bovld,1555,3069,417,1295,917,7253,5
guric,965,1824,2201,1963,300,7253,5
resun,948,2863,1021,899,1522,7253,5
wyner,596,458,1757,3252,1190,7253,5
anzus,1698,671,217,899,3767,7252,5
journ,446,3069,990,1225,1522,7252,5
ploce,1184,1193,1426,770,2679,7252,5
ridge,948,2239,774,612,2679,7252,5
behap,1555,2863,334,2214,285,7251,5
slank,2206,1193,1959,1391,502,7251,5
btise,1555,403,1668,945,2679,7250,5
scarn,2206,338,1959,1225,1522,7250,5
bundt,1555,1824,1757,829,1284,7249,5
frida,847,1543,1668,829,2362,7249,5
menow,1225,2863,1757,1282,122,7249,5
skein,2206,137,1421,1963,1522,7249,5
kafiz,789,4103,271,1963,122,7248,5
azote,1698,59,1426,1385,2679,7247,5
cubit,1512,1824,664,1963,1284,7247,5
lourd,1046,3069,990,1225,917,7247,5
kashi,789,4103,1021,423,910,7246,5
kinau,789,2239,1757,2214,247,7246,5
truce,1264,1543,990,770,2679,7246,5
metif,1225,2863,1048,1963,145,7244,5
scrap,2206,338,2201,2214,285,7244,5
guiba,965,1824,1668,423,2362,7242,5
quila,93,1824,1668,1295,2362,7242,5
whops,596,927,1426,526,3767,7242,5
those,1264,927,1426,945,2679,7241,5
stope,2206,403,1426,526,2679,7240,5
zosma,176,3069,1021,612,2362,7240,5
pyrex,1184,458,2201,3252,144,7239,5
craig,1512,1543,1959,1963,261,7238,5
krein,789,1543,1421,1963,1522,7238,5
tawgi,1264,4103,349,612,910,7238,5
zabti,176,4103,664,1385,910,7238,5
ovens,532,126,1421,1391,3767,7237,5
vodka,404,3069,774,628,2362,7237,5
gould,965,3069,990,1295,917,7236,5
olnek,532,1193,1757,3252,502,7236,5
roust,948,3069,990,945,1284,7236,5
skail,2206,137,1959,1963,971,7236,5
ziram,176,2239,2201,2214,406,7236,5
break,1555,1543,1421,2214,502,7235,5
cynde,1512,458,1757,829,2679,7235,5
mucin,1225,1824,701,1963,1522,7235,5
culti,1512,1824,1603,1385,910,7234,5
epics,693,336,1668,770,3767,7234,5
hempy,844,2863,885,526,2116,7234,5
kuman,789,1824,885,2214,1522,7234,5
nevsa,647,2863,417,945,2362,7234,5
shard,2206,927,1959,1225,917,7234,5
stife,2206,403,1668,278,2679,7234,5
takyr,1264,4103,406,271,1190,7234,5
begod,1555,2863,616,1282,917,7233,5
bryna,1555,1543,381,1391,2362,7232,5
foyil,847,3069,381,1963,971,7231,5
limsy,1046,2239,885,945,2116,7231,5
traik,1264,1543,1959,1963,502,7231,5
wefty,596,2863,271,1385,2116,7231,5
fetor,847,2863,1048,1282,1190,7230,5
petri,1184,2863,1048,1225,910,7230,5
sifac,2206,2239,271,2214,300,7230,5
unlet,420,671,1603,3252,1284,7230,5
deuno,1128,2863,990,1391,857,7229,5
fraid,847,1543,1959,1963,917,7229,5
guzel,965,1824,217,3252,971,7229,5
misky,1225,2239,1021,628,2116,7229,5
shent,2206,927,1421,1391,1284,7229,5
topaz,1264,3069,560,2214,122,7229,5
twine,1264,226,1668,1391,2679,7228,5
arnst,1698,1543,1757,945,1284,7227,5
mudar,1225,1824,774,2214,1190,7227,5
shari,2206,927,1959,1225,910,7227,5
cajou,1512,4103,81,1282,247,7225,5
erbia,693,1543,664,1963,2362,7225,5
nixed,647,2239,170,3252,917,7225,5
prude,1184,1543,990,829,2679,7225,5
icers,473,338,1421,1225,3767,7224,5
youve,225,3069,990,259,2679,7222,5
natch,647,4103,1048,770,654,7222,5
delco,1128,2863,1603,770,857,7221,5
flubs,847,1193,990,423,3767,7220,5
scrag,2206,338,2201,2214,261,7220,5
vilma,404,2239,1603,612,2362,7220,5
afrit,1698,73,2201,1963,1284,7219,5
benzo,1555,2863,1757,186,857,7218,5
ylems,225,1193,1421,612,3767,7218,5
metro,1225,2863,1048,1225,857,7218,5
nertz,647,2863,2201,1385,122,7218,5
sprag,2206,336,2201,2214,261,7218,5
anker,1698,671,406,3252,1190,7217,5
begut,1555,2863,616,899,1284,7217,5
neith,647,2863,1668,1385,654,7217,5
reask,948,2863,1959,945,502,7217,5
retax,948,2863,1048,2214,144,7217,5
blart,1555,1193,1959,1225,1284,7216,5
plaid,1184,1193,1959,1963,917,7216,5
rambo,948,4103,885,423,857,7216,5
aside,1698,341,1668,829,2679,7215,5
bryan,1555,1543,381,2214,1522,7215,5
ouida,532,1824,1668,829,2362,7215,5
steal,2206,403,1421,2214,971,7215,5
stive,2206,403,1668,259,2679,7215,5
found,847,3069,990,1391,917,7214,5
fraze,847,1543,1959,186,2679,7214,5
prosy,1184,1543,1426,945,2116,7214,5
segou,2206,2863,616,1282,247,7214,5
flota,847,1193,1426,1385,2362,7213,5
pauxi,1184,4103,990,26,910,7213,5
wakif,596,4103,406,1963,145,7213,5
devon,1128,2863,417,1282,1522,7212,5
erisa,693,1543,1668,945,2362,7211,5
hound,844,3069,990,1391,917,7211,5
avows,1698,126,1426,192,3767,7209,5
hauck,844,4103,990,770,502,7209,5
hedgy,844,2863,774,612,2116,7209,5
kovil,789,3069,417,1963,971,7209,5
angel,1698,671,616,3252,971,7208,5
fleta,847,1193,1421,1385,2362,7208,5
truly,1264,1543,990,1295,2116,7208,5
howdy,844,3069,349,829,2116,7207,5
leund,1046,2863,990,1391,917,7207,5
nivre,647,2239,417,1225,2679,7207,5
ursel,420,1543,1021,3252,971,7207,5
verdi,404,2863,2201,829,910,7207,5
faugh,847,4103,990,612,654,7206,5
hisbe,844,2239,1021,423,2679,7206,5
idols,473,245,1426,1295,3767,7206,5
acity,1698,338,1668,1385,2116,7205,5
thora,1264,927,1426,1225,2362,7204,5
chaon,1512,927,1959,1282,1522,7202,5
cluny,1512,1193,990,1391,2116,7202,5
musca,1225,1824,1021,770,2362,7202,5
trema,1264,1543,1421,612,2362,7202,5
amide,1698,327,1668,829,2679,7201,5
chery,1512,927,1421,1225,2116,7201,5
fedak,847,2863,774,2214,502,7200,5
plyer,1184,1193,381,3252,1190,7200,5
rhila,948,927,1668,1295,2362,7200,5
sihun,2206,2239,334,899,1522,7200,5
simul,2206,2239,885,899,971,7200,5
braxy,1555,1543,1959,26,2116,7199,5
bront,1555,1543,1426,1391,1284,7199,5
flued,847,1193,990,3252,917,7199,5
prion,1184,1543,1668,1282,1522,7199,5
thera,1264,927,1421,1225,2362,7199,5
japur,446,4103,560,899,1190,7198,5
neysa,647,2863,381,945,2362,7198,5
aloid,1698,1193,1426,1963,917,7197,5
croak,1512,1543,1426,2214,502,7197,5
lihue,1046,2239,334,899,2679,7197,5
noami,647,3069,1959,612,910,7197,5
bigha,1555,2239,616,423,2362,7195,5
gramy,965,1543,1959,612,2116,7195,5
nasch,647,4103,1021,770,654,7195,5
niepa,647,2239,1421,526,2362,7195,5
picao,1184,2239,701,2214,857,7195,5
remap,948,2863,885,2214,285,7195,5
amity,1698,327,1668,1385,2116,7194,5
brent,1555,1543,1421,1391,1284,7194,5
ikons,473,137,1426,1391,3767,7194,5
reach,948,2863,1959,770,654,7194,5
fusty,847,1824,1021,1385,2116,7193,5
lebam,1046,2863,664,2214,406,7193,5
creak,1512,1543,1421,2214,502,7192,5
shoya,2206,927,1426,271,2362,7192,5
timon,1264,2239,885,1282,1522,7192,5
decap,1128,2863,701,2214,285,7191,5
rebak,948,2863,664,2214,502,7191,5
irena,473,1543,1421,1391,2362,7190,5
hopak,844,3069,560,2214,502,7189,5
yeard,225,2863,1959,1225,917,7189,5
alowe,1698,1193,1426,192,2679,7188,5
kadmi,789,4103,774,612,910,7188,5
pisky,1184,2239,1021,628,2116,7188,5
fiard,847,2239,1959,1225,917,7187,5
sheya,2206,927,1421,271,2362,7187,5
snipy,2206,671,1668,526,2116,7187,5
wigan,596,2239,616,2214,1522,7187,5
cyder,1512,458,774,3252,1190,7186,5
aueto,1698,1824,1421,1385,857,7185,5
mosul,1225,3069,1021,899,971,7185,5
haysi,844,4103,381,945,910,7183,5
quake,93,1824,1959,628,2679,7183,5
fient,847,2239,1421,1391,1284,7182,5
mohwa,1225,3069,334,192,2362,7182,5
arnut,1698,1543,1757,899,1284,7181,5
kempy,789,2863,885,526,2116,7179,5
knops,789,671,1426,526,3767,7179,5
lcsen,1046,338,1021,3252,1522,7179,5
chiao,1512,927,1668,2214,857,7178,5
ivens,473,126,1421,1391,3767,7178,5
kithe,789,2239,1048,423,2679,7178,5
olpae,532,1193,560,2214,2679,7178,5
scant,2206,338,1959,1391,1284,7178,5
auxin,1698,1824,170,1963,1522,7177,5
petro,1184,2863,1048,1225,857,7177,5
plica,1184,1193,1668,770,2362,7177,5
greit,965,1543,1421,1963,1284,7176,5
modif,1225,3069,774,1963,145,7176,5
shivy,2206,927,1668,259,2116,7176,5
venlo,404,2863,1757,1295,857,7176,5
vespa,404,2863,1021,526,2362,7176,5
scope,2206,338,1426,526,2679,7175,5
sheva,2206,927,1421,259,2362,7175,5
smiga,2206,327,1668,612,2362,7175,5
furzy,847,1824,2201,186,2116,7174,5
kosti,789,3069,1021,1385,910,7174,5
clart,1512,1193,1959,1225,1284,7173,5
urmia,420,1543,885,1963,2362,7173,5
choke,1512,927,1426,628,2679,7172,5
cryan,1512,1543,381,2214,1522,7172,5
funky,847,1824,1757,628,2116,7172,5
quira,93,1824,1668,1225,2362,7172,5
trove,1264,1543,1426,259,2679,7171,5
watch,596,4103,1048,770,654,7171,5
kilby,789,2239,1603,423,2116,7170,5
april,1698,336,2201,1963,971,7169,5
dupla,1128,1824,560,1295,2362,7169,5
hunky,844,1824,1757,628,2116,7169,5
maqui,1225,4103,32,899,910,7169,5
funje,847,1824,1757,61,2679,7168,5
resaw,948,2863,1021,2214,122,7168,5
sophi,2206,3069,560,423,910,7168,5
pirog,1184,2239,2201,1282,261,7167,5
wertz,596,2863,2201,1385,122,7167,5
wodgy,596,3069,774,612,2116,7167,5
bisdn,1555,2239,1021,829,1522,7166,5
gourd,965,3069,990,1225,917,7166,5
tekya,1264,2863,406,271,2362,7166,5
romic,948,3069,885,1963,300,7165,5
stipa,2206,403,1668,526,2362,7165,5
while,596,927,1668,1295,2679,7165,5
decor,1128,2863,701,1282,1190,7164,5
nauch,647,4103,990,770,654,7164,5
xinca,36,2239,1757,770,2362,7164,5
klieg,789,1193,1668,3252,261,7163,5
orlin,532,1543,1603,1963,1522,7163,5
viseu,404,2239,1021,3252,247,7163,5
ilone,473,1193,1426,1391,2679,7162,5
atune,1698,403,990,1391,2679,7161,5
jeton,446,2863,1048,1282,1522,7161,5
phose,1184,927,1426,945,2679,7161,5
stead,2206,403,1421,2214,917,7161,5
styed,2206,403,381,3252,917,7159,5
stoai,2206,403,1426,2214,910,7159,5
tepor,1264,2863,560,1282,1190,7159,5
yasui,225,4103,1021,899,910,7158,5
kopje,789,3069,560,61,2679,7158,5
azole,1698,59,1426,1295,2679,7157,5
doylt,1128,3069,381,1295,1284,7157,5
peltz,1184,2863,1603,1385,122,7157,5
smpte,2206,327,560,1385,2679,7157,5
delft,1128,2863,1603,278,1284,7156,5
topic,1264,3069,560,1963,300,7156,5
tubar,1264,1824,664,2214,1190,7156,5
thule,1264,927,990,1295,2679,7155,5
kedgy,789,2863,774,612,2116,7154,5
evius,693,126,1668,899,3767,7153,5
flair,847,1193,1959,1963,1190,7152,5
piend,1184,2239,1421,1391,917,7152,5
tawpi,1264,4103,349,526,910,7152,5
ducat,1128,1824,701,2214,1284,7151,5
fidge,847,2239,774,612,2679,7151,5
aldin,1698,1193,774,1963,1522,7150,5
clyte,1512,1193,381,1385,2679,7150,5
aesop,1698,2863,1021,1282,285,7149,5
youze,225,3069,990,186,2679,7149,5
sedum,2206,2863,774,899,406,7148,5
speal,2206,336,1421,2214,971,7148,5
ashen,1698,341,334,3252,1522,7147,5
sylid,2206,458,1603,1963,917,7147,5
benji,1555,2863,1757,61,910,7146,5
besht,1555,2863,1021,423,1284,7146,5
bsage,1555,341,1959,612,2679,7146,5
lhota,1046,927,1426,1385,2362,7146,5
mnage,1225,671,1959,612,2679,7146,5
straw,2206,403,2201,2214,122,7146,5
yucks,225,1824,701,628,3767,7145,5
upsey,420,336,1021,3252,2116,7145,5
achen,1698,338,334,3252,1522,7144,5
blimy,1555,1193,1668,612,2116,7144,5
busky,1555,1824,1021,628,2116,7144,5
goltz,965,3069,1603,1385,122,7144,5
louth,1046,3069,990,1385,654,7144,5
arvin,1698,1543,417,1963,1522,7143,5
pahmi,1184,4103,334,612,910,7143,5
amice,1698,327,1668,770,2679,7142,5
fulah,847,1824,1603,2214,654,7142,5
grant,965,1543,1959,1391,1284,7142,5
zoist,176,3069,1668,945,1284,7142,5
oldie,532,1193,774,1963,2679,7141,5
breva,1555,1543,1421,259,2362,7140,5
bream,1555,1543,1421,2214,406,7139,5
getic,965,2863,1048,1963,300,7139,5
grope,965,1543,1426,526,2679,7139,5
arist,1698,1543,1668,945,1284,7138,5
tydie,1264,458,774,1963,2679,7138,5
pashm,1184,4103,1021,423,406,7137,5
urena,420,1543,1421,1391,2362,7137,5
onlay,532,671,1603,2214,2116,7136,5
rajiv,948,4103,81,1963,41,7136,5
jatki,446,4103,1048,628,910,7135,5
orvie,532,1543,417,1963,2679,7134,5
glike,965,1193,1668,628,2679,7133,5
velic,404,2863,1603,1963,300,7133,5
pyote,1184,458,1426,1385,2679,7132,5
amber,1698,327,664,3252,1190,7131,5
cynar,1512,458,1757,2214,1190,7131,5
cmise,1512,327,1668,945,2679,7131,5
nifle,647,2239,271,1295,2679,7131,5
debag,1128,2863,664,2214,261,7130,5
ivray,473,126,2201,2214,2116,7130,5
levon,1046,2863,417,1282,1522,7130,5
claik,1512,1193,1959,1963,502,7129,5
jobye,446,3069,664,271,2679,7129,5
jozef,446,3069,217,3252,145,7129,5
oylet,532,458,1603,3252,1284,7129,5
cebur,1512,2863,664,899,1190,7128,5
detur,1128,2863,1048,899,1190,7128,5
besom,1555,2863,1021,1282,406,7127,5
debor,1128,2863,664,1282,1190,7127,5
hyrse,844,458,2201,945,2679,7127,5
ruyle,948,1824,381,1295,2679,7127,5
medic,1225,2863,774,1963,300,7125,5
rhame,948,927,1959,612,2679,7125,5
bhima,1555,927,1668,612,2362,7124,5
phora,1184,927,1426,1225,2362,7124,5
redby,948,2863,774,423,2116,7124,5
tipsy,1264,2239,560,945,2116,7124,5
primy,1184,1543,1668,612,2116,7123,5
lubra,1046,1824,664,1225,2362,7121,5
hajib,844,4103,81,1963,129,7120,5
bemud,1555,2863,885,899,917,7119,5
kusin,789,1824,1021,1963,1522,7119,5
swamy,2206,226,1959,612,2116,7119,5
crepy,1512,1543,1421,526,2116,7118,5
litha,1046,2239,1048,423,2362,7118,5
acrid,1698,338,2201,1963,917,7117,5
depot,1128,2863,560,1282,1284,7117,5
glime,965,1193,1668,612,2679,7117,5
tripy,1264,1543,1668,526,2116,7117,5
audio,1698,1824,774,1963,857,7116,5
duali,1128,1824,1959,1295,910,7116,5
speir,2206,336,1421,1963,1190,7116,5
melch,1225,2863,1603,770,654,7115,5
trifa,1264,1543,1668,278,2362,7115,5
exams,693,83,1959,612,3767,7114,5
scrim,2206,338,2201,1963,406,7114,5
tiang,1264,2239,1959,1391,261,7114,5
amlin,1698,327,1603,1963,1522,7113,5
dovap,1128,3069,417,2214,285,7113,5
jtids,446,403,1668,829,3767,7113,5
showa,2206,927,1426,192,2362,7113,5
wauch,596,4103,990,770,654,7113,5
arndt,1698,1543,1757,829,1284,7111,5
bract,1555,1543,1959,770,1284,7111,5
yojan,225,3069,81,2214,1522,7111,5
adieu,1698,245,1668,3252,247,7110,5
druce,1128,1543,990,770,2679,7110,5
kelsi,789,2863,1603,945,910,7110,5
grapy,965,1543,1959,526,2116,7109,5
pugin,1184,1824,616,1963,1522,7109,5
ioyal,473,3069,381,2214,971,7108,5
shewa,2206,927,1421,192,2362,7108,5
tunic,1264,1824,1757,1963,300,7108,5
frome,847,1543,1426,612,2679,7107,5
retip,948,2863,1048,1963,285,7107,5
stude,2206,403,990,829,2679,7107,5
ouphs,532,1824,560,423,3767,7106,5
whase,596,927,1959,945,2679,7106,5
cyril,1512,458,2201,1963,971,7105,5
yasuo,225,4103,1021,899,857,7105,5
diurn,1128,2239,990,1225,1522,7104,5
helyn,844,2863,1603,271,1522,7103,5
hedva,844,2863,774,259,2362,7102,5
afore,1698,73,1426,1225,2679,7101,5
scoad,2206,338,1426,2214,917,7101,5
texon,1264,2863,170,1282,1522,7101,5
awide,1698,226,1668,829,2679,7100,5
bourg,1555,3069,990,1225,261,7100,5
lekha,1046,2863,406,423,2362,7100,5
nomap,647,3069,885,2214,285,7100,5
vertu,404,2863,2201,1385,247,7100,5
noach,647,3069,1959,770,654,7099,5
wyler,596,458,1603,3252,1190,7099,5
hurst,844,1824,2201,945,1284,7098,5
shuma,2206,927,990,612,2362,7097,5
thein,1264,927,1421,1963,1522,7097,5
adnex,1698,245,1757,3252,144,7096,5
botch,1555,3069,1048,770,654,7096,5
cream,1512,1543,1421,2214,406,7096,5
gupta,965,1824,560,1385,2362,7096,5
spicy,2206,336,1668,770,2116,7096,5
echis,693,338,334,1963,3767,7095,5
erida,693,1543,1668,829,2362,7095,5
kendo,789,2863,1757,829,857,7095,5
tufan,1264,1824,271,2214,1522,7095,5
flute,847,1193,990,1385,2679,7094,5
predy,1184,1543,1421,829,2116,7093,5
dwine,1128,226,1668,1391,2679,7092,5
lenox,1046,2863,1757,1282,144,7092,5
lunik,1046,1824,1757,1963,502,7092,5
fibry,847,2239,664,1225,2116,7091,5
lisha,1046,2239,1021,423,2362,7091,5
prove,1184,1543,1426,259,2679,7091,5
acute,1698,338,990,1385,2679,7090,5
lench,1046,2863,1757,770,654,7090,5
quota,93,1824,1426,1385,2362,7090,5
womby,596,3069,885,423,2116,7089,5
klber,789,1193,664,3252,1190,7088,5
scrab,2206,338,2201,2214,129,7088,5
thave,1264,927,1959,259,2679,7088,5
lyase,1046,458,1959,945,2679,7087,5
oukia,532,1824,406,1963,2362,7087,5
slyke,2206,1193,381,628,2679,7087,5
chula,1512,927,990,1295,2362,7086,5
lubec,1046,1824,664,3252,300,7086,5
luiza,1046,1824,1668,186,2362,7086,5
gumly,965,1824,885,1295,2116,7085,5
mizar,1225,2239,217,2214,1190,7085,5
kulah,789,1824,1603,2214,654,7084,5
jabul,446,4103,664,899,971,7083,5
miqra,1225,2239,32,1225,2362,7083,5
vadso,404,4103,774,945,857,7083,5
gloat,965,1193,1426,2214,1284,7082,5
kanzu,789,4103,1757,186,247,7082,5
scalt,2206,338,1959,1295,1284,7082,5
scraw,2206,338,2201,2214,122,7081,5
stion,2206,403,1668,1282,1522,7081,5
tukra,1264,1824,406,1225,2362,7081,5
hawok,844,4103,349,1282,502,7080,5
spalt,2206,336,1959,1295,1284,7080,5
aksel,1698,137,1021,3252,971,7079,5
zagut,176,4103,616,899,1284,7078,5
athie,1698,403,334,1963,2679,7077,5
inlay,473,671,1603,2214,2116,7077,5
kefir,789,2863,271,1963,1190,7076,5
knobs,789,671,1426,423,3767,7076,5
pulik,1184,1824,1603,1963,502,7076,5
reaum,948,2863,1959,899,406,7075,5
rentz,948,2863,1757,1385,122,7075,5
wirth,596,2239,2201,1385,654,7075,5
quean,93,1824,1421,2214,1522,7074,5
chant,1512,927,1959,1391,1284,7073,5
joash,446,3069,1959,945,654,7073,5
naght,647,4103,616,423,1284,7073,5
piest,1184,2239,1421,945,1284,7073,5
pudge,1184,1824,774,612,2679,7073,5
emuls,693,327,990,1295,3767,7072,5
tisza,1264,2239,1021,186,2362,7072,5
tsade,1264,341,1959,829,2679,7072,5
noxal,647,3069,170,2214,971,7071,5
overs,532,126,1421,1225,3767,7071,5
smalt,2206,327,1959,1295,1284,7071,5
print,1184,1543,1668,1391,1284,7070,5
bosch,1555,3069,1021,770,654,7069,5
clove,1512,1193,1426,259,2679,7069,5
dulac,1128,1824,1603,2214,300,7069,5
munic,1225,1824,1757,1963,300,7069,5
rumly,948,1824,885,1295,2116,7068,5
runby,948,1824,1757,423,2116,7068,5
short,2206,927,1426,1225,1284,7068,5
sudic,2206,1824,774,1963,300,7067,5
arson,1698,1543,1021,1282,1522,7066,5
molvi,1225,3069,1603,259,910,7066,5
atule,1698,403,990,1295,2679,7065,5
herzl,844,2863,2201,186,971,7065,5
krosa,789,1543,1426,945,2362,7065,5
swope,2206,226,1426,526,2679,7063,5
glady,965,1193,1959,829,2116,7062,5
twire,1264,226,1668,1225,2679,7062,5
vyner,404,458,1757,3252,1190,7061,5
armil,1698,1543,885,1963,971,7060,5
punti,1184,1824,1757,1385,910,7060,5
zenic,176,2863,1757,1963,300,7059,5
freit,847,1543,1421,1963,1284,7058,5
limpa,1046,2239,885,526,2362,7058,5
oundy,532,1824,1757,829,2116,7058,5
strip,2206,403,2201,1963,285,7058,5
wreat,596,1543,1421,2214,1284,7058,5
zincy,176,2239,1757,770,2116,7058,5
ajmer,1698,32,885,3252,1190,7057,5
fuzed,847,1824,217,3252,917,7057,5
kelso,789,2863,1603,945,857,7057,5
arefy,1698,1543,1421,278,2116,7056,5
yasht,225,4103,1021,423,1284,7056,5
mster,1225,341,1048,3252,1190,7056,5
glave,965,1193,1959,259,2679,7055,5
mikal,1225,2239,406,2214,971,7055,5
nilot,647,2239,1603,1282,1284,7055,5
rhona,948,927,1426,1391,2362,7054,5
snirt,2206,671,1668,1225,1284,7054,5
vijay,404,2239,81,2214,2116,7054,5
chuse,1512,927,990,945,2679,7053,5
flora,847,1193,1426,1225,2362,7053,5
rumex,948,1824,885,3252,144,7053,5
axtel,1698,83,1048,3252,971,7052,5
decaf,1128,2863,701,2214,145,7051,5
nasho,647,4103,1021,423,857,7051,5
nevai,647,2863,417,2214,910,7051,5
thida,1264,927,1668,829,2362,7050,5
krome,789,1543,1426,612,2679,7049,5
mohun,1225,3069,334,899,1522,7049,5
bueno,1555,1824,1421,1391,857,7048,5
clint,1512,1193,1668,1391,1284,7048,5
andre,1698,671,774,1225,2679,7047,5
deynt,1128,2863,381,1391,1284,7047,5
elnar,693,1193,1757,2214,1190,7047,5
abide,1698,172,1668,829,2679,7046,5
nuked,647,1824,406,3252,917,7046,5
routh,948,3069,990,1385,654,7046,5
alogy,1698,1193,1426,612,2116,7045,5
chive,1512,927,1668,259,2679,7045,5
jokai,446,3069,406,2214,910,7045,5
nesac,647,2863,1021,2214,300,7045,5
ancle,1698,671,701,1295,2679,7044,5
arche,1698,1543,701,423,2679,7044,5
phony,1184,927,1426,1391,2116,7044,5
khmer,789,927,885,3252,1190,7043,5
rheta,948,927,1421,1385,2362,7043,5
autor,1698,1824,1048,1282,1190,7042,5
cnida,1512,671,1668,829,2362,7042,5
acron,1698,338,2201,1282,1522,7041,5
asper,1698,341,560,3252,1190,7041,5
khila,789,927,1668,1295,2362,7041,5
albin,1698,1193,664,1963,1522,7040,5
ifrps,473,73,2201,526,3767,7040,5
zinah,176,2239,1757,2214,654,7040,5
apron,1698,336,2201,1282,1522,7039,5
aslef,1698,341,1603,3252,145,7039,5
clavy,1512,1193,1959,259,2116,7039,5
pheny,1184,927,1421,1391,2116,7039,5
bouch,1555,3069,990,770,654,7038,5
houri,844,3069,990,1225,910,7038,5
humin,844,1824,885,1963,1522,7038,5
justa,446,1824,1021,1385,2362,7038,5
sebum,2206,2863,664,899,406,7038,5
sweal,2206,226,1421,2214,971,7038,5
swive,2206,226,1668,259,2679,7038,5
erica,693,1543,1668,770,2362,7036,5
grobe,965,1543,1426,423,2679,7036,5
guilt,965,1824,1668,1295,1284,7036,5
klute,789,1193,990,1385,2679,7036,5
ribal,948,2239,664,2214,971,7036,5
rioja,948,2239,1426,61,2362,7036,5
drove,1128,1543,1426,259,2679,7035,5
keach,789,2863,1959,770,654,7035,5
atony,1698,403,1426,1391,2116,7034,5
beryx,1555,2863,2201,271,144,7034,5
bichy,1555,2239,701,423,2116,7034,5
gulpy,965,1824,1603,526,2116,7034,5
sruti,2206,1543,990,1385,910,7034,5
strig,2206,403,2201,1963,261,7034,5
vughs,404,1824,616,423,3767,7034,5
claim,1512,1193,1959,1963,406,7033,5
micah,1225,2239,701,2214,654,7033,5
pique,1184,2239,32,899,2679,7033,5
snarl,2206,671,1959,1225,971,7032,5
vitry,404,2239,1048,1225,2116,7032,5
droil,1128,1543,1426,1963,971,7031,5
yourn,225,3069,990,1225,1522,7031,5
ptain,1184,403,1959,1963,1522,7031,5
resod,948,2863,1021,1282,917,7031,5
rudin,948,1824,774,1963,1522,7031,5
awber,1698,226,664,3252,1190,7030,5
bigam,1555,2239,616,2214,406,7030,5
blume,1555,1193,990,612,2679,7029,5
mysia,1225,458,1021,1963,2362,7029,5
denbo,1128,2863,1757,423,857,7028,5
orvet,532,1543,417,3252,1284,7028,5
pyral,1184,458,2201,2214,971,7028,5
punic,1184,1824,1757,1963,300,7028,5
tybie,1264,458,664,1963,2679,7028,5
ulita,420,1193,1668,1385,2362,7028,5
amper,1698,327,560,3252,1190,7027,5
oizys,532,2239,217,271,3767,7026,5
rehid,948,2863,334,1963,917,7025,5
unlay,420,671,1603,2214,2116,7024,5
holtz,844,3069,1603,1385,122,7023,5
mylan,1225,458,1603,2214,1522,7022,5
jorum,446,3069,2201,899,406,7021,5
bingo,1555,2239,1757,612,857,7020,5
phaye,1184,927,1959,271,2679,7020,5
lubin,1046,1824,664,1963,1522,7019,5
sheik,2206,927,1421,1963,502,7019,5
whone,596,927,1426,1391,2679,7019,5
byron,1555,458,2201,1282,1522,7018,5
choir,1512,927,1426,1963,1190,7018,5
opahs,532,336,1959,423,3767,7017,5
chura,1512,927,990,1225,2362,7016,5
orgia,532,1543,616,1963,2362,7016,5
scion,2206,338,1668,1282,1522,7016,5
bland,1555,1193,1959,1391,917,7015,5
hulky,844,1824,1603,628,2116,7015,5
kimbe,789,2239,885,423,2679,7015,5
priam,1184,1543,1668,2214,406,7015,5
sneak,2206,671,1421,2214,502,7014,5
cheir,1512,927,1421,1963,1190,7013,5
kuban,789,1824,664,2214,1522,7013,5
ivers,473,126,1421,1225,3767,7012,5
juvia,446,1824,417,1963,2362,7012,5
lukan,1046,1824,406,2214,1522,7012,5
rison,948,2239,1021,1282,1522,7012,5
scart,2206,338,1959,1225,1284,7012,5
tejon,1264,2863,81,1282,1522,7012,5
thram,1264,927,2201,2214,406,7012,5
plant,1184,1193,1959,1391,1284,7011,5
recap,948,2863,701,2214,285,7011,5
deism,1128,2863,1668,945,406,7010,5
pithy,1184,2239,1048,423,2116,7010,5
slang,2206,1193,1959,1391,261,7010,5
spart,2206,336,1959,1225,1284,7010,5
blazy,1555,1193,1959,186,2116,7009,5
ogams,532,139,1959,612,3767,7009,5
stoga,2206,403,1426,612,2362,7009,5
stoma,2206,403,1426,612,2362,7009,5
hexad,844,2863,170,2214,917,7008,5
kiowa,789,2239,1426,192,2362,7008,5
ticon,1264,2239,701,1282,1522,7008,5
behav,1555,2863,334,2214,41,7007,5
punto,1184,1824,1757,1385,857,7007,5
nyxis,647,458,170,1963,3767,7005,5
qulin,93,1824,1603,1963,1522,7005,5
stimy,2206,403,1668,612,2116,7005,5
burch,1555,1824,2201,770,654,7004,5
girsh,965,2239,2201,945,654,7004,5
yetah,225,2863,1048,2214,654,7004,5
jelib,446,2863,1603,1963,129,7004,5
musil,1225,1824,1021,1963,971,7004,5
nepil,647,2863,560,1963,971,7004,5
phail,1184,927,1959,1963,971,7004,5
stema,2206,403,1421,612,2362,7004,5
kevil,789,2863,417,1963,971,7003,5
toefl,1264,3069,1421,278,971,7003,5
freda,847,1543,1421,829,2362,7002,5
adger,1698,245,616,3252,1190,7001,5
novah,647,3069,417,2214,654,7001,5
smart,2206,327,1959,1225,1284,7001,5
eibar,693,2239,664,2214,1190,7000,5
kreit,789,1543,1421,1963,1284,7000,5
washo,596,4103,1021,423,857,7000,5
jewry,446,2863,349,1225,2116,6999,5
dupin,1128,1824,560,1963,1522,6997,5
shirl,2206,927,1668,1225,971,6997,5
bilsh,1555,2239,1603,945,654,6996,5
cloze,1512,1193,1426,186,2679,6996,5
guano,965,1824,1959,1391,857,6996,5
brist,1555,1543,1668,945,1284,6995,5
logic,1046,3069,616,1963,300,6994,5
prand,1184,1543,1959,1391,917,6994,5
jiboa,446,2239,664,1282,2362,6993,5
scrip,2206,338,2201,1963,285,6993,5
algin,1698,1193,616,1963,1522,6992,5
hispa,844,2239,1021,526,2362,6992,5
astre,1698,341,1048,1225,2679,6991,5
bewig,1555,2863,349,1963,261,6991,5
ceryx,1512,2863,2201,271,144,6991,5
crudy,1512,1543,990,829,2116,6990,5
guato,965,1824,1959,1385,857,6990,5
riche,948,2239,701,423,2679,6990,5
vergi,404,2863,2201,612,910,6990,5
lutao,1046,1824,1048,2214,857,6989,5
staun,2206,403,1959,899,1522,6989,5
triac,1264,1543,1668,2214,300,6989,5
dipsy,1128,2239,560,945,2116,6988,5
truda,1264,1543,990,829,2362,6988,5
leong,1046,2863,1426,1391,261,6987,5
moeck,1225,3069,1421,770,502,6987,5
shank,2206,927,1959,1391,502,6985,5
slype,2206,1193,381,526,2679,6985,5
withe,596,2239,1048,423,2679,6985,5
jotun,446,3069,1048,899,1522,6984,5
katuf,789,4103,1048,899,145,6984,5
osier,532,341,1668,3252,1190,6983,5
veldt,404,2863,1603,829,1284,6983,5
zohar,176,3069,334,2214,1190,6983,5
dhoty,1128,927,1426,1385,2116,6982,5
glaze,965,1193,1959,186,2679,6982,5
wheys,596,927,1421,271,3767,6982,5
dolph,1128,3069,1603,526,654,6980,5
wulfe,596,1824,1603,278,2679,6980,5
giuba,965,2239,990,423,2362,6979,5
amvet,1698,327,417,3252,1284,6978,5
lodur,1046,3069,774,899,1190,6978,5
suomi,2206,1824,1426,612,910,6978,5
yapur,225,4103,560,899,1190,6977,5
bigot,1555,2239,616,1282,1284,6976,5
mudir,1225,1824,774,1963,1190,6976,5
ancre,1698,671,701,1225,2679,6974,5
devot,1128,2863,417,1282,1284,6974,5
lewak,1046,2863,349,2214,502,6974,5
limon,1046,2239,885,1282,1522,6974,5
stove,2206,403,1426,259,2679,6973,5
jundy,446,1824,1757,829,2116,6972,5
guiac,965,1824,1668,2214,300,6971,5
arend,1698,1543,1421,1391,917,6970,5
gunja,965,1824,1757,61,2362,6969,5
agnew,1698,139,1757,3252,122,6968,5
ahint,1698,927,1668,1391,1284,6968,5
itous,473,403,1426,899,3767,6968,5
sprig,2206,336,2201,1963,261,6967,5
yurak,225,1824,2201,2214,502,6966,5
midgy,1225,2239,774,612,2116,6966,5
spaik,2206,336,1959,1963,502,6966,5
ankhs,1698,671,406,423,3767,6965,5
auryl,1698,1824,2201,271,971,6965,5
demur,1128,2863,885,899,1190,6965,5
float,847,1193,1426,2214,1284,6964,5
phial,1184,927,1668,2214,971,6964,5
reiko,948,2863,1668,628,857,6964,5
rewon,948,2863,349,1282,1522,6964,5
style,2206,403,381,1295,2679,6964,5
vacuo,404,4103,701,899,857,6964,5
distr,1128,2239,1021,1385,1190,6963,5
jauch,446,4103,990,770,654,6963,5
wound,596,3069,990,1391,917,6963,5
goetz,965,3069,1421,1385,122,6962,5
shaul,2206,927,1959,899,971,6962,5
tuzla,1264,1824,217,1295,2362,6962,5
feigl,847,2863,1668,612,971,6961,5
hymen,844,458,885,3252,1522,6961,5
nosig,647,3069,1021,1963,261,6961,5
wedgy,596,2863,774,612,2116,6961,5
lifar,1046,2239,271,2214,1190,6960,5
slink,2206,1193,1668,1391,502,6960,5
angle,1698,671,616,1295,2679,6959,5
avril,1698,126,2201,1963,971,6959,5
rifty,948,2239,271,1385,2116,6959,5
heigl,844,2863,1668,612,971,6958,5
wlity,596,1193,1668,1385,2116,6958,5
jacht,446,4103,701,423,1284,6957,5
owner,532,226,1757,3252,1190,6957,5
smaik,2206,327,1959,1963,502,6957,5
subic,2206,1824,664,1963,300,6957,5
fedor,847,2863,774,1282,1190,6956,5
limba,1046,2239,885,423,2362,6955,5
waugh,596,4103,990,612,654,6955,5
wendi,596,2863,1757,829,910,6955,5
antep,1698,671,1048,3252,285,6954,5
skoal,2206,137,1426,2214,971,6954,5
spiky,2206,336,1668,628,2116,6954,5
unare,420,671,1959,1225,2679,6954,5
islet,473,341,1603,3252,1284,6953,5
ketol,789,2863,1048,1282,971,6953,5
crist,1512,1543,1668,945,1284,6952,5
miaou,1225,2239,1959,1282,247,6952,5
risky,948,2239,1021,628,2116,6952,5
urbia,420,1543,664,1963,2362,6952,5
gubat,965,1824,664,2214,1284,6951,5
nidge,647,2239,774,612,2679,6951,5
reown,948,2863,1426,192,1522,6951,5
thyms,1264,927,381,612,3767,6951,5
brank,1555,1543,1959,1391,502,6950,5
rebag,948,2863,664,2214,261,6950,5
tepic,1264,2863,560,1963,300,6950,5
irony,473,1543,1426,1391,2116,6949,5
skive,2206,137,1668,259,2679,6949,5
troak,1264,1543,1426,2214,502,6949,5
adron,1698,245,2201,1282,1522,6948,5
arith,1698,1543,1668,1385,654,6948,5
ticky,1264,2239,701,628,2116,6948,5
acoin,1698,338,1426,1963,1522,6947,5
kitwe,789,2239,1048,192,2679,6947,5
multi,1225,1824,1603,1385,910,6947,5
havoc,844,4103,417,1282,300,6946,5
kruse,789,1543,990,945,2679,6946,5
muist,1225,1824,1668,945,1284,6946,5
broun,1555,1543,1426,899,1522,6945,5
fouth,847,3069,990,1385,654,6945,5
yauco,225,4103,990,770,857,6945,5
kreda,789,1543,1421,829,2362,6944,5
scrod,2206,338,2201,1282,917,6944,5
sprod,2206,336,2201,1282,917,6942,5
avice,1698,126,1668,770,2679,6941,5
older,532,1193,774,3252,1190,6941,5
shuln,2206,927,990,1295,1522,6940,5
ulmer,420,1193,885,3252,1190,6940,5
bushy,1555,1824,1021,423,2116,6939,5
tulip,1264,1824,1603,1963,285,6939,5
dunst,1128,1824,1757,945,1284,6938,5
yunca,225,1824,1757,770,2362,6938,5
chude,1512,927,990,829,2679,6937,5
helco,844,2863,1603,770,857,6937,5
repot,948,2863,560,1282,1284,6937,5
tubal,1264,1824,664,2214,971,6937,5
blast,1555,1193,1959,945,1284,6936,5
murdo,1225,1824,2201,829,857,6936,5
putid,1184,1824,1048,1963,917,6936,5
zeist,176,2863,1668,945,1284,6936,5
dioxy,1128,2239,1426,26,2116,6935,5
foism,847,3069,1668,945,406,6935,5
kelci,789,2863,1603,770,910,6935,5
liest,1046,2239,1421,945,1284,6935,5
twain,1264,226,1959,1963,1522,6934,5
ately,1698,403,1421,1295,2116,6933,5
azide,1698,59,1668,829,2679,6933,5
dunaj,1128,1824,1757,2214,10,6933,5
ophis,532,336,334,1963,3767,6932,5
pitau,1184,2239,1048,2214,247,6932,5
ripal,948,2239,560,2214,971,6932,5
abune,1698,172,990,1391,2679,6930,5
cleon,1512,1193,1421,1282,1522,6930,5
gwine,965,226,1668,1391,2679,6929,5
plead,1184,1193,1421,2214,917,6929,5
siafu,2206,2239,1959,278,247,6929,5
apure,1698,336,990,1225,2679,6928,5
bryce,1555,1543,381,770,2679,6928,5
orial,532,1543,1668,2214,971,6928,5
prato,1184,1543,1959,1385,857,6928,5
delhi,1128,2863,1603,423,910,6927,5
dishy,1128,2239,1021,423,2116,6927,5
lidah,1046,2239,774,2214,654,6927,5
mysel,1225,458,1021,3252,971,6927,5
piero,1184,2239,1421,1225,857,6926,5
areic,1698,1543,1421,1963,300,6925,5
blirt,1555,1193,1668,1225,1284,6925,5
courb,1512,3069,990,1225,129,6925,5
dylan,1128,458,1603,2214,1522,6925,5
glory,965,1193,1426,1225,2116,6925,5
thoke,1264,927,1426,628,2679,6924,5
duply,1128,1824,560,1295,2116,6923,5
frize,847,1543,1668,186,2679,6923,5
stopa,2206,403,1426,526,2362,6923,5
tigon,1264,2239,616,1282,1522,6923,5
whole,596,927,1426,1295,2679,6923,5
ruthe,948,1824,1048,423,2679,6922,5
myths,1225,458,1048,423,3767,6921,5
rubin,948,1824,664,1963,1522,6921,5
lydie,1046,458,774,1963,2679,6920,5
newsy,647,2863,349,945,2116,6920,5
oracy,532,1543,1959,770,2116,6920,5
snivy,2206,671,1668,259,2116,6920,5
mundt,1225,1824,1757,829,1284,6919,5
ncmos,647,338,885,1282,3767,6919,5
xenic,36,2863,1757,1963,300,6919,5
nould,647,3069,990,1295,917,6918,5
osler,532,341,1603,3252,1190,6918,5
yakut,225,4103,406,899,1284,6917,5
sitch,2206,2239,1048,770,654,6917,5
strix,2206,403,2201,1963,144,6917,5
thuan,1264,927,990,2214,1522,6917,5
turco,1264,1824,2201,770,857,6916,5
zinky,176,2239,1757,628,2116,6916,5
lupin,1046,1824,560,1963,1522,6915,5
zomba,176,3069,885,423,2362,6915,5
orgel,532,1543,616,3252,971,6914,5
sioux,2206,2239,1426,899,144,6914,5
slour,2206,1193,1426,899,1190,6914,5
flipe,847,1193,1668,526,2679,6913,5
sheaf,2206,927,1421,2214,145,6913,5
furth,847,1824,2201,1385,654,6911,5
hypos,844,458,560,1282,3767,6911,5
jolyn,446,3069,1603,271,1522,6911,5
steid,2206,403,1421,1963,917,6910,5
viand,404,2239,1959,1391,917,6910,5
ashet,1698,341,334,3252,1284,6909,5
compd,1512,3069,885,526,917,6909,5
micky,1225,2239,701,628,2116,6909,5
groma,965,1543,1426,612,2362,6908,5
jumna,446,1824,885,1391,2362,6908,5
orbed,532,1543,664,3252,917,6908,5
scove,2206,338,1426,259,2679,6908,5
shuba,2206,927,990,423,2362,6908,5
chart,1512,927,1959,1225,1284,6907,5
crank,1512,1543,1959,1391,502,6907,5
bumpy,1555,1824,885,526,2116,6906,5
stowe,2206,403,1426,192,2679,6906,5
puist,1184,1824,1668,945,1284,6905,5
urnal,420,1543,1757,2214,971,6905,5
grimy,965,1543,1668,612,2116,6904,5
pedro,1184,2863,774,1225,857,6903,5
reich,948,2863,1668,770,654,6903,5
adige,1698,245,1668,612,2679,6902,5
compi,1512,3069,885,526,910,6902,5
kumar,789,1824,885,2214,1190,6902,5
spoil,2206,336,1426,1963,971,6902,5
tyken,1264,458,406,3252,1522,6902,5
muton,1225,1824,1048,1282,1522,6901,5
swart,2206,226,1959,1225,1284,6900,5
zingy,176,2239,1757,612,2116,6900,5
elora,693,1193,1426,1225,2362,6899,5
olena,532,1193,1421,1391,2362,6899,5
gutsy,965,1824,1048,945,2116,6898,5
owlet,532,226,1603,3252,1284,6897,5
speil,2206,336,1421,1963,971,6897,5
alyse,1698,1193,381,945,2679,6896,5
cushy,1512,1824,1021,423,2116,6896,5
liang,1046,2239,1959,1391,261,6896,5
doubt,1128,3069,990,423,1284,6894,5
erika,693,1543,1668,628,2362,6894,5
multo,1225,1824,1603,1385,857,6894,5
clast,1512,1193,1959,945,1284,6893,5
ocate,532,338,1959,1385,2679,6893,5
oleta,532,1193,1421,1385,2362,6893,5
skyed,2206,137,381,3252,917,6893,5
whaly,596,927,1959,1295,2116,6893,5
chiba,1512,927,1668,423,2362,6892,5
dompt,1128,3069,885,526,1284,6892,5
ketoi,789,2863,1048,1282,910,6892,5
arest,1698,1543,1421,945,1284,6891,5
grofe,965,1543,1426,278,2679,6891,5
thrap,1264,927,2201,2214,285,6891,5
guard,965,1824,1959,1225,917,6890,5
lugar,1046,1824,616,2214,1190,6890,5
fiche,847,2239,701,423,2679,6889,5
lieut,1046,2239,1421,899,1284,6889,5
heinz,844,2863,1668,1391,122,6888,5
klein,789,1193,1421,1963,1522,6888,5
munro,1225,1824,1757,1225,857,6888,5
sylva,2206,458,1603,259,2362,6888,5
asker,1698,341,406,3252,1190,6887,5
bleak,1555,1193,1421,2214,502,6885,5
shayn,2206,927,1959,271,1522,6885,5
wacko,596,4103,701,628,857,6885,5
acker,1698,338,406,3252,1190,6884,5
khieu,789,927,1668,3252,247,6883,5
lemur,1046,2863,885,899,1190,6883,5
shiro,2206,927,1668,1225,857,6883,5
olean,532,1193,1421,2214,1522,6882,5
budgy,1555,1824,774,612,2116,6881,5
iglus,473,139,1603,899,3767,6881,5
bough,1555,3069,990,612,654,6880,5
oxids,532,83,1668,829,3767,6879,5
vefry,404,2863,271,1225,2116,6879,5
shrog,2206,927,2201,1282,261,6877,5
slipt,2206,1193,1668,526,1284,6877,5
stand,2206,403,1959,1391,917,6876,5
vital,404,2239,1048,2214,971,6876,5
cloky,1512,1193,1426,628,2116,6875,5
glome,965,1193,1426,612,2679,6875,5
snath,2206,671,1959,1385,654,6875,5
tropy,1264,1543,1426,526,2116,6875,5
auvil,1698,1824,417,1963,971,6873,5
kevon,789,2863,417,1282,1522,6873,5
grove,965,1543,1426,259,2679,6872,5
lithy,1046,2239,1048,423,2116,6872,5
wroke,596,1543,1426,628,2679,6872,5
cotyl,1512,3069,1048,271,971,6871,5
lycus,1046,458,701,899,3767,6871,5
atory,1698,403,1426,1225,2116,6868,5
picky,1184,2239,701,628,2116,6868,5
trefa,1264,1543,1421,278,2362,6868,5
abdel,1698,172,774,3252,971,6867,5
showy,2206,927,1426,192,2116,6867,5
would,596,3069,990,1295,917,6867,5
aview,1698,126,1668,3252,122,6866,5
drupe,1128,1543,990,526,2679,6866,5
zelig,176,2863,1603,1963,261,6866,5
flear,847,1193,1421,2214,1190,6865,5
fruin,847,1543,990,1963,1522,6865,5
nexal,647,2863,170,2214,971,6865,5
unkey,420,671,406,3252,2116,6865,5
nomic,647,3069,885,1963,300,6864,5
sloth,2206,1193,1426,1385,654,6864,5
flyer,847,1193,381,3252,1190,6863,5
unled,420,671,1603,3252,917,6863,5
shend,2206,927,1421,1391,917,6862,5
dunlo,1128,1824,1757,1295,857,6861,5
elisa,693,1193,1668,945,2362,6861,5
glaky,965,1193,1959,628,2116,6861,5
nevil,647,2863,417,1963,971,6861,5
puton,1184,1824,1048,1282,1522,6860,5
timor,1264,2239,885,1282,1190,6860,5
zlote,176,1193,1426,1385,2679,6859,5
femic,847,2863,885,1963,300,6858,5
scopa,2206,338,1426,526,2362,6858,5
pubal,1184,1824,664,2214,971,6857,5
votaw,404,3069,1048,2214,122,6857,5
hemic,844,2863,885,1963,300,6855,5
musha,1225,1824,1021,423,2362,6855,5
zoque,176,3069,32,899,2679,6855,5
naumk,647,4103,990,612,502,6854,5
sigyn,2206,2239,616,271,1522,6854,5
hoick,844,3069,1668,770,502,6853,5
kurth,789,1824,2201,1385,654,6853,5
sicht,2206,2239,701,423,1284,6853,5
tumid,1264,1824,885,1963,917,6853,5
tusky,1264,1824,1021,628,2116,6853,5
whore,596,927,1426,1225,2679,6853,5
burck,1555,1824,2201,770,502,6852,5
grint,965,1543,1668,1391,1284,6851,5
cheka,1512,927,1421,628,2362,6850,5
hyden,844,458,774,3252,1522,6850,5
wurst,596,1824,2201,945,1284,6850,5
novak,647,3069,417,2214,502,6849,5
plion,1184,1193,1668,1282,1522,6849,5
treva,1264,1543,1421,259,2362,6849,5
copht,1512,3069,560,423,1284,6848,5
minco,1225,2239,1757,770,857,6848,5
olwen,532,1193,349,3252,1522,6848,5
claut,1512,1193,1959,899,1284,6847,5
cloak,1512,1193,1426,2214,502,6847,5
burgh,1555,1824,2201,612,654,6846,5
lafox,1046,4103,271,1282,144,6846,5
hemol,844,2863,885,1282,971,6845,5
ilona,473,1193,1426,1391,2362,6845,5
imler,473,327,1603,3252,1190,6845,5
juked,446,1824,406,3252,917,6845,5
knows,789,671,1426,192,3767,6845,5
nidal,647,2239,774,2214,971,6845,5
blent,1555,1193,1421,1391,1284,6844,5
declo,1128,2863,701,1295,857,6844,5
leigh,1046,2863,1668,612,654,6843,5
pudsy,1184,1824,774,945,2116,6843,5
agron,1698,139,2201,1282,1522,6842,5
gravy,965,1543,1959,259,2116,6842,5
rumal,948,1824,885,2214,971,6842,5
lubke,1046,1824,664,628,2679,6841,5
uncos,420,671,701,1282,3767,6841,5
akron,1698,137,2201,1282,1522,6840,5
dirck,1128,2239,2201,770,502,6840,5
hobic,844,3069,664,1963,300,6840,5
arbil,1698,1543,664,1963,971,6839,5
choga,1512,927,1426,612,2362,6839,5
cuero,1512,1824,1421,1225,857,6839,5
spuke,2206,336,990,628,2679,6839,5
debut,1128,2863,664,899,1284,6838,5
ducal,1128,1824,701,2214,971,6838,5
adure,1698,245,990,1225,2679,6837,5
cough,1512,3069,990,612,654,6837,5
nafud,647,4103,271,899,917,6837,5
rudge,948,1824,774,612,2679,6837,5
trinl,1264,1543,1668,1391,971,6837,5
zadok,176,4103,774,1282,502,6837,5
atoke,1698,403,1426,628,2679,6834,5
byram,1555,458,2201,2214,406,6834,5
chema,1512,927,1421,612,2362,6834,5
yutan,225,1824,1048,2214,1522,6833,5
kench,789,2863,1757,770,654,6833,5
nodab,647,3069,774,2214,129,6833,5
redip,948,2863,774,1963,285,6833,5
hogni,844,3069,616,1391,910,6830,5
abime,1698,172,1668,612,2679,6829,5
avron,1698,126,2201,1282,1522,6829,5
hymie,844,458,885,1963,2679,6829,5
nikep,647,2239,406,3252,285,6829,5
nucla,647,1824,701,1295,2362,6829,5
avoue,1698,126,1426,899,2679,6828,5
fulwa,847,1824,1603,192,2362,6828,5
khair,789,927,1959,1963,1190,6828,5
quoin,93,1824,1426,1963,1522,6828,5
swimy,2206,226,1668,612,2116,6828,5
dumka,1128,1824,885,628,2362,6827,5
miaow,1225,2239,1959,1282,122,6827,5
turki,1264,1824,2201,628,910,6827,5
becht,1555,2863,701,423,1284,6826,5
gleit,965,1193,1421,1963,1284,6826,5
hctds,844,338,1048,829,3767,6826,5
wyled,596,458,1603,3252,917,6826,5
gipsy,965,2239,560,945,2116,6825,5
bucky,1555,1824,701,628,2116,6824,5
juicy,446,1824,1668,770,2116,6824,5
pocul,1184,3069,701,899,971,6824,5
prent,1184,1543,1421,1391,1284,6823,5
spume,2206,336,990,612,2679,6823,5
unite,420,671,1668,1385,2679,6823,5
alert,1698,1193,1421,1225,1284,6821,5
bilch,1555,2239,1603,770,654,6821,5
mufty,1225,1824,271,1385,2116,6821,5
niort,647,2239,1426,1225,1284,6821,5
oshea,532,341,334,3252,2362,6821,5
vidar,404,2239,774,2214,1190,6821,5
punct,1184,1824,1757,770,1284,6819,5
shark,2206,927,1959,1225,502,6819,5
gripy,965,1543,1668,526,2116,6818,5
urial,420,1543,1668,2214,971,6816,5
asher,1698,341,334,3252,1190,6815,5
fiend,847,2239,1421,1391,917,6815,5
hepza,844,2863,560,186,2362,6815,5
outly,532,1824,1048,1295,2116,6815,5
twila,1264,226,1668,1295,2362,6815,5
fraik,847,1543,1959,1963,502,6814,5
jecon,446,2863,701,1282,1522,6814,5
musky,1225,1824,1021,628,2116,6814,5
quave,93,1824,1959,259,2679,6814,5
rojak,948,3069,81,2214,502,6814,5
bldge,1555,1193,774,612,2679,6813,5
hynek,844,458,1757,3252,502,6813,5
acher,1698,338,334,3252,1190,6812,5
dicky,1128,2239,701,628,2116,6812,5
gnide,965,671,1668,829,2679,6812,5
limpy,1046,2239,885,526,2116,6812,5
snort,2206,671,1426,1225,1284,6812,5
kyloe,789,458,1603,1282,2679,6811,5
scand,2206,338,1959,1391,917,6811,5
skart,2206,137,1959,1225,1284,6811,5
quail,93,1824,1959,1963,971,6810,5
ziega,176,2239,1421,612,2362,6810,5
gyral,965,458,2201,2214,971,6809,5
redig,948,2863,774,1963,261,6809,5
rhode,948,927,1426,829,2679,6809,5
topsl,1264,3069,560,945,971,6809,5
doyst,1128,3069,381,945,1284,6807,5
flory,847,1193,1426,1225,2116,6807,5
recti,948,2863,701,1385,910,6807,5
sheol,2206,927,1421,1282,971,6807,5
shawn,2206,927,1959,192,1522,6806,5
brith,1555,1543,1668,1385,654,6805,5
abode,1698,172,1426,829,2679,6804,5
stupe,2206,403,990,526,2679,6804,5
owler,532,226,1603,3252,1190,6803,5
remix,948,2863,885,1963,144,6803,5
theda,1264,927,1421,829,2362,6803,5
urgel,420,1543,616,3252,971,6802,5
bilow,1555,2239,1603,1282,122,6801,5
humit,844,1824,885,1963,1284,6800,5
rolph,948,3069,1603,526,654,6800,5
akule,1698,137,990,1295,2679,6799,5
choil,1512,927,1426,1963,971,6799,5
clari,1512,1193,1959,1225,910,6799,5
dwain,1128,226,1959,1963,1522,6798,5
phagy,1184,927,1959,612,2116,6798,5
shunt,2206,927,990,1391,1284,6798,5
eloin,693,1193,1426,1963,1522,6797,5
haymo,844,4103,381,612,857,6797,5
sneap,2206,671,1421,2214,285,6797,5
apery,1698,336,1421,1225,2116,6796,5
ouzel,532,1824,217,3252,971,6796,5
skiba,2206,137,1668,423,2362,6796,5
awhet,1698,226,334,3252,1284,6794,5
chyle,1512,927,381,1295,2679,6794,5
muhly,1225,1824,334,1295,2116,6794,5
ahern,1698,927,1421,1225,1522,6793,5
alvin,1698,1193,417,1963,1522,6793,5
deluc,1128,2863,1603,899,300,6793,5
dusio,1128,1824,1021,1963,857,6793,5
yourt,225,3069,990,1225,1284,6793,5
amory,1698,327,1426,1225,2116,6792,5
runic,948,1824,1757,1963,300,6792,5
staig,2206,403,1959,1963,261,6792,5
argil,1698,1543,616,1963,971,6791,5
sevum,2206,2863,417,899,406,6791,5
froma,847,1543,1426,612,2362,6790,5
grume,965,1543,990,612,2679,6789,5
rival,948,2239,417,2214,971,6789,5
spilt,2206,336,1668,1295,1284,6789,5
alist,1698,1193,1668,945,1284,6788,5
jacki,446,4103,701,628,910,6788,5
skyte,2206,137,381,1385,2679,6788,5
amery,1698,327,1421,1225,2116,6787,5
gulfy,965,1824,1603,278,2116,6786,5
lygus,1046,458,616,899,3767,6786,5
duhat,1128,1824,334,2214,1284,6784,5
goyim,965,3069,381,1963,406,6784,5
josip,446,3069,1021,1963,285,6784,5
alkin,1698,1193,406,1963,1522,6782,5
chint,1512,927,1668,1391,1284,6782,5
rhein,948,927,1421,1963,1522,6781,5
untie,420,671,1048,1963,2679,6781,5
mogul,1225,3069,616,899,971,6780,5
befur,1555,2863,271,899,1190,6778,5
sciot,2206,338,1668,1282,1284,6778,5
shado,2206,927,1959,829,857,6778,5
tosch,1264,3069,1021,770,654,6778,5
duson,1128,1824,1021,1282,1522,6777,5
stern,2206,403,1421,1225,1522,6777,5
cupid,1512,1824,560,1963,917,6776,5
hodur,844,3069,774,899,1190,6776,5
grand,965,1543,1959,1391,917,6775,5
delph,1128,2863,1603,526,654,6774,5
jehad,446,2863,334,2214,917,6774,5
ulnar,420,1193,1757,2214,1190,6774,5
fotui,847,3069,1048,899,910,6773,5
hucar,844,1824,701,2214,1190,6773,5
nesto,647,2863,1021,1385,857,6773,5
whame,596,927,1959,612,2679,6773,5
rohun,948,3069,334,899,1522,6772,5
brawn,1555,1543,1959,192,1522,6771,5
junky,446,1824,1757,628,2116,6771,5
licha,1046,2239,701,423,2362,6771,5
aflex,1698,73,1603,3252,144,6770,5
agony,1698,139,1426,1391,2116,6770,5
dougl,1128,3069,990,612,971,6770,5
gleda,965,1193,1421,829,2362,6770,5
privy,1184,1543,1668,259,2116,6770,5
dujan,1128,1824,81,2214,1522,6769,5
hugin,844,1824,616,1963,1522,6769,5
lynde,1046,458,1757,829,2679,6769,5
fname,847,671,1959,612,2679,6768,5
grani,965,1543,1959,1391,910,6768,5
sight,2206,2239,616,423,1284,6768,5
sulfo,2206,1824,1603,278,857,6768,5
chaim,1512,927,1959,1963,406,6767,5
drent,1128,1543,1421,1391,1284,6767,5
jambi,446,4103,885,423,910,6767,5
pigmy,1184,2239,616,612,2116,6767,5
rusma,948,1824,1021,612,2362,6767,5
zigan,176,2239,616,2214,1522,6767,5
motch,1225,3069,1048,770,654,6766,5
sheld,2206,927,1421,1295,917,6766,5
toxic,1264,3069,170,1963,300,6766,5
vigny,404,2239,616,1391,2116,6766,5
their,1264,927,1421,1963,1190,6765,5
brunt,1555,1543,990,1391,1284,6763,5
bunco,1555,1824,1757,770,857,6763,5
idler,473,245,1603,3252,1190,6763,5
nigua,647,2239,616,899,2362,6763,5
stogy,2206,403,1426,612,2116,6763,5
stomy,2206,403,1426,612,2116,6763,5
crith,1512,1543,1668,1385,654,6762,5
grati,965,1543,1959,1385,910,6762,5
huari,844,1824,1959,1225,910,6762,5
lenzi,1046,2863,1757,186,910,6762,5
lukin,1046,1824,406,1963,1522,6761,5
cumby,1512,1824,885,423,2116,6760,5
onset,532,671,1021,3252,1284,6760,5
recip,948,2863,701,1963,285,6760,5
amoke,1698,327,1426,628,2679,6758,5
yermo,225,2863,2201,612,857,6758,5
vidry,404,2239,774,1225,2116,6758,5
ulcer,420,1193,701,3252,1190,6756,5
shorl,2206,927,1426,1225,971,6755,5
kopaz,789,3069,560,2214,122,6754,5
recto,948,2863,701,1385,857,6754,5
brost,1555,1543,1426,945,1284,6753,5
chopa,1512,927,1426,526,2362,6753,5
dugal,1128,1824,616,2214,971,6753,5
julid,446,1824,1603,1963,917,6753,5
riyal,948,2239,381,2214,971,6753,5
aveny,1698,126,1421,1391,2116,6752,5
clova,1512,1193,1426,259,2362,6752,5
myrah,1225,458,2201,2214,654,6752,5
cloam,1512,1193,1426,2214,406,6751,5
hijra,844,2239,81,1225,2362,6751,5
sherl,2206,927,1421,1225,971,6750,5
thrax,1264,927,2201,2214,144,6750,5
ankle,1698,671,406,1295,2679,6749,5
enows,693,671,1426,192,3767,6749,5
fondu,847,3069,1757,829,247,6749,5
bicol,1555,2239,701,1282,971,6748,5
biham,1555,2239,334,2214,406,6748,5
brest,1555,1543,1421,945,1284,6748,5
urged,420,1543,616,3252,917,6748,5
vicar,404,2239,701,2214,1190,6748,5
cleva,1512,1193,1421,259,2362,6747,5
islay,473,341,1603,2214,2116,6747,5
touch,1264,3069,990,770,654,6747,5
claro,1512,1193,1959,1225,857,6746,5
cleam,1512,1193,1421,2214,406,6746,5
steak,2206,403,1421,2214,502,6746,5
stroh,2206,403,2201,1282,654,6746,5
elida,693,1193,1668,829,2362,6745,5
wrive,596,1543,1668,259,2679,6745,5
shang,2206,927,1959,1391,261,6744,5
theca,1264,927,1421,770,2362,6744,5
alton,1698,1193,1048,1282,1522,6743,5
flaky,847,1193,1959,628,2116,6743,5
tengu,1264,2863,1757,612,247,6743,5
fjare,847,32,1959,1225,2679,6742,5
griot,965,1543,1668,1282,1284,6742,5
lendu,1046,2863,1757,829,247,6742,5
shout,2206,927,1426,899,1284,6742,5
swipy,2206,226,1668,526,2116,6742,5
trudy,1264,1543,990,829,2116,6742,5
snirl,2206,671,1668,1225,971,6741,5
badju,1555,4103,774,61,247,6740,5
dubai,1128,1824,664,2214,910,6740,5
lundt,1046,1824,1757,829,1284,6740,5
fubar,847,1824,664,2214,1190,6739,5
argid,1698,1543,616,1963,917,6737,5
entia,693,671,1048,1963,2362,6737,5
felch,847,2863,1603,770,654,6737,5
fudge,847,1824,774,612,2679,6736,5
yacht,225,4103,701,423,1284,6736,5
bedog,1555,2863,774,1282,261,6735,5
duroc,1128,1824,2201,1282,300,6735,5
jacko,446,4103,701,628,857,6735,5
neagh,647,2863,1959,612,654,6735,5
joust,446,3069,990,945,1284,6734,5
squeg,2206,25,990,3252,261,6734,5
imlay,473,327,1603,2214,2116,6733,5
gleir,965,1193,1421,1963,1190,6732,5
pryse,1184,1543,381,945,2679,6732,5
bodhi,1555,3069,774,423,910,6731,5
gimpy,965,2239,885,526,2116,6731,5
nacho,647,4103,701,423,857,6731,5
meung,1225,2863,990,1391,261,6730,5
oidal,532,2239,774,2214,971,6730,5
akure,1698,137,990,1225,2679,6729,5
anoil,1698,671,1426,1963,971,6729,5
despr,1128,2863,1021,526,1190,6728,5
filth,847,2239,1603,1385,654,6728,5
yusem,225,1824,1021,3252,406,6728,5
lindo,1046,2239,1757,829,857,6728,5
mintz,1225,2239,1757,1385,122,6728,5
thraw,1264,927,2201,2214,122,6728,5
triol,1264,1543,1668,1282,971,6728,5
chiam,1512,927,1668,2214,406,6727,5
flamy,847,1193,1959,612,2116,6727,5
styan,2206,403,381,2214,1522,6726,5
alwin,1698,1193,349,1963,1522,6725,5
potch,1184,3069,1048,770,654,6725,5
sumpt,2206,1824,885,526,1284,6725,5
blind,1555,1193,1668,1391,917,6724,5
fgrep,847,139,2201,3252,285,6724,5
typer,1264,458,560,3252,1190,6724,5
bejig,1555,2863,81,1963,261,6723,5
cgiar,1512,139,1668,2214,1190,6723,5
drusy,1128,1543,990,945,2116,6722,5
luton,1046,1824,1048,1282,1522,6722,5
alyce,1698,1193,381,770,2679,6721,5
crunt,1512,1543,990,1391,1284,6720,5
field,847,2239,1421,1295,917,6719,5
sling,2206,1193,1668,1391,261,6719,5
spirt,2206,336,1668,1225,1284,6719,5
squat,2206,25,990,2214,1284,6719,5
dubhe,1128,1824,664,423,2679,6718,5
nicad,647,2239,701,2214,917,6718,5
slonk,2206,1193,1426,1391,502,6718,5
ditzy,1128,2239,1048,186,2116,6717,5
dusky,1128,1824,1021,628,2116,6717,5
kimon,789,2239,885,1282,1522,6717,5
mohur,1225,3069,334,899,1190,6717,5
pheal,1184,927,1421,2214,971,6717,5
quica,93,1824,1668,770,2362,6717,5
scorn,2206,338,1426,1225,1522,6717,5
alson,1698,1193,1021,1282,1522,6716,5
hield,844,2239,1421,1295,917,6716,5
ogler,532,139,1603,3252,1190,6716,5
piqua,1184,2239,32,899,2362,6716,5
graip,965,1543,1959,1963,285,6715,5
grano,965,1543,1959,1391,857,6715,5
yurik,225,1824,2201,1963,502,6715,5
scald,2206,338,1959,1295,917,6715,5
jambo,446,4103,885,423,857,6714,5
layup,1046,4103,381,899,285,6714,5
wiyat,596,2239,381,2214,1284,6714,5
floit,847,1193,1426,1963,1284,6713,5
spald,2206,336,1959,1295,917,6713,5
bluma,1555,1193,990,612,2362,6712,5
dream,1128,1543,1421,2214,406,6712,5
spoky,2206,336,1426,628,2116,6712,5
venom,404,2863,1757,1282,406,6712,5
crost,1512,1543,1426,945,1284,6710,5
glead,965,1193,1421,2214,917,6710,5
arbon,1698,1543,664,1282,1522,6709,5
limby,1046,2239,885,423,2116,6709,5
orant,532,1543,1959,1391,1284,6709,5
mouch,1225,3069,990,770,654,6708,5
ative,1698,403,1668,259,2679,6707,5
brout,1555,1543,1426,899,1284,6707,5
mulct,1225,1824,1603,770,1284,6706,5
squin,2206,25,990,1963,1522,6706,5
crest,1512,1543,1421,945,1284,6705,5
dumah,1128,1824,885,2214,654,6705,5
lampf,1046,4103,885,526,145,6705,5
ligon,1046,2239,616,1282,1522,6705,5
hizar,844,2239,217,2214,1190,6704,5
yirth,225,2239,2201,1385,654,6704,5
foulk,847,3069,990,1295,502,6703,5
smoky,2206,327,1426,628,2116,6703,5
vibex,404,2239,664,3252,144,6703,5
shult,2206,927,990,1295,1284,6702,5
inset,473,671,1021,3252,1284,6701,5
stube,2206,403,990,423,2679,6701,5
anury,1698,671,990,1225,2116,6700,5
chazy,1512,927,1959,186,2116,6700,5
pucka,1184,1824,701,628,2362,6699,5
dewax,1128,2863,349,2214,144,6698,5
whiny,596,927,1668,1391,2116,6698,5
fique,847,2239,32,899,2679,6696,5
froid,847,1543,1426,1963,917,6696,5
orman,532,1543,885,2214,1522,6696,5
sherd,2206,927,1421,1225,917,6696,5
busti,1555,1824,1021,1385,910,6695,5
recut,948,2863,701,899,1284,6695,5
lysed,1046,458,1021,3252,917,6694,5
zrike,176,1543,1668,628,2679,6694,5
align,1698,1193,1668,612,1522,6693,5
chati,1512,927,1959,1385,910,6693,5
julio,446,1824,1603,1963,857,6693,5
hadji,844,4103,774,61,910,6692,5
voust,404,3069,990,945,1284,6692,5
whity,596,927,1668,1385,2116,6692,5
funic,847,1824,1757,1963,300,6691,5
butic,1555,1824,1048,1963,300,6690,5
mylar,1225,458,1603,2214,1190,6690,5
mingo,1225,2239,1757,612,857,6690,5
picot,1184,2239,701,1282,1284,6690,5
eriha,693,1543,1668,423,2362,6689,5
niche,647,2239,701,423,2679,6689,5
ridgy,948,2239,774,612,2116,6689,5
sheri,2206,927,1421,1225,910,6689,5
uplay,420,336,1603,2214,2116,6689,5
myron,1225,458,2201,1282,1522,6688,5
kreil,789,1543,1421,1963,971,6687,5
chilt,1512,927,1668,1295,1284,6686,5
globe,965,1193,1426,423,2679,6686,5
scaut,2206,338,1959,899,1284,6686,5
skint,2206,137,1668,1391,1284,6686,5
swati,2206,226,1959,1385,910,6686,5
uhlan,420,927,1603,2214,1522,6686,5
wilno,596,2239,1603,1391,857,6686,5
femur,847,2863,885,899,1190,6684,5
lyken,1046,458,406,3252,1522,6684,5
owned,532,226,1757,3252,917,6684,5
ploid,1184,1193,1426,1963,917,6683,5
mowth,1225,3069,349,1385,654,6682,5
froze,847,1543,1426,186,2679,6681,5
lofti,1046,3069,271,1385,910,6681,5
ovate,532,126,1959,1385,2679,6681,5
query,93,1824,1421,1225,2116,6679,5
speak,2206,336,1421,2214,502,6679,5
blert,1555,1193,1421,1225,1284,6678,5
vidua,404,2239,774,899,2362,6678,5
ouvre,532,1824,417,1225,2679,6677,5
punkt,1184,1824,1757,628,1284,6677,5
situp,2206,2239,1048,899,285,6677,5
soyuz,2206,3069,381,899,122,6677,5
haeju,844,4103,1421,61,247,6676,5
items,473,403,1421,612,3767,6676,5
dvina,1128,126,1668,1391,2362,6675,5
swoln,2206,226,1426,1295,1522,6675,5
chiot,1512,927,1668,1282,1284,6673,5
yapok,225,4103,560,1282,502,6672,5
mchen,1225,338,334,3252,1522,6671,5
yuman,225,1824,885,2214,1522,6670,5
stefa,2206,403,1421,278,2362,6670,5
guild,965,1824,1668,1295,917,6669,5
phoca,1184,927,1426,770,2362,6669,5
cibol,1512,2239,664,1282,971,6668,5
minsk,1225,2239,1757,945,502,6668,5
vodun,404,3069,774,899,1522,6668,5
vouli,404,3069,990,1295,910,6668,5
witha,596,2239,1048,423,2362,6668,5
pouch,1184,3069,990,770,654,6667,5
crang,1512,1543,1959,1391,261,6666,5
okays,532,137,1959,271,3767,6666,5
cetyl,1512,2863,1048,271,971,6665,5
golub,965,3069,1603,899,129,6665,5
pinko,1184,2239,1757,628,857,6665,5
pliam,1184,1193,1668,2214,406,6665,5
tomsk,1264,3069,885,945,502,6665,5
twiny,1264,226,1668,1391,2116,6665,5
crout,1512,1543,1426,899,1284,6664,5
amble,1698,327,664,1295,2679,6663,5
imare,473,327,1959,1225,2679,6663,5
slaum,2206,1193,1959,899,406,6663,5
ulose,420,1193,1426,945,2679,6663,5
oxims,532,83,1668,612,3767,6662,5
prudy,1184,1543,990,829,2116,6662,5
argon,1698,1543,616,1282,1522,6661,5
devol,1128,2863,417,1282,971,6661,5
jacob,446,4103,701,1282,129,6661,5
welsh,596,2863,1603,945,654,6661,5
muang,1225,1824,1959,1391,261,6660,5
brink,1555,1543,1668,1391,502,6659,5
noemi,647,3069,1421,612,910,6659,5
trank,1264,1543,1959,1391,502,6659,5
athel,1698,403,334,3252,971,6658,5
nifty,647,2239,271,1385,2116,6658,5
plume,1184,1193,990,612,2679,6658,5
rebut,948,2863,664,899,1284,6658,5
awoke,1698,226,1426,628,2679,6657,5
becki,1555,2863,701,628,910,6657,5
brash,1555,1543,1959,945,654,6656,5
cuing,1512,1824,1668,1391,261,6656,5
ofnps,532,73,1757,526,3767,6655,5
fiord,847,2239,1426,1225,917,6654,5
shaft,2206,927,1959,278,1284,6654,5
sixth,2206,2239,170,1385,654,6654,5
hurok,844,1824,2201,1282,502,6653,5
kirch,789,2239,2201,770,654,6653,5
qibla,93,2239,664,1295,2362,6653,5
fleda,847,1193,1421,829,2362,6652,5
lefor,1046,2863,271,1282,1190,6652,5
mbira,1225,172,1668,1225,2362,6652,5
stivy,2206,403,1668,259,2116,6652,5
azure,1698,59,990,1225,2679,6651,5
yetac,225,2863,1048,2214,300,6650,5
steam,2206,403,1421,2214,406,6650,5
acidy,1698,338,1668,829,2116,6649,5
pylar,1184,458,1603,2214,1190,6649,5
pingo,1184,2239,1757,612,857,6649,5
moshi,1225,3069,1021,423,910,6648,5
tushy,1264,1824,1021,423,2116,6648,5
unset,420,671,1021,3252,1284,6648,5
alfin,1698,1193,271,1963,1522,6647,5
rieth,948,2239,1421,1385,654,6647,5
fishy,847,2239,1021,423,2116,6646,5
shtik,2206,927,1048,1963,502,6646,5
blist,1555,1193,1668,945,1284,6645,5
minch,1225,2239,1757,770,654,6645,5
waefu,596,4103,1421,278,247,6645,5
oxane,532,83,1959,1391,2679,6644,5
rendu,948,2863,1757,829,247,6644,5
elsan,693,1193,1021,2214,1522,6643,5
busto,1555,1824,1021,1385,857,6642,5
hylan,844,458,1603,2214,1522,6641,5
wisha,596,2239,1021,423,2362,6641,5
scent,2206,338,1421,1391,1284,6640,5
thrip,1264,927,2201,1963,285,6640,5
wench,596,2863,1757,770,654,6640,5
amuse,1698,327,990,945,2679,6639,5
kiang,789,2239,1959,1391,261,6639,5
phobe,1184,927,1426,423,2679,6639,5
loewi,1046,3069,1421,192,910,6638,5
spent,2206,336,1421,1391,1284,6638,5
arlyn,1698,1543,1603,271,1522,6637,5
fayum,847,4103,381,899,406,6636,5
lusky,1046,1824,1021,628,2116,6635,5
zadoc,176,4103,774,1282,300,6635,5
dicot,1128,2239,701,1282,1284,6634,5
inter,473,671,1048,3252,1190,6634,5
repic,948,2863,560,1963,300,6634,5
funli,847,1824,1757,1295,910,6633,5
giamo,965,2239,1959,612,857,6632,5
ricky,948,2239,701,628,2116,6632,5
olein,532,1193,1421,1963,1522,6631,5
sicko,2206,2239,701,628,857,6631,5
aholt,1698,927,1426,1295,1284,6630,5
mucid,1225,1824,701,1963,917,6630,5
slack,2206,1193,1959,770,502,6630,5
slept,2206,1193,1421,526,1284,6630,5
elvia,693,1193,417,1963,2362,6628,5
skyre,2206,137,381,1225,2679,6628,5
fruit,847,1543,990,1963,1284,6627,5
khoin,789,927,1426,1963,1522,6627,5
oread,532,1543,1421,2214,917,6627,5
pinsk,1184,2239,1757,945,502,6627,5
auxil,1698,1824,170,1963,971,6626,5
fusil,847,1824,1021,1963,971,6626,5
yulma,225,1824,1603,612,2362,6626,5
minow,1225,2239,1757,1282,122,6625,5
knape,789,671,1959,526,2679,6624,5
gilud,965,2239,1603,899,917,6623,5
dumba,1128,1824,885,423,2362,6622,5
bunko,1555,1824,1757,628,857,6621,5
cryal,1512,1543,381,2214,971,6621,5
quaky,93,1824,1959,628,2116,6620,5
synod,2206,458,1757,1282,917,6620,5
suevi,2206,1824,1421,259,910,6620,5
bundh,1555,1824,1757,829,654,6619,5
trixy,1264,1543,1668,26,2116,6617,5
chirt,1512,927,1668,1225,1284,6616,5
crink,1512,1543,1668,1391,502,6616,5
freon,847,1543,1421,1282,1522,6615,5
asked,1698,341,406,3252,917,6614,5
crash,1512,1543,1959,945,654,6613,5
sluig,2206,1193,990,1963,261,6613,5
scopy,2206,338,1426,526,2116,6612,5
renzo,948,2863,1757,186,857,6611,5
shipt,2206,927,1668,526,1284,6611,5
snowy,2206,671,1426,192,2116,6611,5
chald,1512,927,1959,1295,917,6610,5
bigod,1555,2239,616,1282,917,6609,5
choky,1512,927,1426,628,2116,6609,5
gront,965,1543,1426,1391,1284,6609,5
mushy,1225,1824,1021,423,2116,6609,5
dichy,1128,2239,701,423,2116,6607,5
twice,1264,226,1668,770,2679,6607,5
ermin,693,1543,885,1963,1522,6606,5
opine,532,336,1668,1391,2679,6606,5
bungo,1555,1824,1757,612,857,6605,5
sworn,2206,226,1426,1225,1522,6605,5
vicua,404,2239,701,899,2362,6605,5
pinch,1184,2239,1757,770,654,6604,5
cuish,1512,1824,1668,945,654,6603,5
kiswa,789,2239,1021,192,2362,6603,5
lydia,1046,458,774,1963,2362,6603,5
adzer,1698,245,217,3252,1190,6602,5
ofays,532,73,1959,271,3767,6602,5
pleon,1184,1193,1421,1282,1522,6602,5
sharp,2206,927,1959,1225,285,6602,5
vidal,404,2239,774,2214,971,6602,5
ahind,1698,927,1668,1391,917,6601,5
blank,1555,1193,1959,1391,502,6600,5
grube,965,1543,990,423,2679,6600,5
inkos,473,671,406,1282,3767,6599,5
mugil,1225,1824,616,1963,971,6599,5
vinod,404,2239,1757,1282,917,6599,5
udale,420,245,1959,1295,2679,6598,5
fload,847,1193,1426,2214,917,6597,5
gusba,965,1824,1021,423,2362,6595,5
clyde,1512,1193,381,829,2679,6594,5
dingo,1128,2239,1757,612,857,6593,5
junot,446,1824,1757,1282,1284,6593,5
dempr,1128,2863,885,526,1190,6592,5
scaur,2206,338,1959,899,1190,6592,5
irked,473,1543,406,3252,917,6591,5
thoma,1264,927,1426,612,2362,6591,5
depth,1128,2863,560,1385,654,6590,5
quoit,93,1824,1426,1963,1284,6590,5
gursh,965,1824,2201,945,654,6589,5
hsian,844,341,1668,2214,1522,6589,5
rizal,948,2239,217,2214,971,6589,5
stuka,2206,403,990,628,2362,6589,5
tough,1264,3069,990,612,654,6589,5
croix,1512,1543,1426,1963,144,6588,5
kishy,789,2239,1021,423,2116,6588,5
zoldi,176,3069,1603,829,910,6587,5
avery,1698,126,1421,1225,2116,6586,5
isled,473,341,1603,3252,917,6586,5
thema,1264,927,1421,612,2362,6586,5
lyrid,1046,458,2201,1963,917,6585,5
indus,473,671,774,899,3767,6584,5
plano,1184,1193,1959,1391,857,6584,5
urman,420,1543,885,2214,1522,6584,5
gemul,965,2863,885,899,971,6583,5
voltz,404,3069,1603,1385,122,6583,5
glaik,965,1193,1959,1963,502,6582,5
libya,1046,2239,664,271,2362,6582,5
choak,1512,927,1426,2214,502,6581,5
dumky,1128,1824,885,628,2116,6581,5
gebur,965,2863,664,899,1190,6581,5
almon,1698,1193,885,1282,1522,6580,5
nutsy,647,1824,1048,945,2116,6580,5
bragi,1555,1543,1959,612,910,6579,5
prank,1184,1543,1959,1391,502,6579,5
updos,420,336,774,1282,3767,6579,5
plato,1184,1193,1959,1385,857,6578,5
shako,2206,927,1959,628,857,6577,5
whute,596,927,990,1385,2679,6577,5
craft,1512,1543,1959,278,1284,6576,5
rdhos,948,245,334,1282,3767,6576,5
ruche,948,1824,701,423,2679,6575,5
ation,1698,403,1668,1282,1522,6573,5
rugal,948,1824,616,2214,971,6573,5
whose,596,927,1426,945,2679,6573,5
cralg,1512,1543,1959,1295,261,6570,5
actin,1698,338,1048,1963,1522,6569,5
turbo,1264,1824,2201,423,857,6569,5
ureal,420,1543,1421,2214,971,6569,5
uvate,420,126,1959,1385,2679,6569,5
gipon,965,2239,560,1282,1522,6568,5
pushy,1184,1824,1021,423,2116,6568,5
sylni,2206,458,1603,1391,910,6568,5
hynde,844,458,1757,829,2679,6567,5
plast,1184,1193,1959,945,1284,6565,5
broth,1555,1543,1426,1385,654,6563,5
nobut,647,3069,664,899,1284,6563,5
snark,2206,671,1959,1225,502,6563,5
bmgte,1555,327,616,1385,2679,6562,5
shamo,2206,927,1959,612,857,6561,5
bunch,1555,1824,1757,770,654,6560,5
ample,1698,327,560,1295,2679,6559,5
breth,1555,1543,1421,1385,654,6558,5
noyau,647,3069,381,2214,247,6558,5
pugil,1184,1824,616,1963,971,6558,5
avoke,1698,126,1426,628,2679,6557,5
clank,1512,1193,1959,1391,502,6557,5
pryce,1184,1543,381,770,2679,6557,5
comdg,1512,3069,885,829,261,6556,5
phyte,1184,927,381,1385,2679,6556,5
duval,1128,1824,417,2214,971,6554,5
bipod,1555,2239,560,1282,917,6553,5
owsen,532,226,1021,3252,1522,6553,5
artic,1698,1543,1048,1963,300,6552,5
kirov,789,2239,2201,1282,41,6552,5
milko,1225,2239,1603,628,857,6552,5
leung,1046,2863,990,1391,261,6551,5
quant,93,1824,1959,1391,1284,6551,5
ripon,948,2239,560,1282,1522,6551,5
atrip,1698,403,2201,1963,285,6550,5
drupa,1128,1543,990,526,2362,6549,5
loxic,1046,3069,170,1963,300,6548,5
drucy,1128,1543,990,770,2116,6547,5
numda,647,1824,885,829,2362,6547,5
alost,1698,1193,1426,945,1284,6546,5
goumi,965,3069,990,612,910,6546,5
tulsi,1264,1824,1603,945,910,6546,5
bogum,1555,3069,616,899,406,6545,5
holub,844,3069,1603,899,129,6544,5
study,2206,403,990,829,2116,6544,5
wirtz,596,2239,2201,1385,122,6543,5
ashed,1698,341,334,3252,917,6542,5
spelt,2206,336,1421,1295,1284,6542,5
teuch,1264,2863,990,770,654,6541,5
bunow,1555,1824,1757,1282,122,6540,5
chard,1512,927,1959,1225,917,6540,5
spath,2206,336,1959,1385,654,6540,5
ached,1698,338,334,3252,917,6539,5
guiro,965,1824,1668,1225,857,6539,5
resht,948,2863,1021,423,1284,6539,5
arvid,1698,1543,417,1963,917,6538,5
psora,1184,341,1426,1225,2362,6538,5
smolt,2206,327,1426,1295,1284,6538,5
edroy,693,245,2201,1282,2116,6537,5
ritzy,948,2239,1048,186,2116,6537,5
rusky,948,1824,1021,628,2116,6537,5
nudge,647,1824,774,612,2679,6536,5
sligo,2206,1193,1668,612,857,6536,5
trend,1264,1543,1421,1391,917,6536,5
fugit,847,1824,616,1963,1284,6534,5
chari,1512,927,1959,1225,910,6533,5
eimak,693,2239,885,2214,502,6533,5
smelt,2206,327,1421,1295,1284,6533,5
sward,2206,226,1959,1225,917,6533,5
tucky,1264,1824,701,628,2116,6533,5
osmen,532,341,885,3252,1522,6532,5
fluty,847,1193,990,1385,2116,6531,5
gymel,965,458,885,3252,971,6531,5
sehyo,2206,2863,334,271,857,6531,5
jevon,446,2863,417,1282,1522,6530,5
lycia,1046,458,701,1963,2362,6530,5
gyber,965,458,664,3252,1190,6529,5
louch,1046,3069,990,770,654,6529,5
apfel,1698,336,271,3252,971,6528,5
eliga,693,1193,1668,612,2362,6528,5
hicky,844,2239,701,628,2116,6528,5
limax,1046,2239,885,2214,144,6528,5
shirk,2206,927,1668,1225,502,6528,5
freak,847,1543,1421,2214,502,6527,5
slavi,2206,1193,1959,259,910,6527,5
druze,1128,1543,990,186,2679,6526,5
leuco,1046,2863,990,770,857,6526,5
ictus,473,338,1048,899,3767,6525,5
gledy,965,1193,1421,829,2116,6524,5
anomy,1698,671,1426,612,2116,6523,5
drank,1128,1543,1959,1391,502,6523,5
futon,847,1824,1048,1282,1522,6523,5
queal,93,1824,1421,2214,971,6523,5
digby,1128,2239,616,423,2116,6522,5
glove,965,1193,1426,259,2679,6522,5
jakop,446,4103,406,1282,285,6522,5
thury,1264,927,990,1225,2116,6522,5
dusza,1128,1824,1021,186,2362,6521,5
kisor,789,2239,1021,1282,1190,6521,5
scind,2206,338,1668,1391,917,6520,5
skirt,2206,137,1668,1225,1284,6520,5
anthe,1698,671,1048,423,2679,6519,5
idems,473,245,1421,612,3767,6518,5
rewax,948,2863,349,2214,144,6518,5
whsle,596,927,1021,1295,2679,6518,5
vocab,404,3069,701,2214,129,6517,5
kmole,789,327,1426,1295,2679,6516,5
sclim,2206,338,1603,1963,406,6516,5
odine,532,245,1668,1391,2679,6515,5
chlor,1512,927,1603,1282,1190,6514,5
knute,789,671,990,1385,2679,6514,5
skald,2206,137,1959,1295,917,6514,5
dilog,1128,2239,1603,1282,261,6513,5
unmet,420,671,885,3252,1284,6512,5
bruja,1555,1543,990,61,2362,6511,5
incus,473,671,701,899,3767,6511,5
lingo,1046,2239,1757,612,857,6511,5
phoma,1184,927,1426,612,2362,6511,5
nawob,647,4103,349,1282,129,6510,5
pudgy,1184,1824,774,612,2116,6510,5
arish,1698,1543,1668,945,654,6508,5
elman,693,1193,885,2214,1522,6507,5
gotch,965,3069,1048,770,654,6506,5
grath,965,1543,1959,1385,654,6506,5
jowpy,446,3069,349,526,2116,6506,5
outhe,532,1824,1048,423,2679,6506,5
kenzi,789,2863,1757,186,910,6505,5
lowth,1046,3069,349,1385,654,6503,5
glint,965,1193,1668,1391,1284,6501,5
ihlat,473,927,1603,2214,1284,6501,5
minho,1225,2239,1757,423,857,6501,5
ulnad,420,1193,1757,2214,917,6501,5
alout,1698,1193,1426,899,1284,6500,5
gulix,965,1824,1603,1963,144,6499,5
uriah,420,1543,1668,2214,654,6499,5
usine,420,341,1668,1391,2679,6499,5
choya,1512,927,1426,271,2362,6498,5
strom,2206,403,2201,1282,406,6498,5
wispy,596,2239,1021,526,2116,6498,5
atimy,1698,403,1668,612,2116,6497,5
felup,847,2863,1603,899,285,6497,5
troic,1264,1543,1426,1963,300,6496,5
aleut,1698,1193,1421,899,1284,6495,5
lurch,1046,1824,2201,770,654,6495,5
mucky,1225,1824,701,628,2116,6494,5
shrug,2206,927,2201,899,261,6494,5
aptly,1698,336,1048,1295,2116,6493,5
rhoda,948,927,1426,829,2362,6492,5
front,847,1543,1426,1391,1284,6491,5
milch,1225,2239,1603,770,654,6491,5
slich,2206,1193,1668,770,654,6491,5
wuhan,596,1824,334,2214,1522,6490,5
linsk,1046,2239,1757,945,502,6489,5
rotch,948,3069,1048,770,654,6489,5
nival,647,2239,417,2214,971,6488,5
rehab,948,2863,334,2214,129,6488,5
depoh,1128,2863,560,1282,654,6487,5
rheda,948,927,1421,829,2362,6487,5
stupa,2206,403,990,526,2362,6487,5
snout,2206,671,1426,899,1284,6486,5
welch,596,2863,1603,770,654,6486,5
flyte,847,1193,381,1385,2679,6485,5
wudge,596,1824,774,612,2679,6485,5
abuse,1698,172,990,945,2679,6484,5
andry,1698,671,774,1225,2116,6484,5
grind,965,1543,1668,1391,917,6484,5
sclaw,2206,338,1603,2214,122,6483,5
blond,1555,1193,1426,1391,917,6482,5
blowy,1555,1193,1426,192,2116,6482,5
chivy,1512,927,1668,259,2116,6482,5
nitza,647,2239,1048,186,2362,6482,5
zendo,176,2863,1757,829,857,6482,5
archy,1698,1543,701,423,2116,6481,5
brach,1555,1543,1959,770,654,6481,5
frija,847,1543,1668,61,2362,6481,5
charo,1512,927,1959,1225,857,6480,5
cheam,1512,927,1421,2214,406,6480,5
claud,1512,1193,1959,899,917,6480,5
dumpy,1128,1824,885,526,2116,6479,5
ethos,693,403,334,1282,3767,6479,5
antsy,1698,671,1048,945,2116,6478,5
weism,596,2863,1668,945,406,6478,5
blend,1555,1193,1421,1391,917,6477,5
sport,2206,336,1426,1225,1284,6477,5
timur,1264,2239,885,899,1190,6477,5
hyena,844,458,1421,1391,2362,6476,5
virtu,404,2239,2201,1385,247,6476,5
orban,532,1543,664,2214,1522,6475,5
clapt,1512,1193,1959,526,1284,6474,5
cumol,1512,1824,885,1282,971,6474,5
kongu,789,3069,1757,612,247,6474,5
kraut,789,1543,1959,899,1284,6474,5
quoad,93,1824,1426,2214,917,6474,5
robyn,948,3069,664,271,1522,6474,5
alcid,1698,1193,701,1963,917,6472,5
drovy,1128,1543,1426,259,2116,6472,5
fugal,847,1824,616,2214,971,6472,5
adobe,1698,245,1426,423,2679,6471,5
aldon,1698,1193,774,1282,1522,6469,5
gintz,965,2239,1757,1385,122,6468,5
squit,2206,25,990,1963,1284,6468,5
vison,404,2239,1021,1282,1522,6468,5
wield,596,2239,1421,1295,917,6468,5
midst,1225,2239,774,945,1284,6467,5
linch,1046,2239,1757,770,654,6466,5
phyle,1184,927,381,1295,2679,6466,5
amzel,1698,327,217,3252,971,6465,5
detox,1128,2863,1048,1282,144,6465,5
utile,420,403,1668,1295,2679,6465,5
infos,473,671,271,1282,3767,6464,5
elura,693,1193,990,1225,2362,6463,5
endia,693,671,774,1963,2362,6463,5
wojak,596,3069,81,2214,502,6462,5
stank,2206,403,1959,1391,502,6461,5
synth,2206,458,1757,1385,654,6460,5
umbos,420,327,664,1282,3767,6460,5
oulap,532,1824,1603,2214,285,6458,5
thawy,1264,927,1959,192,2116,6458,5
stoun,2206,403,1426,899,1522,6456,5
digor,1128,2239,616,1282,1190,6455,5
duero,1128,1824,1421,1225,857,6455,5
pecht,1184,2863,701,423,1284,6455,5
pyxie,1184,458,170,1963,2679,6454,5
bikol,1555,2239,406,1282,971,6453,5
dough,1128,3069,990,612,654,6453,5
shing,2206,927,1668,1391,261,6453,5
lynda,1046,458,1757,829,2362,6452,5
lucid,1046,1824,701,1963,917,6451,5
typed,1264,458,560,3252,917,6451,5
yinst,225,2239,1757,945,1284,6450,5
pilch,1184,2239,1603,770,654,6450,5
gloze,965,1193,1426,186,2679,6449,5
khosa,789,927,1426,945,2362,6449,5
tempi,1264,2863,885,526,910,6448,5
enola,693,671,1426,1295,2362,6447,5
ouija,532,1824,1668,61,2362,6447,5
traci,1264,1543,1959,770,910,6446,5
uptie,420,336,1048,1963,2679,6446,5
gytle,965,458,1048,1295,2679,6445,5
tumor,1264,1824,885,1282,1190,6445,5
vyase,404,458,1959,945,2679,6445,5
freya,847,1543,1421,271,2362,6444,5
medoc,1225,2863,774,1282,300,6444,5
miauw,1225,2239,1959,899,122,6444,5
neigh,647,2863,1668,612,654,6444,5
zambo,176,4103,885,423,857,6444,5
ogled,532,139,1603,3252,917,6443,5
rumba,948,1824,885,423,2362,6442,5
unsay,420,671,1021,2214,2116,6442,5
wheat,596,927,1421,2214,1284,6442,5
emina,693,327,1668,1391,2362,6441,5
abrim,1698,172,2201,1963,406,6440,5
ibsen,473,172,1021,3252,1522,6440,5
judex,446,1824,774,3252,144,6440,5
ltzen,1046,403,217,3252,1522,6440,5
oncet,532,671,701,3252,1284,6440,5
reyno,948,2863,381,1391,857,6440,5
glume,965,1193,990,612,2679,6439,5
guest,965,1824,1421,945,1284,6439,5
louhi,1046,3069,990,423,910,6438,5
wakhi,596,4103,406,423,910,6438,5
erato,693,1543,1959,1385,857,6437,5
dubio,1128,1824,664,1963,857,6436,5
fumid,847,1824,885,1963,917,6436,5
etlan,693,403,1603,2214,1522,6435,5
urion,420,1543,1668,1282,1522,6435,5
cypre,1512,458,560,1225,2679,6434,5
dyker,1128,458,406,3252,1190,6434,5
humid,844,1824,885,1963,917,6433,5
husky,844,1824,1021,628,2116,6433,5
swelt,2206,226,1421,1295,1284,6432,5
audri,1698,1824,774,1225,910,6431,5
fream,847,1543,1421,2214,406,6431,5
peuhl,1184,2863,990,423,971,6431,5
lusby,1046,1824,1021,423,2116,6430,5
lushy,1046,1824,1021,423,2116,6430,5
murph,1225,1824,2201,526,654,6430,5
swath,2206,226,1959,1385,654,6430,5
stilo,2206,403,1668,1295,857,6429,5
whein,596,927,1421,1963,1522,6429,5
gyron,965,458,2201,1282,1522,6428,5
often,532,73,1048,3252,1522,6427,5
organ,532,1543,616,2214,1522,6427,5
richy,948,2239,701,423,2116,6427,5
ziska,176,2239,1021,628,2362,6426,5
gland,965,1193,1959,1391,917,6425,5
argot,1698,1543,616,1282,1284,6423,5
giust,965,2239,990,945,1284,6423,5
joerg,446,3069,1421,1225,261,6422,5
pinyl,1184,2239,1757,271,971,6422,5
withy,596,2239,1048,423,2116,6422,5
xylia,36,458,1603,1963,2362,6422,5
blawn,1555,1193,1959,192,1522,6421,5
cleti,1512,1193,1421,1385,910,6421,5
abyed,1698,172,381,3252,917,6420,5
crsab,1512,1543,1021,2214,129,6419,5
glazy,965,1193,1959,186,2116,6419,5
kitab,789,2239,1048,2214,129,6419,5
kusha,789,1824,1021,423,2362,6419,5
onder,532,671,774,3252,1190,6419,5
bring,1555,1543,1668,1391,261,6418,5
hyleg,844,458,1603,3252,261,6418,5
bronk,1555,1543,1426,1391,502,6417,5
fylde,847,458,1603,829,2679,6416,5
metho,1225,2863,1048,423,857,6416,5
vimpa,404,2239,885,526,2362,6416,5
adion,1698,245,1668,1282,1522,6415,5
aydin,1698,458,774,1963,1522,6415,5
intel,473,671,1048,3252,971,6415,5
lesko,1046,2863,1021,628,857,6415,5
chewa,1512,927,1421,192,2362,6414,5
echos,693,338,334,1282,3767,6414,5
blunt,1555,1193,990,1391,1284,6413,5
kursh,789,1824,2201,945,654,6413,5
qurti,93,1824,2201,1385,910,6413,5
ringo,948,2239,1757,612,857,6413,5
brenk,1555,1543,1421,1391,502,6412,5
grahn,965,1543,1959,423,1522,6412,5
libau,1046,2239,664,2214,247,6410,5
aitch,1698,2239,1048,770,654,6409,5
pivot,1184,2239,417,1282,1284,6406,5
wrand,596,1543,1959,1391,917,6406,5
grist,965,1543,1668,945,1284,6405,5
nihal,647,2239,334,2214,971,6405,5
rowth,948,3069,349,1385,654,6405,5
stevy,2206,403,1421,259,2116,6405,5
audix,1698,1824,774,1963,144,6403,5
avoir,1698,126,1426,1963,1190,6403,5
fract,847,1543,1959,770,1284,6403,5
udine,420,245,1668,1391,2679,6403,5
acedy,1698,338,1421,829,2116,6402,5
aequi,1698,2863,32,899,910,6402,5
sclav,2206,338,1603,2214,41,6402,5
petum,1184,2863,1048,899,406,6400,5
prawn,1184,1543,1959,192,1522,6400,5
bshed,1555,341,334,3252,917,6399,5
blanc,1555,1193,1959,1391,300,6398,5
blest,1555,1193,1421,945,1284,6398,5
newby,647,2863,349,423,2116,6398,5
wierd,596,2239,1421,1225,917,6398,5
crapo,1512,1543,1959,526,857,6397,5
ducky,1128,1824,701,628,2116,6397,5
gryde,965,1543,381,829,2679,6397,5
lumpy,1046,1824,885,526,2116,6397,5
shaum,2206,927,1959,899,406,6397,5
ultan,420,1193,1048,2214,1522,6397,5
alcon,1698,1193,701,1282,1522,6396,5
fubsy,847,1824,664,945,2116,6396,5
ovine,532,126,1668,1391,2679,6396,5
phyre,1184,927,381,1225,2679,6396,5
duryl,1128,1824,2201,271,971,6395,5
tempo,1264,2863,885,526,857,6395,5
wisby,596,2239,1021,423,2116,6395,5
wishy,596,2239,1021,423,2116,6395,5
asyle,1698,341,381,1295,2679,6394,5
kiehn,789,2239,1421,423,1522,6394,5
spank,2206,336,1959,1391,502,6394,5
yamph,225,4103,885,526,654,6393,5
weigh,596,2863,1668,612,654,6393,5
adrip,1698,245,2201,1963,285,6392,5
elsin,693,1193,1021,1963,1522,6392,5
prunt,1184,1543,990,1391,1284,6392,5
clark,1512,1193,1959,1225,502,6391,5
lucio,1046,1824,701,1963,857,6391,5
tihwa,1264,2239,334,192,2362,6391,5
unary,420,671,1959,1225,2116,6391,5
encia,693,671,701,1963,2362,6390,5
amove,1698,327,1426,259,2679,6389,5
bruni,1555,1543,990,1391,910,6389,5
nahum,647,4103,334,899,406,6389,5
fotch,847,3069,1048,770,654,6388,5
algid,1698,1193,616,1963,917,6387,5
bulow,1555,1824,1603,1282,122,6386,5
rubye,948,1824,664,271,2679,6386,5
skivy,2206,137,1668,259,2116,6386,5
aynor,1698,458,1757,1282,1190,6385,5
expos,693,83,560,1282,3767,6385,5
quart,93,1824,1959,1225,1284,6385,5
arulo,1698,1543,990,1295,857,6383,5
flint,847,1193,1668,1391,1284,6383,5
teugh,1264,2863,990,612,654,6383,5
prost,1184,1543,1426,945,1284,6382,5
letch,1046,2863,1048,770,654,6381,5
skyla,2206,137,381,1295,2362,6381,5
tikor,1264,2239,406,1282,1190,6381,5
wymer,596,458,885,3252,1190,6381,5
kenji,789,2863,1757,61,910,6380,5
tyika,1264,458,1668,628,2362,6380,5
arimo,1698,1543,1668,612,857,6378,5
erkan,693,1543,406,2214,1522,6378,5
prest,1184,1543,1421,945,1284,6377,5
strop,2206,403,2201,1282,285,6377,5
dumby,1128,1824,885,423,2116,6376,5
oriya,532,1543,1668,271,2362,6376,5
snurt,2206,671,990,1225,1284,6376,5
guaco,965,1824,1959,770,857,6375,5
holgu,844,3069,1603,612,247,6375,5
plath,1184,1193,1959,1385,654,6375,5
chort,1512,927,1426,1225,1284,6374,5
cronk,1512,1543,1426,1391,502,6374,5
fidac,847,2239,774,2214,300,6374,5
scaul,2206,338,1959,899,971,6373,5
prado,1184,1543,1959,829,857,6372,5
viewy,404,2239,1421,192,2116,6372,5
lough,1046,3069,990,612,654,6371,5
roshi,948,3069,1021,423,910,6371,5
vexil,404,2863,170,1963,971,6371,5
uziel,420,59,1668,3252,971,6370,5
chert,1512,927,1421,1225,1284,6369,5
defix,1128,2863,271,1963,144,6369,5
diazo,1128,2239,1959,186,857,6369,5
euton,693,1824,1048,1282,1522,6369,5
ermit,693,1543,885,1963,1284,6368,5
rinch,948,2239,1757,770,654,6368,5
trink,1264,1543,1668,1391,502,6368,5
jakob,446,4103,406,1282,129,6366,5
stalk,2206,403,1959,1295,502,6365,5
trash,1264,1543,1959,945,654,6365,5
gleba,965,1193,1421,423,2362,6364,5
shack,2206,927,1959,770,502,6364,5
thorn,1264,927,1426,1225,1522,6364,5
khula,789,927,990,1295,2362,6363,5
oster,532,341,1048,3252,1190,6363,5
shift,2206,927,1668,278,1284,6363,5
urban,420,1543,664,2214,1522,6363,5
shrub,2206,927,2201,899,129,6362,5
wimpy,596,2239,885,526,2116,6362,5
aliso,1698,1193,1668,945,857,6361,5
altun,1698,1193,1048,899,1522,6360,5
grank,965,1543,1959,1391,502,6360,5
mutic,1225,1824,1048,1963,300,6360,5
cheap,1512,927,1421,2214,285,6359,5
edina,693,245,1668,1391,2362,6359,5
rusot,948,1824,1021,1282,1284,6359,5
ruthy,948,1824,1048,423,2116,6359,5
eruca,693,1543,990,770,2362,6358,5
aztec,1698,59,1048,3252,300,6357,5
blout,1555,1193,1426,899,1284,6357,5
knave,789,671,1959,259,2679,6357,5
nucal,647,1824,701,2214,971,6357,5
otina,532,403,1668,1391,2362,6356,5
chino,1512,927,1668,1391,857,6355,5
fruma,847,1543,990,612,2362,6354,5
edita,693,245,1668,1385,2362,6353,5
gnome,965,671,1426,612,2679,6353,5
symon,2206,458,885,1282,1522,6353,5
yacov,225,4103,701,1282,41,6352,5
squad,2206,25,990,2214,917,6352,5
sibyl,2206,2239,664,271,971,6351,5
divot,1128,2239,417,1282,1284,6350,5
elric,693,1193,2201,1963,300,6350,5
embus,693,327,664,899,3767,6350,5
kicva,789,2239,701,259,2362,6350,5
gushy,965,1824,1021,423,2116,6349,5
kempt,789,2863,885,526,1284,6347,5
linum,1046,2239,1757,899,406,6347,5
oakum,532,4103,406,899,406,6346,5
oncer,532,671,701,3252,1190,6346,5
scovy,2206,338,1426,259,2116,6345,5
drawn,1128,1543,1959,192,1522,6344,5
keogh,789,2863,1426,612,654,6344,5
roybn,948,3069,381,423,1522,6343,5
stond,2206,403,1426,1391,917,6343,5
lahmu,1046,4103,334,612,247,6342,5
lexic,1046,2863,170,1963,300,6342,5
rigby,948,2239,616,423,2116,6342,5
dixon,1128,2239,170,1282,1522,6341,5
pluma,1184,1193,990,612,2362,6341,5
begum,1555,2863,616,899,406,6339,5
slick,2206,1193,1668,770,502,6339,5
prang,1184,1543,1959,1391,261,6338,5
stend,2206,403,1421,1391,917,6338,5
stewy,2206,403,1421,192,2116,6338,5
flowe,847,1193,1426,192,2679,6337,5
fluke,847,1193,990,628,2679,6337,5
raghu,948,4103,616,423,247,6337,5
bruno,1555,1543,990,1391,857,6336,5
drunt,1128,1543,990,1391,1284,6336,5
kurmi,789,1824,2201,612,910,6336,5
pheon,1184,927,1421,1282,1522,6336,5
prout,1184,1543,1426,899,1284,6336,5
judge,446,1824,774,612,2679,6335,5
kylin,789,458,1603,1963,1522,6335,5
slorp,2206,1193,1426,1225,285,6335,5
blype,1555,1193,381,526,2679,6334,5
tudor,1264,1824,774,1282,1190,6334,5
knipe,789,671,1668,526,2679,6333,5
music,1225,1824,1021,1963,300,6333,5
chosn,1512,927,1426,945,1522,6332,5
rushy,948,1824,1021,423,2116,6332,5
svelt,2206,126,1421,1295,1284,6332,5
alpid,1698,1193,560,1963,917,6331,5
nicky,647,2239,701,628,2116,6331,5
olive,532,1193,1668,259,2679,6331,5
pilum,1184,2239,1603,899,406,6331,5
zitah,176,2239,1048,2214,654,6331,5
dielu,1128,2239,1421,1295,247,6330,5
brack,1555,1543,1959,770,502,6329,5
kheda,789,927,1421,829,2362,6328,5
wrast,596,1543,1959,945,1284,6327,5
angry,1698,671,616,1225,2116,6326,5
rhyne,948,927,381,1391,2679,6326,5
thisn,1264,927,1668,945,1522,6326,5
wekau,596,2863,406,2214,247,6326,5
igbos,473,139,664,1282,3767,6325,5
eyota,693,458,1426,1385,2362,6324,5
youth,225,3069,990,1385,654,6323,5
leuch,1046,2863,990,770,654,6323,5
recpt,948,2863,701,526,1284,6322,5
drest,1128,1543,1421,945,1284,6321,5
flume,847,1193,990,612,2679,6321,5
kurtz,789,1824,2201,1385,122,6321,5
buick,1555,1824,1668,770,502,6319,5
child,1512,927,1668,1295,917,6319,5
kilom,789,2239,1603,1282,406,6319,5
scuba,2206,338,990,423,2362,6319,5
skiwy,2206,137,1668,192,2116,6319,5
phano,1184,927,1959,1391,857,6318,5
pheba,1184,927,1421,423,2362,6317,5
clang,1512,1193,1959,1391,261,6316,5
lucky,1046,1824,701,628,2116,6315,5
areng,1698,1543,1421,1391,261,6314,5
clout,1512,1193,1426,899,1284,6314,5
myope,1225,458,1426,526,2679,6314,5
tungo,1264,1824,1757,612,857,6314,5
admin,1698,245,885,1963,1522,6313,5
fulth,847,1824,1603,1385,654,6313,5
muntz,1225,1824,1757,1385,122,6313,5
twyer,1264,226,381,3252,1190,6313,5
upset,420,336,1021,3252,1284,6313,5
virgo,404,2239,2201,612,857,6313,5
fingo,847,2239,1757,612,857,6312,5
lupid,1046,1824,560,1963,917,6310,5
nimby,647,2239,885,423,2116,6310,5
blink,1555,1193,1668,1391,502,6309,5
grovy,965,1543,1426,259,2116,6309,5
jutka,446,1824,1048,628,2362,6308,5
mynah,1225,458,1757,2214,654,6308,5
flawy,847,1193,1959,192,2116,6307,5
under,420,671,774,3252,1190,6307,5
blash,1555,1193,1959,945,654,6306,5
liesh,1046,2239,1421,945,654,6305,5
hyper,844,458,560,3252,1190,6304,5
ister,473,341,1048,3252,1190,6304,5
umset,420,327,1021,3252,1284,6304,5
vedic,404,2863,774,1963,300,6304,5
chirl,1512,927,1668,1225,971,6303,5
vaduz,404,4103,774,899,122,6302,5
agric,1698,139,2201,1963,300,6301,5
ovile,532,126,1668,1295,2679,6300,5
mckay,1225,338,406,2214,2116,6299,5
rumpy,948,1824,885,526,2116,6299,5
stoic,2206,403,1426,1963,300,6298,5
lewth,1046,2863,349,1385,654,6297,5
avion,1698,126,1668,1282,1522,6296,5
swirl,2206,226,1668,1225,971,6296,5
vingt,404,2239,1757,612,1284,6296,5
zloty,176,1193,1426,1385,2116,6296,5
cubti,1512,1824,664,1385,910,6295,5
dietz,1128,2239,1421,1385,122,6295,5
proxy,1184,1543,1426,26,2116,6295,5
stark,2206,403,1959,1225,502,6295,5
zohak,176,3069,334,2214,502,6295,5
keung,789,2863,990,1391,261,6294,5
heijo,844,2863,1668,61,857,6293,5
necro,647,2863,701,1225,857,6293,5
mehul,1225,2863,334,899,971,6292,5
spiro,2206,336,1668,1225,857,6292,5
chank,1512,927,1959,1391,502,6291,5
clype,1512,1193,381,526,2679,6291,5
rebud,948,2863,664,899,917,6291,5
unbet,420,671,664,3252,1284,6291,5
ahunt,1698,927,990,1391,1284,6290,5
prexy,1184,1543,1421,26,2116,6290,5
whory,596,927,1426,1225,2116,6290,5
wundt,596,1824,1757,829,1284,6290,5
gibun,965,2239,664,899,1522,6289,5
prink,1184,1543,1668,1391,502,6288,5
scrog,2206,338,2201,1282,261,6288,5
tragi,1264,1543,1959,612,910,6288,5
demob,1128,2863,885,1282,129,6287,5
frist,847,1543,1668,945,1284,6287,5
pungi,1184,1824,1757,612,910,6287,5
crept,1512,1543,1421,526,1284,6286,5
elrod,693,1193,2201,1282,917,6286,5
shiko,2206,927,1668,628,857,6286,5
gundi,965,1824,1757,829,910,6285,5
swank,2206,226,1959,1391,502,6284,5
aevum,1698,2863,417,899,406,6283,5
bryon,1555,1543,381,1282,1522,6283,5
petfi,1184,2863,1048,278,910,6283,5
retch,948,2863,1048,770,654,6283,5
drang,1128,1543,1959,1391,261,6282,5
slunk,2206,1193,990,1391,502,6282,5
stawn,2206,403,1959,192,1522,6282,5
okehs,532,137,1421,423,3767,6280,5
omina,532,327,1668,1391,2362,6280,5
wicky,596,2239,701,628,2116,6280,5
huang,844,1824,1959,1391,261,6279,5
spurn,2206,336,990,1225,1522,6279,5
swoun,2206,226,1426,899,1522,6279,5
steno,2206,403,1421,1391,857,6278,5
shaup,2206,927,1959,899,285,6276,5
wreak,596,1543,1421,2214,502,6276,5
mungo,1225,1824,1757,612,857,6275,5
crust,1512,1543,990,945,1284,6274,5
gujar,965,1824,81,2214,1190,6274,5
futwa,847,1824,1048,192,2362,6273,5
rough,948,3069,990,612,654,6273,5
scend,2206,338,1421,1391,917,6273,5
shown,2206,927,1426,192,1522,6273,5
fdubs,847,245,990,423,3767,6272,5
sphex,2206,336,334,3252,144,6272,5
spend,2206,336,1421,1391,917,6271,5
spewy,2206,336,1421,192,2116,6271,5
westm,596,2863,1021,1385,406,6271,5
wyted,596,458,1048,3252,917,6271,5
rhema,948,927,1421,612,2362,6270,5
junto,446,1824,1757,1385,857,6269,5
orgue,532,1543,616,899,2679,6269,5
keryx,789,2863,2201,271,144,6268,5
rundi,948,1824,1757,829,910,6268,5
shewn,2206,927,1421,192,1522,6268,5
finch,847,2239,1757,770,654,6267,5
roehm,948,3069,1421,423,406,6267,5
bitch,1555,2239,1048,770,654,6266,5
bsmin,1555,341,885,1963,1522,6266,5
clink,1512,1193,1668,1391,502,6266,5
tubac,1264,1824,664,2214,300,6266,5
kwame,789,226,1959,612,2679,6265,5
seqwl,2206,2863,32,192,971,6264,5
ureid,420,1543,1421,1963,917,6264,5
zoism,176,3069,1668,945,406,6264,5
ahold,1698,927,1426,1295,917,6263,5
clash,1512,1193,1959,945,654,6263,5
kluge,789,1193,990,612,2679,6263,5
remop,948,2863,885,1282,285,6263,5
domph,1128,3069,885,526,654,6262,5
sybil,2206,458,664,1963,971,6262,5
orcin,532,1543,701,1963,1522,6261,5
fourb,847,3069,990,1225,129,6260,5
otila,532,403,1668,1295,2362,6260,5
quint,93,1824,1668,1391,1284,6260,5
spumy,2206,336,990,612,2116,6260,5
unity,420,671,1668,1385,2116,6260,5
chilo,1512,927,1668,1295,857,6259,5
cymar,1512,458,885,2214,1190,6259,5
bredi,1555,1543,1421,829,910,6258,5
ayont,1698,458,1426,1391,1284,6257,5
diego,1128,2239,1421,612,857,6257,5
draco,1128,1543,1959,770,857,6257,5
uniat,420,671,1668,2214,1284,6257,5
befop,1555,2863,271,1282,285,6256,5
gybed,965,458,664,3252,917,6256,5
rubio,948,1824,664,1963,857,6256,5
tibur,1264,2239,664,899,1190,6256,5
atomy,1698,403,1426,612,2116,6255,5
shawl,2206,927,1959,192,971,6255,5
slamp,2206,1193,1959,612,285,6255,5
desyl,1128,2863,1021,271,971,6254,5
glent,965,1193,1421,1391,1284,6254,5
huaco,844,1824,1959,770,857,6254,5
kusam,789,1824,1021,2214,406,6254,5
axion,1698,83,1668,1282,1522,6253,5
dijon,1128,2239,81,1282,1522,6252,5
uster,420,341,1048,3252,1190,6251,5
hynda,844,458,1757,829,2362,6250,5
durzi,1128,1824,2201,186,910,6249,5
enpia,693,671,560,1963,2362,6249,5
yucat,225,1824,701,2214,1284,6248,5
staci,2206,403,1959,770,910,6248,5
ultra,420,1193,1048,1225,2362,6248,5
blurt,1555,1193,990,1225,1284,6247,5
micro,1225,2239,701,1225,857,6247,5
stold,2206,403,1426,1295,917,6247,5
italy,473,403,1959,1295,2116,6246,5
ostia,532,341,1048,1963,2362,6246,5
rhody,948,927,1426,829,2116,6246,5
unget,420,671,616,3252,1284,6243,5
frank,847,1543,1959,1391,502,6242,5
grond,965,1543,1426,1391,917,6242,5
swird,2206,226,1668,1225,917,6242,5
abody,1698,172,1426,829,2116,6241,5
ehman,693,927,885,2214,1522,6241,5
shilf,2206,927,1668,1295,145,6241,5
astir,1698,341,1048,1963,1190,6240,5
smith,2206,327,1668,1385,654,6240,5
brown,1555,1543,1426,192,1522,6238,5
elgan,693,1193,616,2214,1522,6238,5
keijo,789,2863,1668,61,857,6238,5
rdbms,948,245,664,612,3767,6236,5
resow,948,2863,1021,1282,122,6236,5
afric,1698,73,2201,1963,300,6235,5
brimo,1555,1543,1668,612,857,6235,5
chevy,1512,927,1421,259,2116,6235,5
dulci,1128,1824,1603,770,910,6235,5
ismet,473,341,885,3252,1284,6235,5
otary,532,403,1959,1225,2116,6235,5
above,1698,172,1426,259,2679,6234,5
adoze,1698,245,1426,186,2679,6234,5
erath,693,1543,1959,1385,654,6234,5
evita,693,126,1668,1385,2362,6234,5
yoick,225,3069,1668,770,502,6234,5
ulman,420,1193,885,2214,1522,6234,5
dyula,1128,458,990,1295,2362,6233,5
befog,1555,2863,271,1282,261,6232,5
drink,1128,1543,1668,1391,502,6232,5
nipha,647,2239,560,423,2362,6231,5
aboil,1698,172,1426,1963,971,6230,5
critz,1512,1543,1668,1385,122,6230,5
munch,1225,1824,1757,770,654,6230,5
elint,693,1193,1668,1391,1284,6229,5
oncia,532,671,701,1963,2362,6229,5
plank,1184,1193,1959,1391,502,6229,5
orvan,532,1543,417,2214,1522,6228,5
spark,2206,336,1959,1225,502,6228,5
inola,473,671,1426,1295,2362,6227,5
iroha,473,1543,1426,423,2362,6227,5
bravi,1555,1543,1959,259,910,6226,5
tophi,1264,3069,560,423,910,6226,5
zemni,176,2863,885,1391,910,6225,5
ernst,693,1543,1757,945,1284,6222,5
mucor,1225,1824,701,1282,1190,6222,5
ihram,473,927,2201,2214,406,6221,5
owser,532,226,1021,3252,1190,6221,5
brawl,1555,1543,1959,192,971,6220,5
butyn,1555,1824,1048,271,1522,6220,5
clour,1512,1193,1426,899,1190,6220,5
odyls,532,245,381,1295,3767,6220,5
stang,2206,403,1959,1391,261,6220,5
ogden,532,139,774,3252,1522,6219,5
kefti,789,2863,271,1385,910,6218,5
flirt,847,1193,1668,1225,1284,6217,5
rucky,948,1824,701,628,2116,6217,5
tubik,1264,1824,664,1963,502,6217,5
cequi,1512,2863,32,899,910,6216,5
bronc,1555,1543,1426,1391,300,6215,5
grith,965,1543,1668,1385,654,6215,5
spawn,2206,336,1959,192,1522,6215,5
arium,1698,1543,1668,899,406,6214,5
blatz,1555,1193,1959,1385,122,6214,5
cukor,1512,1824,406,1282,1190,6214,5
strow,2206,403,2201,1282,122,6214,5
brisk,1555,1543,1668,945,502,6213,5
gumby,965,1824,885,423,2116,6213,5
trask,1264,1543,1959,945,502,6213,5
jimpy,446,2239,885,526,2116,6212,5
phard,1184,927,1959,1225,917,6212,5
dynah,1128,458,1757,2214,654,6211,5
jurdi,446,1824,2201,829,910,6210,5
acorn,1698,338,1426,1225,1522,6209,5
kinch,789,2239,1757,770,654,6209,5
chapt,1512,927,1959,526,1284,6208,5
epona,693,336,1426,1391,2362,6208,5
eupad,693,1824,560,2214,917,6208,5
negro,647,2863,616,1225,857,6208,5
unice,420,671,1668,770,2679,6208,5
chaui,1512,927,1959,899,910,6207,5
kleon,789,1193,1421,1282,1522,6207,5
skirl,2206,137,1668,1225,971,6207,5
glaur,965,1193,1959,899,1190,6206,5
sheng,2206,927,1421,1391,261,6206,5
wloka,596,1193,1426,628,2362,6205,5
gloam,965,1193,1426,2214,406,6204,5
nydia,647,458,774,1963,2362,6204,5
yeisk,225,2863,1668,945,502,6203,5
visby,404,2239,1021,423,2116,6203,5
inger,473,671,616,3252,1190,6202,5
owain,532,226,1959,1963,1522,6202,5
abury,1698,172,990,1225,2116,6201,5
gleam,965,1193,1421,2214,406,6199,5
lesgh,1046,2863,1021,612,654,6196,5
tieck,1264,2239,1421,770,502,6196,5
chalk,1512,927,1959,1295,502,6195,5
crown,1512,1543,1426,192,1522,6195,5
humpy,844,1824,885,526,2116,6195,5
elboa,693,1193,664,1282,2362,6194,5
nurmi,647,1824,2201,612,910,6194,5
draft,1128,1543,1959,278,1284,6192,5
duchy,1128,1824,701,423,2116,6192,5
pierz,1184,2239,1421,1225,122,6191,5
luing,1046,1824,1668,1391,261,6190,5
mulki,1225,1824,1603,628,910,6190,5
chiro,1512,927,1668,1225,857,6189,5
punch,1184,1824,1757,770,654,6189,5
refix,948,2863,271,1963,144,6189,5
notch,647,3069,1048,770,654,6188,5
tiwaz,1264,2239,349,2214,122,6188,5
juxta,446,1824,170,1385,2362,6187,5
spado,2206,336,1959,829,857,6187,5
sherm,2206,927,1421,1225,406,6185,5
clipt,1512,1193,1668,526,1284,6183,5
diehl,1128,2239,1421,423,971,6182,5
fetch,847,2863,1048,770,654,6182,5
scold,2206,338,1426,1295,917,6182,5
arick,1698,1543,1668,770,502,6181,5
grawn,965,1543,1959,192,1522,6181,5
eloah,693,1193,1426,2214,654,6180,5
tsked,1264,341,406,3252,917,6180,5
yreka,225,1543,1421,628,2362,6179,5
tumli,1264,1824,885,1295,910,6178,5
cyano,1512,458,1959,1391,857,6177,5
crawl,1512,1543,1959,192,971,6177,5
dwyer,1128,226,381,3252,1190,6177,5
fleak,847,1193,1421,2214,502,6177,5
churn,1512,927,990,1225,1522,6176,5
tyrol,1264,458,2201,1282,971,6176,5
usita,420,341,1668,1385,2362,6176,5
houck,844,3069,990,770,502,6175,5
velum,404,2863,1603,899,406,6175,5
livor,1046,2239,417,1282,1190,6174,5
mosgu,1225,3069,1021,612,247,6174,5
bravo,1555,1543,1959,259,857,6173,5
fudgy,847,1824,774,612,2116,6173,5
grunt,965,1543,990,1391,1284,6173,5
yogic,225,3069,616,1963,300,6173,5
unrid,420,671,2201,1963,917,6172,5
islek,473,341,1603,3252,502,6171,5
misdo,1225,2239,1021,829,857,6171,5
cloth,1512,1193,1426,1385,654,6170,5
stink,2206,403,1668,1391,502,6170,5
atopy,1698,403,1426,526,2116,6169,5
chuje,1512,927,990,61,2679,6169,5
yaqui,225,4103,32,899,910,6169,5
pydna,1184,458,774,1391,2362,6169,5
sycon,2206,458,701,1282,1522,6169,5
ursal,420,1543,1021,2214,971,6169,5
vraic,404,1543,1959,1963,300,6169,5
chewy,1512,927,1421,192,2116,6168,5
fundi,847,1824,1757,829,910,6167,5
tranq,1264,1543,1959,1391,9,6166,5
fraud,847,1543,1959,899,917,6165,5
steri,2206,403,1421,1225,910,6165,5
wylde,596,458,1603,829,2679,6165,5
azlon,1698,59,1603,1282,1522,6164,5
hundi,844,1824,1757,829,910,6164,5
quilt,93,1824,1668,1295,1284,6164,5
obeys,532,172,1421,271,3767,6163,5
credo,1512,1543,1421,829,857,6162,5
fhlba,847,927,1603,423,2362,6162,5
tryma,1264,1543,381,612,2362,6162,5
idyls,473,245,381,1295,3767,6161,5
kraul,789,1543,1959,899,971,6161,5
alsip,1698,1193,1021,1963,285,6160,5
alcot,1698,1193,701,1282,1284,6158,5
alish,1698,1193,1668,945,654,6158,5
joung,446,3069,990,1391,261,6157,5
scrob,2206,338,2201,1282,129,6156,5
ruach,948,1824,1959,770,654,6155,5
eland,693,1193,1959,1391,917,6153,5
scout,2206,338,1426,899,1284,6153,5
spang,2206,336,1959,1391,261,6153,5
zihar,176,2239,334,2214,1190,6153,5
obrit,532,172,2201,1963,1284,6152,5
pharo,1184,927,1959,1225,857,6152,5
plaud,1184,1193,1959,899,917,6152,5
spout,2206,336,1426,899,1284,6151,5
wogul,596,3069,616,899,971,6151,5
jihad,446,2239,334,2214,917,6150,5
cspan,1512,341,560,2214,1522,6149,5
dript,1128,1543,1668,526,1284,6149,5
lochi,1046,3069,701,423,910,6149,5
lungi,1046,1824,1757,612,910,6149,5
phyla,1184,927,381,1295,2362,6149,5
scrow,2206,338,2201,1282,122,6149,5
unger,420,671,616,3252,1190,6149,5
inoue,473,671,1426,899,2679,6148,5
iplan,473,336,1603,2214,1522,6148,5
eldin,693,1193,774,1963,1522,6145,5
guido,965,1824,1668,829,857,6143,5
eikon,693,2239,406,1282,1522,6142,5
frayn,847,1543,1959,271,1522,6142,5
smout,2206,327,1426,899,1284,6142,5
flaxy,847,1193,1959,26,2116,6141,5
letup,1046,2863,1048,899,285,6141,5
ukase,420,137,1959,945,2679,6140,5
swith,2206,226,1668,1385,654,6139,5
absit,1698,172,1021,1963,1284,6138,5
ervin,693,1543,417,1963,1522,6138,5
wyola,596,458,1426,1295,2362,6137,5
wrath,596,1543,1959,1385,654,6137,5
visor,404,2239,1021,1282,1190,6136,5
moqui,1225,3069,32,899,910,6135,5
impen,473,327,560,3252,1522,6134,5
shyam,2206,927,381,2214,406,6134,5
svign,2206,126,1668,612,1522,6134,5
aloud,1698,1193,1426,899,917,6133,5
dunch,1128,1824,1757,770,654,6133,5
knoit,789,671,1426,1963,1284,6133,5
tecum,1264,2863,701,899,406,6133,5
eclat,693,338,1603,2214,1284,6132,5
nidor,647,2239,774,1282,1190,6132,5
sparm,2206,336,1959,1225,406,6132,5
avoid,1698,126,1426,1963,917,6130,5
cravo,1512,1543,1959,259,857,6130,5
wheal,596,927,1421,2214,971,6129,5
wurtz,596,1824,2201,1385,122,6128,5
lemhi,1046,2863,885,423,910,6127,5
muong,1225,1824,1426,1391,261,6127,5
urali,420,1543,1959,1295,910,6127,5
nichy,647,2239,701,423,2116,6126,5
pedum,1184,2863,774,899,406,6126,5
tronk,1264,1543,1426,1391,502,6126,5
chark,1512,927,1959,1225,502,6125,5
ducor,1128,1824,701,1282,1190,6125,5
lyman,1046,458,885,2214,1522,6125,5
netop,647,2863,1048,1282,285,6125,5
frond,847,1543,1426,1391,917,6124,5
frowy,847,1543,1426,192,2116,6124,5
hejaz,844,2863,81,2214,122,6124,5
ketch,789,2863,1048,770,654,6124,5
nocht,647,3069,701,423,1284,6124,5
stour,2206,403,1426,899,1190,6124,5
globy,965,1193,1426,423,2116,6123,5
mikol,1225,2239,406,1282,971,6123,5
osage,532,341,1959,612,2679,6123,5
vedro,404,2863,774,1225,857,6123,5
gluma,965,1193,990,612,2362,6122,5
styca,2206,403,381,770,2362,6122,5
ament,1698,327,1421,1391,1284,6121,5
avowe,1698,126,1426,192,2679,6121,5
locum,1046,3069,701,899,406,6121,5
shrpg,2206,927,2201,526,261,6121,5
winou,596,2239,1757,1282,247,6121,5
eliot,693,1193,1668,1282,1284,6120,5
olema,532,1193,1421,612,2362,6120,5
orpin,532,1543,560,1963,1522,6120,5
jubal,446,1824,664,2214,971,6119,5
gleby,965,1193,1421,423,2116,6118,5
subch,2206,1824,664,770,654,6118,5
bight,1555,2239,616,423,1284,6117,5
grout,965,1543,1426,899,1284,6117,5
uncia,420,671,701,1963,2362,6117,5
adorn,1698,245,1426,1225,1522,6116,5
rejig,948,2863,81,1963,261,6116,5
strum,2206,403,2201,899,406,6115,5
byard,1555,458,1959,1225,917,6114,5
furyl,847,1824,2201,271,971,6114,5
filch,847,2239,1603,770,654,6113,5
hdqrs,844,245,32,1225,3767,6113,5
scult,2206,338,990,1295,1284,6113,5
tupik,1264,1824,560,1963,502,6113,5
chawn,1512,927,1959,192,1522,6112,5
pizor,1184,2239,217,1282,1190,6112,5
stero,2206,403,1421,1225,857,6112,5
thiol,1264,927,1668,1282,971,6112,5
chyme,1512,927,381,612,2679,6111,5
uslta,420,341,1603,1385,2362,6111,5
argol,1698,1543,616,1282,971,6110,5
musth,1225,1824,1021,1385,654,6109,5
elaic,693,1193,1959,1963,300,6108,5
emlin,693,327,1603,1963,1522,6108,5
snack,2206,671,1959,770,502,6108,5
fugio,847,1824,616,1963,857,6107,5
snift,2206,671,1668,278,1284,6107,5
tuism,1264,1824,1668,945,406,6107,5
wesco,596,2863,1021,770,857,6107,5
pyric,1184,458,2201,1963,300,6106,5
gusti,965,1824,1021,1385,910,6105,5
oxter,532,83,1048,3252,1190,6105,5
vifda,404,2239,271,829,2362,6105,5
spink,2206,336,1668,1391,502,6103,5
eliza,693,1193,1668,186,2362,6102,5
squid,2206,25,990,1963,917,6101,5
drago,1128,1543,1959,612,857,6099,5
emily,693,327,1668,1295,2116,6099,5
frith,847,1543,1668,1385,654,6097,5
yield,225,2239,1421,1295,917,6097,5
slock,2206,1193,1426,770,502,6097,5
ofter,532,73,1048,3252,1190,6095,5
plumy,1184,1193,990,612,2116,6095,5
sumph,2206,1824,885,526,654,6095,5
grype,965,1543,381,526,2679,6094,5
quirt,93,1824,1668,1225,1284,6094,5
bhang,1555,927,1959,1391,261,6093,5
kwela,789,226,1421,1295,2362,6093,5
ruing,948,1824,1668,1391,261,6092,5
sleck,2206,1193,1421,770,502,6092,5
rhiza,948,927,1668,186,2362,6091,5
chest,1512,927,1421,945,1284,6089,5
gijon,965,2239,81,1282,1522,6089,5
azury,1698,59,990,1225,2116,6088,5
hugon,844,1824,616,1282,1522,6088,5
vicky,404,2239,701,628,2116,6088,5
amboy,1698,327,664,1282,2116,6087,5
axoid,1698,83,1426,1963,917,6087,5
inket,473,671,406,3252,1284,6086,5
muzio,1225,1824,217,1963,857,6086,5
knife,789,671,1668,278,2679,6085,5
opted,532,336,1048,3252,917,6085,5
quern,93,1824,1421,1225,1522,6085,5
unbay,420,671,664,2214,2116,6085,5
cruth,1512,1543,990,1385,654,6084,5
sixmo,2206,2239,170,612,857,6084,5
theor,1264,927,1421,1282,1190,6084,5
rutic,948,1824,1048,1963,300,6083,5
scalp,2206,338,1959,1295,285,6083,5
jodyn,446,3069,774,271,1522,6082,5
ascry,1698,341,701,1225,2116,6081,5
fleam,847,1193,1421,2214,406,6081,5
rheba,948,927,1421,423,2362,6081,5
shogi,2206,927,1426,612,910,6081,5
ghast,965,927,1959,945,1284,6080,5
cbema,1512,172,1421,612,2362,6079,5
wouch,596,3069,990,770,654,6079,5
johst,446,3069,334,945,1284,6078,5
chold,1512,927,1426,1295,917,6077,5
ulric,420,1193,2201,1963,300,6077,5
mulch,1225,1824,1603,770,654,6076,5
phoby,1184,927,1426,423,2116,6076,5
trypa,1264,1543,381,526,2362,6076,5
admit,1698,245,885,1963,1284,6075,5
psoai,1184,341,1426,2214,910,6075,5
ticul,1264,2239,701,899,971,6074,5
trish,1264,1543,1668,945,654,6074,5
shick,2206,927,1668,770,502,6073,5
pexsi,1184,2863,170,945,910,6072,5
quarl,93,1824,1959,1225,971,6072,5
skewy,2206,137,1421,192,2116,6072,5
getfd,965,2863,1048,278,917,6071,5
jugal,446,1824,616,2214,971,6071,5
pisco,1184,2239,1021,770,857,6071,5
choli,1512,927,1426,1295,910,6070,5
erwin,693,1543,349,1963,1522,6070,5
chufa,1512,927,990,278,2362,6069,5
ertha,693,1543,1048,423,2362,6069,5
notum,647,3069,1048,899,406,6069,5
ruvid,948,1824,417,1963,917,6069,5
diamb,1128,2239,1959,612,129,6067,5
fgrid,847,139,2201,1963,917,6067,5
mowch,1225,3069,349,770,654,6067,5
knive,789,671,1668,259,2679,6066,5
wilco,596,2239,1603,770,857,6065,5
alcor,1698,1193,701,1282,1190,6064,5
frawn,847,1543,1959,192,1522,6063,5
snurl,2206,671,990,1225,971,6063,5
blenk,1555,1193,1421,1391,502,6062,5
onida,532,671,1668,829,2362,6062,5
svend,2206,126,1421,1391,917,6061,5
wingo,596,2239,1757,612,857,6061,5
cuyab,1512,1824,381,2214,129,6060,5
getup,965,2863,1048,899,285,6060,5
bronx,1555,1543,1426,1391,144,6059,5
scour,2206,338,1426,899,1190,6059,5
urent,420,1543,1421,1391,1284,6059,5
psize,1184,341,1668,186,2679,6058,5
wusih,596,1824,1021,1963,654,6058,5
zeism,176,2863,1668,945,406,6058,5
djave,1128,32,1959,259,2679,6057,5
alodi,1698,1193,1426,829,910,6056,5
rigol,948,2239,616,1282,971,6056,5
bjart,1555,32,1959,1225,1284,6055,5
glist,965,1193,1668,945,1284,6055,5
thirl,1264,927,1668,1225,971,6055,5
queak,93,1824,1421,2214,502,6054,5
gusto,965,1824,1021,1385,857,6052,5
snitz,2206,671,1668,1385,122,6052,5
lunch,1046,1824,1757,770,654,6051,5
onker,532,671,406,3252,1190,6051,5
chang,1512,927,1959,1391,261,6050,5
image,473,327,1959,612,2679,6050,5
scrum,2206,338,2201,899,406,6050,5
vidya,404,2239,774,271,2362,6050,5
oside,532,341,1668,829,2679,6049,5
pylon,1184,458,1603,1282,1522,6049,5
syrup,2206,458,2201,899,285,6049,5
chout,1512,927,1426,899,1284,6048,5
amnic,1698,327,1757,1963,300,6045,5
frost,847,1543,1426,945,1284,6045,5
pudic,1184,1824,774,1963,300,6045,5
aborn,1698,172,1426,1225,1522,6043,5
croft,1512,1543,1426,278,1284,6043,5
swang,2206,226,1959,1391,261,6043,5
thank,1264,927,1959,1391,502,6043,5
tlaco,1264,1193,1959,770,857,6043,5
osity,532,341,1668,1385,2116,6042,5
rebop,948,2863,664,1282,285,6042,5
slung,2206,1193,990,1391,261,6041,5
spurt,2206,336,990,1225,1284,6041,5
elogy,693,1193,1426,612,2116,6040,5
franc,847,1543,1959,1391,300,6040,5
elvan,693,1193,417,2214,1522,6039,5
supvr,2206,1824,560,259,1190,6039,5
brick,1555,1543,1668,770,502,6038,5
inure,473,671,990,1225,2679,6038,5
track,1264,1543,1959,770,502,6038,5
cujam,1512,1824,81,2214,406,6037,5
ergal,693,1543,616,2214,971,6037,5
wrist,596,1543,1668,945,1284,6036,5
aldim,1698,1193,774,1963,406,6034,5
ghaut,965,927,1959,899,1284,6034,5
yurok,225,1824,2201,1282,502,6034,5
bruhn,1555,1543,990,423,1522,6033,5
omena,532,327,1421,1391,2362,6033,5
unket,420,671,406,3252,1284,6033,5
aneto,1698,671,1421,1385,857,6032,5
exira,693,83,1668,1225,2362,6031,5
hyped,844,458,560,3252,917,6031,5
ambry,1698,327,664,1225,2116,6030,5
duong,1128,1824,1426,1391,261,6030,5
snork,2206,671,1426,1225,502,6030,5
charm,1512,927,1959,1225,406,6029,5
graft,965,1543,1959,278,1284,6029,5
ismay,473,341,885,2214,2116,6029,5
bejou,1555,2863,81,1282,247,6028,5
esbay,693,341,664,2214,2116,6028,5
ocean,532,338,1421,2214,1522,6027,5
bretz,1555,1543,1421,1385,122,6026,5
edlin,693,245,1603,1963,1522,6026,5
sparc,2206,336,1959,1225,300,6026,5
cling,1512,1193,1668,1391,261,6025,5
humor,844,1824,885,1282,1190,6025,5
unode,420,671,1426,829,2679,6025,5
clyve,1512,1193,381,259,2679,6024,5
clonk,1512,1193,1426,1391,502,6024,5
alurd,1698,1193,990,1225,917,6023,5
gwely,965,226,1421,1295,2116,6023,5
irfan,473,1543,271,2214,1522,6023,5
izote,473,59,1426,1385,2679,6022,5
swarm,2206,226,1959,1225,406,6022,5
altro,1698,1193,1048,1225,857,6021,5
dhoby,1128,927,1426,423,2116,6020,5
ouphe,532,1824,560,423,2679,6018,5
hienz,844,2239,1421,1391,122,6017,5
spect,2206,336,1421,770,1284,6017,5
nitro,647,2239,1048,1225,857,6016,5
resup,948,2863,1021,899,285,6016,5
shunk,2206,927,990,1391,502,6016,5
winch,596,2239,1757,770,654,6016,5
disco,1128,2239,1021,770,857,6015,5
embay,693,327,664,2214,2116,6014,5
gecko,965,2863,701,628,857,6014,5
oliva,532,1193,1668,259,2362,6014,5
quent,93,1824,1421,1391,1284,6013,5
scarp,2206,338,1959,1225,285,6013,5
sloyd,2206,1193,1426,271,917,6013,5
knead,789,671,1421,2214,917,6012,5
redox,948,2863,774,1282,144,6011,5
usage,420,341,1959,612,2679,6011,5
lysin,1046,458,1021,1963,1522,6010,5
vaxbi,404,4103,170,423,910,6010,5
gyved,965,458,417,3252,917,6009,5
kudva,789,1824,774,259,2362,6008,5
spatz,2206,336,1959,1385,122,6008,5
ulema,420,1193,1421,612,2362,6008,5
chord,1512,927,1426,1225,917,6007,5
itnez,473,403,1757,3252,122,6007,5
khiva,789,927,1668,259,2362,6005,5
ginzo,965,2239,1757,186,857,6004,5
khiam,789,927,1668,2214,406,6004,5
stirk,2206,403,1668,1225,502,6004,5
cribo,1512,1543,1668,423,857,6003,5
eucha,693,1824,701,423,2362,6003,5
rhyta,948,927,381,1385,2362,6003,5
riehl,948,2239,1421,423,971,6002,5
third,1264,927,1668,1225,917,6001,5
afnor,1698,73,1757,1282,1190,6000,5
anoli,1698,671,1426,1295,910,6000,5
chink,1512,927,1668,1391,502,6000,5
sword,2206,226,1426,1225,917,6000,5
aledo,1698,1193,1421,829,857,5998,5
tikur,1264,2239,406,899,1190,5998,5
emyds,693,327,381,829,3767,5997,5
amply,1698,327,560,1295,2116,5996,5
cheri,1512,927,1421,1225,910,5995,5
yomud,225,3069,885,899,917,5995,5
swerd,2206,226,1421,1225,917,5995,5
filum,847,2239,1603,899,406,5994,5
judye,446,1824,774,271,2679,5994,5
picul,1184,2239,701,899,971,5994,5
shelf,2206,927,1421,1295,145,5994,5
egnar,693,139,1757,2214,1190,5993,5
smeth,2206,327,1421,1385,654,5993,5
swink,2206,226,1668,1391,502,5993,5
avern,1698,126,1421,1225,1522,5992,5
inker,473,671,406,3252,1190,5992,5
oland,532,1193,1959,1391,917,5992,5
tryon,1264,1543,381,1282,1522,5992,5
hilum,844,2239,1603,899,406,5991,5
icken,473,338,406,3252,1522,5991,5
whart,596,927,1959,1225,1284,5991,5
myoid,1225,458,1426,1963,917,5989,5
ghent,965,927,1421,1391,1284,5988,5
ledum,1046,2863,774,899,406,5988,5
plang,1184,1193,1959,1391,261,5988,5
synop,2206,458,1757,1282,285,5988,5
elgin,693,1193,616,1963,1522,5987,5
gript,965,1543,1668,526,1284,5986,5
orbit,532,1543,664,1963,1284,5986,5
plout,1184,1193,1426,899,1284,5986,5
bhalu,1555,927,1959,1295,247,5983,5
ulmin,420,1193,885,1963,1522,5983,5
muzak,1225,1824,217,2214,502,5982,5
ampex,1698,327,560,3252,144,5981,5
brunk,1555,1543,990,1391,502,5981,5
ryked,948,458,406,3252,917,5981,5
unpay,420,671,560,2214,2116,5981,5
algor,1698,1193,616,1282,1190,5979,5
aubyn,1698,1824,664,271,1522,5979,5
black,1555,1193,1959,770,502,5979,5
kuehn,789,1824,1421,423,1522,5979,5
osber,532,341,664,3252,1190,5979,5
tubig,1264,1824,664,1963,261,5976,5
unwet,420,671,349,3252,1284,5976,5
whiba,596,927,1668,423,2362,5976,5
ndola,647,245,1426,1295,2362,5975,5
gratz,965,1543,1959,1385,122,5974,5
guyon,965,1824,381,1282,1522,5974,5
imena,473,327,1421,1391,2362,5974,5
irpex,473,1543,560,3252,144,5972,5
lyart,1046,458,1959,1225,1284,5972,5
tripl,1264,1543,1668,526,971,5972,5
trodi,1264,1543,1426,829,910,5972,5
along,1698,1193,1426,1391,261,5969,5
aport,1698,336,1426,1225,1284,5969,5
proud,1184,1543,1426,899,917,5969,5
stauk,2206,403,1959,899,502,5969,5
cdoba,1512,245,1426,423,2362,5968,5
cyath,1512,458,1959,1385,654,5968,5
lyric,1046,458,2201,1963,300,5968,5
rhamn,948,927,1959,612,1522,5968,5
whyte,596,927,381,1385,2679,5968,5
shaku,2206,927,1959,628,247,5967,5
omber,532,327,664,3252,1190,5965,5
onery,532,671,1421,1225,2116,5965,5
pynot,1184,458,1757,1282,1284,5965,5
apert,1698,336,1421,1225,1284,5964,5
dynam,1128,458,1757,2214,406,5963,5
stahl,2206,403,1959,423,971,5962,5
amort,1698,327,1426,1225,1284,5960,5
chaft,1512,927,1959,278,1284,5960,5
enfia,693,671,271,1963,2362,5960,5
skerl,2206,137,1421,1225,971,5960,5
vogul,404,3069,616,899,971,5959,5
ovary,532,126,1959,1225,2116,5958,5
nucha,647,1824,701,423,2362,5957,5
pujah,1184,1824,81,2214,654,5957,5
apiol,1698,336,1668,1282,971,5955,5
piwut,1184,2239,349,899,1284,5955,5
misgo,1225,2239,1021,612,857,5954,5
suyog,2206,1824,381,1282,261,5954,5
crisp,1512,1543,1668,945,285,5953,5
emony,693,327,1426,1391,2116,5953,5
runch,948,1824,1757,770,654,5953,5
bylaw,1555,458,1603,2214,122,5952,5
gluon,965,1193,990,1282,1522,5952,5
skout,2206,137,1426,899,1284,5952,5
edora,693,245,1426,1225,2362,5951,5
osela,532,341,1421,1295,2362,5951,5
alenu,1698,1193,1421,1391,247,5950,5
fungi,847,1824,1757,612,910,5950,5
broch,1555,1543,1426,770,654,5948,5
pyoid,1184,458,1426,1963,917,5948,5
cloud,1512,1193,1426,899,917,5947,5
wiltz,596,2239,1603,1385,122,5945,5
clabo,1512,1193,1959,423,857,5944,5
trigo,1264,1543,1668,612,857,5944,5
krang,789,1543,1959,1391,261,5943,5
outby,532,1824,1048,423,2116,5943,5
scalf,2206,338,1959,1295,145,5943,5
ketyl,789,2863,1048,271,971,5942,5
scalx,2206,338,1959,1295,144,5942,5
amino,1698,327,1668,1391,857,5941,5
unlit,420,671,1603,1963,1284,5941,5
jumba,446,1824,885,423,2362,5940,5
arock,1698,1543,1426,770,502,5939,5
crunk,1512,1543,990,1391,502,5938,5
plink,1184,1193,1668,1391,502,5938,5
ambit,1698,327,664,1963,1284,5936,5
clept,1512,1193,1421,526,1284,5936,5
young,225,3069,990,1391,261,5936,5
mitch,1225,2239,1048,770,654,5936,5
apsid,1698,336,1021,1963,917,5935,5
atwin,1698,403,349,1963,1522,5935,5
clift,1512,1193,1668,278,1284,5935,5
plash,1184,1193,1959,945,654,5935,5
pubic,1184,1824,664,1963,300,5935,5
decyl,1128,2863,701,271,971,5934,5
agent,1698,139,1421,1391,1284,5933,5
lisco,1046,2239,1021,770,857,5933,5
owena,532,226,1421,1391,2362,5932,5
philo,1184,927,1668,1295,857,5931,5
aucht,1698,1824,701,423,1284,5930,5
kusti,789,1824,1021,1385,910,5929,5
sting,2206,403,1668,1391,261,5929,5
trawl,1264,1543,1959,192,971,5929,5
omrah,532,327,2201,2214,654,5928,5
smirk,2206,327,1668,1225,502,5928,5
stonk,2206,403,1426,1391,502,5928,5
rugby,948,1824,616,423,2116,5927,5
tronc,1264,1543,1426,1391,300,5924,5
unbed,420,671,664,3252,917,5924,5
blitz,1555,1193,1668,1385,122,5923,5
hyman,844,458,885,2214,1522,5923,5
khano,789,927,1959,1391,857,5923,5
throu,1264,927,2201,1282,247,5921,5
wough,596,3069,990,612,654,5921,5
eglin,693,139,1603,1963,1522,5920,5
scalz,2206,338,1959,1295,122,5920,5
thewy,1264,927,1421,192,2116,5920,5
angil,1698,671,616,1963,971,5919,5
armyn,1698,1543,885,271,1522,5919,5
uloid,420,1193,1426,1963,917,5919,5
quelt,93,1824,1421,1295,1284,5917,5
hindu,844,2239,1757,829,247,5916,5
starw,2206,403,1959,1225,122,5915,5
egrid,693,139,2201,1963,917,5913,5
email,693,327,1959,1963,971,5913,5
pismo,1184,2239,1021,612,857,5913,5
swami,2206,226,1959,612,910,5913,5
wyver,596,458,417,3252,1190,5913,5
degum,1128,2863,616,899,406,5912,5
judah,446,1824,774,2214,654,5912,5
unram,420,671,2201,2214,406,5912,5
arvol,1698,1543,417,1282,971,5911,5
cramp,1512,1543,1959,612,285,5911,5
hsuan,844,341,990,2214,1522,5911,5
jingo,446,2239,1757,612,857,5911,5
fluid,847,1193,990,1963,917,5910,5
ikary,473,137,1959,1225,2116,5910,5
orwin,532,1543,349,1963,1522,5909,5
ulpan,420,1193,560,2214,1522,5909,5
prinz,1184,1543,1668,1391,122,5908,5
upget,420,336,616,3252,1284,5908,5
wrapt,596,1543,1959,526,1284,5908,5
dropt,1128,1543,1426,526,1284,5907,5
ludic,1046,1824,774,1963,300,5907,5
elgar,693,1193,616,2214,1190,5906,5
imber,473,327,664,3252,1190,5906,5
visto,404,2239,1021,1385,857,5906,5
hliod,844,1193,1668,1282,917,5904,5
sprug,2206,336,2201,899,261,5903,5
szold,2206,59,1426,1295,917,5903,5
byrom,1555,458,2201,1282,406,5902,5
drift,1128,1543,1668,278,1284,5901,5
eutaw,693,1824,1048,2214,122,5901,5
rebox,948,2863,664,1282,144,5901,5
duomi,1128,1824,1426,612,910,5900,5
slurp,2206,1193,990,1225,285,5899,5
klino,789,1193,1668,1391,857,5898,5
xenyl,36,2863,1757,271,971,5898,5
fungo,847,1824,1757,612,857,5897,5
idona,473,245,1426,1391,2362,5897,5
isola,473,341,1426,1295,2362,5897,5
jehol,446,2863,334,1282,971,5896,5
pitch,1184,2239,1048,770,654,5895,5
clasp,1512,1193,1959,945,285,5894,5
flank,847,1193,1959,1391,502,5892,5
kochi,789,3069,701,423,910,5892,5
aston,1698,341,1048,1282,1522,5891,5
ileon,473,1193,1421,1282,1522,5891,5
luzon,1046,1824,217,1282,1522,5891,5
minbu,1225,2239,1757,423,247,5891,5
ayond,1698,458,1426,1391,917,5890,5
sidhu,2206,2239,774,423,247,5889,5
vidor,404,2239,774,1282,1190,5889,5
acton,1698,338,1048,1282,1522,5888,5
blown,1555,1193,1426,192,1522,5888,5
butyr,1555,1824,1048,271,1190,5888,5
gyric,965,458,2201,1963,300,5887,5
piezo,1184,2239,1421,186,857,5887,5
vouch,404,3069,990,770,654,5887,5
brahm,1555,1543,1959,423,406,5886,5
ideta,473,245,1421,1385,2362,5886,5
anour,1698,671,1426,899,1190,5884,5
elath,693,1193,1959,1385,654,5884,5
guafo,965,1824,1959,278,857,5883,5
imola,473,327,1426,1295,2362,5883,5
vichy,404,2239,701,423,2116,5883,5
orpit,532,1543,560,1963,1284,5882,5
bruyn,1555,1543,990,271,1522,5881,5
juang,446,1824,1959,1391,261,5881,5
amuze,1698,327,990,186,2679,5880,5
aloft,1698,1193,1426,278,1284,5879,5
arzun,1698,1543,217,899,1522,5879,5
erdah,693,1543,774,2214,654,5878,5
olvan,532,1193,417,2214,1522,5878,5
opera,532,336,1421,1225,2362,5876,5
orgal,532,1543,616,2214,971,5876,5
idean,473,245,1421,2214,1522,5875,5
spekt,2206,336,1421,628,1284,5875,5
aleft,1698,1193,1421,278,1284,5874,5
disko,1128,2239,1021,628,857,5873,5
scarf,2206,338,1959,1225,145,5873,5
ulani,420,1193,1959,1391,910,5873,5
micht,1225,2239,701,423,1284,5872,5
skeif,2206,137,1421,1963,145,5872,5
upleg,420,336,1603,3252,261,5872,5
numac,647,1824,885,2214,300,5870,5
joshi,446,3069,1021,423,910,5869,5
wecht,596,2863,701,423,1284,5867,5
atmid,1698,403,885,1963,917,5866,5
oflem,532,73,1603,3252,406,5866,5
theol,1264,927,1421,1282,971,5865,5
primo,1184,1543,1668,612,857,5864,5
thawn,1264,927,1959,192,1522,5864,5
ursid,420,1543,1021,1963,917,5864,5
ernul,693,1543,1757,899,971,5863,5
thyme,1264,927,381,612,2679,5863,5
franz,847,1543,1959,1391,122,5862,5
kevyn,789,2863,417,271,1522,5862,5
hyrax,844,458,2201,2214,144,5861,5
kindu,789,2239,1757,829,247,5861,5
imune,473,327,990,1391,2679,5860,5
infer,473,671,271,3252,1190,5857,5
gladi,965,1193,1959,829,910,5856,5
twedy,1264,226,1421,829,2116,5856,5
froth,847,1543,1426,1385,654,5855,5
clerk,1512,1193,1421,1225,502,5853,5
kraft,789,1543,1959,278,1284,5853,5
umber,420,327,664,3252,1190,5853,5
funch,847,1824,1757,770,654,5852,5
butch,1555,1824,1048,770,654,5851,5
judon,446,1824,774,1282,1522,5848,5
aroph,1698,1543,1426,526,654,5847,5
unrwa,420,671,2201,192,2362,5846,5
writh,596,1543,1668,1385,654,5846,5
aught,1698,1824,616,423,1284,5845,5
clown,1512,1193,1426,192,1522,5845,5
synch,2206,458,1757,770,654,5845,5
tweil,1264,226,1421,1963,971,5845,5
flche,847,1193,701,423,2679,5843,5
kiehl,789,2239,1421,423,971,5843,5
xtian,36,403,1668,2214,1522,5843,5
zipah,176,2239,560,2214,654,5843,5
syftn,2206,458,271,1385,1522,5842,5
squam,2206,25,990,2214,406,5841,5
nicol,647,2239,701,1282,971,5840,5
stack,2206,403,1959,770,502,5840,5
alogi,1698,1193,1426,612,910,5839,5
ditch,1128,2239,1048,770,654,5839,5
strub,2206,403,2201,899,129,5838,5
uprid,420,336,2201,1963,917,5837,5
istle,473,341,1048,1295,2679,5836,5
ekron,693,137,2201,1282,1522,5835,5
ijore,473,32,1426,1225,2679,5835,5
risco,948,2239,1021,770,857,5835,5
chirk,1512,927,1668,1225,502,5834,5
erbil,693,1543,664,1963,971,5834,5
spahi,2206,336,1959,423,910,5834,5
clavi,1512,1193,1959,259,910,5833,5
pheni,1184,927,1421,1391,910,5833,5
xylan,36,458,1603,2214,1522,5833,5
evora,693,126,1426,1225,2362,5832,5
fibro,847,2239,664,1225,857,5832,5
mucro,1225,1824,701,1225,857,5832,5
alick,1698,1193,1668,770,502,5831,5
shock,2206,927,1426,770,502,5831,5
khuai,789,927,990,2214,910,5830,5
aneth,1698,671,1421,1385,654,5829,5
scuti,2206,338,990,1385,910,5829,5
quito,93,1824,1668,1385,857,5827,5
okean,532,137,1421,2214,1522,5826,5
oveta,532,126,1421,1385,2362,5826,5
busch,1555,1824,1021,770,654,5824,5
gnast,965,671,1959,945,1284,5824,5
asroc,1698,341,2201,1282,300,5822,5
cyton,1512,458,1048,1282,1522,5822,5
fuzil,847,1824,217,1963,971,5822,5
indre,473,671,774,1225,2679,5822,5
tholi,1264,927,1426,1295,910,5822,5
olent,532,1193,1421,1391,1284,5821,5
askew,1698,341,406,3252,122,5819,5
incle,473,671,701,1295,2679,5819,5
prich,1184,1543,1668,770,654,5819,5
stilu,2206,403,1668,1295,247,5819,5
artou,1698,1543,1048,1282,247,5818,5
enrol,693,671,2201,1282,971,5818,5
ibota,473,172,1426,1385,2362,5818,5
snick,2206,671,1668,770,502,5817,5
gulch,965,1824,1603,770,654,5816,5
humic,844,1824,885,1963,300,5816,5
debug,1128,2863,664,899,261,5815,5
jitro,446,2239,1048,1225,857,5815,5
quist,93,1824,1668,945,1284,5814,5
thuya,1264,927,990,271,2362,5814,5
glost,965,1193,1426,945,1284,5813,5
devow,1128,2863,417,1282,122,5812,5
drown,1128,1543,1426,192,1522,5811,5
brizo,1555,1543,1668,186,857,5809,5
oneal,532,671,1421,2214,971,5809,5
amroc,1698,327,2201,1282,300,5808,5
scaum,2206,338,1959,899,406,5808,5
snerp,2206,671,1421,1225,285,5808,5
woful,596,3069,271,899,971,5806,5
abort,1698,172,1426,1225,1284,5805,5
defog,1128,2863,271,1282,261,5805,5
oblat,532,172,1603,2214,1284,5805,5
prong,1184,1543,1426,1391,261,5805,5
druxy,1128,1543,990,26,2116,5803,5
slojd,2206,1193,1426,61,917,5803,5
throb,1264,927,2201,1282,129,5803,5
imper,473,327,560,3252,1190,5802,5
dekow,1128,2863,406,1282,122,5801,5
idola,473,245,1426,1295,2362,5801,5
niwot,647,2239,349,1282,1284,5801,5
runck,948,1824,1757,770,502,5801,5
abert,1698,172,1421,1225,1284,5800,5
chauk,1512,927,1959,899,502,5799,5
kumni,789,1824,885,1391,910,5799,5
physa,1184,927,381,945,2362,5799,5
zinco,176,2239,1757,770,857,5799,5
ebony,693,172,1426,1391,2116,5798,5
jumpy,446,1824,885,526,2116,5797,5
brock,1555,1543,1426,770,502,5796,5
throw,1264,927,2201,1282,122,5796,5
vijao,404,2239,81,2214,857,5795,5
drawl,1128,1543,1959,192,971,5793,5
breck,1555,1543,1421,770,502,5791,5
eusol,693,1824,1021,1282,971,5791,5
gnarl,965,671,1959,1225,971,5791,5
inula,473,671,990,1295,2362,5791,5
jokul,446,3069,406,899,971,5791,5
oxide,532,83,1668,829,2679,5791,5
rhino,948,927,1668,1391,857,5791,5
brogh,1555,1543,1426,612,654,5790,5
whand,596,927,1959,1391,917,5790,5
alisp,1698,1193,1668,945,285,5789,5
ikona,473,137,1426,1391,2362,5789,5
scruf,2206,338,2201,899,145,5789,5
sherj,2206,927,1421,1225,10,5789,5
wrest,596,1543,1421,945,1284,5789,5
elvin,693,1193,417,1963,1522,5788,5
olepy,532,1193,1421,526,2116,5788,5
urson,420,1543,1021,1282,1522,5788,5
emory,693,327,1426,1225,2116,5787,5
might,1225,2239,616,423,1284,5787,5
stirp,2206,403,1668,1225,285,5787,5
drisk,1128,1543,1668,945,502,5786,5
tsuda,1264,341,990,829,2362,5786,5
ashly,1698,341,334,1295,2116,5784,5
whatd,596,927,1959,1385,917,5784,5
clong,1512,1193,1426,1391,261,5783,5
bshec,1555,341,334,3252,300,5782,5
dhoni,1128,927,1426,1391,910,5782,5
wiyot,596,2239,381,1282,1284,5782,5
fultz,847,1824,1603,1385,122,5781,5
quirl,93,1824,1668,1225,971,5781,5
tharm,1264,927,1959,1225,406,5781,5
intra,473,671,1048,1225,2362,5779,5
elkin,693,1193,406,1963,1522,5777,5
flurn,847,1193,990,1225,1522,5777,5
dhoti,1128,927,1426,1385,910,5776,5
liszt,1046,2239,1021,186,1284,5776,5
dicht,1128,2239,701,423,1284,5775,5
elsah,693,1193,1021,2214,654,5775,5
fluky,847,1193,990,628,2116,5774,5
scrub,2206,338,2201,899,129,5773,5
spack,2206,336,1959,770,502,5773,5
vitro,404,2239,1048,1225,857,5773,5
efron,693,73,2201,1282,1522,5771,5
jough,446,3069,990,612,654,5771,5
algic,1698,1193,616,1963,300,5770,5
intue,473,671,1048,899,2679,5770,5
nicut,647,2239,701,899,1284,5770,5
trelu,1264,1543,1421,1295,247,5770,5
idose,473,245,1426,945,2679,5768,5
glout,965,1193,1426,899,1284,5767,5
cynth,1512,458,1757,1385,654,5766,5
ulvan,420,1193,417,2214,1522,5766,5
uncle,420,671,701,1295,2679,5766,5
ozena,532,59,1421,1391,2362,5765,5
smack,2206,327,1959,770,502,5764,5
smift,2206,327,1668,278,1284,5763,5
stork,2206,403,1426,1225,502,5762,5
swarf,2206,226,1959,1225,145,5761,5
bjorn,1555,32,1426,1225,1522,5760,5
spelk,2206,336,1421,1295,502,5760,5
ching,1512,927,1668,1391,261,5759,5
chonk,1512,927,1426,1391,502,5758,5
mylor,1225,458,1603,1282,1190,5758,5
knowe,789,671,1426,192,2679,5757,5
litch,1046,2239,1048,770,654,5757,5
sterk,2206,403,1421,1225,502,5757,5
pruth,1184,1543,990,1385,654,5756,5
xylem,36,458,1603,3252,406,5755,5
amend,1698,327,1421,1391,917,5754,5
avert,1698,126,1421,1225,1284,5754,5
armco,1698,1543,885,770,857,5753,5
entry,693,671,1048,1225,2116,5753,5
nikau,647,2239,406,2214,247,5753,5
staup,2206,403,1959,899,285,5752,5
swing,2206,226,1668,1391,261,5752,5
think,1264,927,1668,1391,502,5752,5
swonk,2206,226,1426,1391,502,5751,5
urbai,420,1543,664,2214,910,5751,5
mukti,1225,1824,406,1385,910,5750,5
musci,1225,1824,1021,770,910,5750,5
rislu,948,2239,1021,1295,247,5750,5
struv,2206,403,2201,899,41,5750,5
upbay,420,336,664,2214,2116,5750,5
wrang,596,1543,1959,1391,261,5750,5
chasm,1512,927,1959,945,406,5749,5
pisum,1184,2239,1021,899,406,5749,5
enrut,693,671,2201,899,1284,5748,5
isode,473,341,1426,829,2679,5748,5
staph,2206,403,1959,526,654,5748,5
trick,1264,1543,1668,770,502,5747,5
pight,1184,2239,616,423,1284,5746,5
prism,1184,1543,1668,945,406,5746,5
thegn,1264,927,1421,612,1522,5746,5
redug,948,2863,774,899,261,5745,5
dreng,1128,1543,1421,1391,261,5744,5
arjun,1698,1543,81,899,1522,5743,5
insue,473,671,1021,899,2679,5743,5
slurb,2206,1193,990,1225,129,5743,5
udela,420,245,1421,1295,2362,5743,5
awkly,1698,226,406,1295,2116,5741,5
vetch,404,2863,1048,770,654,5739,5
chirm,1512,927,1668,1225,406,5738,5
elton,693,1193,1048,1282,1522,5738,5
grift,965,1543,1668,278,1284,5738,5
shkod,2206,927,406,1282,917,5738,5
guyot,965,1824,381,1282,1284,5736,5
coypu,1512,3069,381,526,247,5735,5
agist,1698,139,1668,945,1284,5734,5
ingle,473,671,616,1295,2679,5734,5
bushi,1555,1824,1021,423,910,5733,5
hyrst,844,458,2201,945,1284,5732,5
pregl,1184,1543,1421,612,971,5731,5
quasi,93,1824,1959,945,910,5731,5
vigor,404,2239,616,1282,1190,5731,5
closh,1512,1193,1426,945,654,5730,5
yeung,225,2863,990,1391,261,5730,5
dipso,1128,2239,560,945,857,5729,5
spurl,2206,336,990,1225,971,5728,5
agrom,1698,139,2201,1282,406,5726,5
acmon,1698,338,885,1282,1522,5725,5
orest,532,1543,1421,945,1284,5725,5
enoil,693,671,1426,1963,971,5724,5
croyl,1512,1543,1426,271,971,5723,5
nizam,647,2239,217,2214,406,5723,5
anvil,1698,671,417,1963,971,5720,5
elwin,693,1193,349,1963,1522,5720,5
glink,965,1193,1668,1391,502,5719,5
glori,965,1193,1426,1225,910,5719,5
inked,473,671,406,3252,917,5719,5
kylah,789,458,1603,2214,654,5718,5
ocker,532,338,406,3252,1190,5718,5
visct,404,2239,1021,770,1284,5718,5
qursh,93,1824,2201,945,654,5717,5
slemp,2206,1193,1421,612,285,5717,5
spitz,2206,336,1668,1385,122,5717,5
avrom,1698,126,2201,1282,406,5713,5
flawn,847,1193,1959,192,1522,5713,5
adrop,1698,245,2201,1282,285,5711,5
elson,693,1193,1021,1282,1522,5711,5
other,532,403,334,3252,1190,5711,5
ulent,420,1193,1421,1391,1284,5709,5
fremt,847,1543,1421,612,1284,5707,5
vinum,404,2239,1757,899,406,5705,5
ahong,1698,927,1426,1391,261,5703,5
chaum,1512,927,1959,899,406,5703,5
kunbi,789,1824,1757,423,910,5703,5
bught,1555,1824,616,423,1284,5702,5
fingu,847,2239,1757,612,247,5702,5
insep,473,671,1021,3252,285,5702,5
isnad,473,341,1757,2214,917,5702,5
isbel,473,341,664,3252,971,5701,5
pharm,1184,927,1959,1225,406,5701,5
stich,2206,403,1668,770,654,5701,5
stilb,2206,403,1668,1295,129,5701,5
bsche,1555,341,701,423,2679,5699,5
grasp,965,1543,1959,945,285,5697,5
thrum,1264,927,2201,899,406,5697,5
trego,1264,1543,1421,612,857,5697,5
plonk,1184,1193,1426,1391,502,5696,5
xhosa,36,927,1426,945,2362,5696,5
gismo,965,2239,1021,612,857,5694,5
jumby,446,1824,885,423,2116,5694,5
thero,1264,927,1421,1225,857,5694,5
licht,1046,2239,701,423,1284,5693,5
kranj,789,1543,1959,1391,10,5692,5
xicak,36,2239,701,2214,502,5692,5
acost,1698,338,1426,945,1284,5691,5
abilo,1698,172,1668,1295,857,5690,5
dight,1128,2239,616,423,1284,5690,5
shawm,2206,927,1959,192,406,5690,5
trunk,1264,1543,990,1391,502,5690,5
blick,1555,1193,1668,770,502,5688,5
brevi,1555,1543,1421,259,910,5688,5
cleft,1512,1193,1421,278,1284,5688,5
brush,1555,1543,990,945,654,5687,5
plasm,1184,1193,1959,945,406,5687,5
scaup,2206,338,1959,899,285,5687,5
stong,2206,403,1426,1391,261,5687,5
kechi,789,2863,701,423,910,5686,5
orang,532,1543,1959,1391,261,5686,5
gyani,965,458,1959,1391,910,5683,5
bligh,1555,1193,1668,612,654,5682,5
steng,2206,403,1421,1391,261,5682,5
tembu,1264,2863,885,423,247,5682,5
smerk,2206,327,1421,1225,502,5681,5
antic,1698,671,1048,1963,300,5680,5
cylix,1512,458,1603,1963,144,5680,5
wharl,596,927,1959,1225,971,5678,5
rompu,948,3069,885,526,247,5675,5
upeat,420,336,1421,2214,1284,5675,5
wyman,596,458,885,2214,1522,5675,5
acold,1698,338,1426,1295,917,5674,5
atelo,1698,403,1421,1295,857,5674,5
ilyse,473,1193,381,945,2679,5671,5
sylow,2206,458,1603,1282,122,5671,5
butyl,1555,1824,1048,271,971,5669,5
mitzl,1225,2239,1048,186,971,5669,5
showd,2206,927,1426,192,917,5668,5
timbo,1264,2239,885,423,857,5668,5
prick,1184,1543,1668,770,502,5667,5
scawl,2206,338,1959,192,971,5666,5
storm,2206,403,1426,1225,406,5666,5
thulr,1264,927,990,1295,1190,5666,5
unked,420,671,406,3252,917,5666,5
cryst,1512,1543,381,945,1284,5665,5
croup,1512,1543,1426,899,285,5665,5
spawl,2206,336,1959,192,971,5664,5
hydra,844,458,774,1225,2362,5663,5
swack,2206,226,1959,770,502,5663,5
swept,2206,226,1421,526,1284,5663,5
tramp,1264,1543,1959,612,285,5663,5
msent,1225,341,1421,1391,1284,5662,5
swift,2206,226,1668,278,1284,5662,5
stipo,2206,403,1668,526,857,5660,5
tharp,1264,927,1959,1225,285,5660,5
icker,473,338,406,3252,1190,5659,5
ritch,948,2239,1048,770,654,5659,5
bsagr,1555,341,1959,612,1190,5657,5
enrib,693,671,2201,1963,129,5657,5
troch,1264,1543,1426,770,654,5657,5
ergon,693,1543,616,1282,1522,5656,5
thilk,1264,927,1668,1295,502,5656,5
junco,446,1824,1757,770,857,5654,5
lythe,1046,458,1048,423,2679,5654,5
octan,532,338,1048,2214,1522,5654,5
ither,473,403,334,3252,1190,5652,5
flang,847,1193,1959,1391,261,5651,5
guelf,965,1824,1421,1295,145,5650,5
archt,1698,1543,701,423,1284,5649,5
flout,847,1193,1426,899,1284,5649,5
osher,532,341,334,3252,1190,5649,5
grown,965,1543,1426,192,1522,5648,5
yoshi,225,3069,1021,423,910,5648,5
width,596,2239,774,1385,654,5648,5
graph,965,1543,1959,526,654,5647,5
kyoga,789,458,1426,612,2362,5647,5
ureic,420,1543,1421,1963,300,5647,5
cdrom,1512,245,2201,1282,406,5646,5
ocher,532,338,334,3252,1190,5646,5
sweyn,2206,226,1421,271,1522,5646,5
albur,1698,1193,664,899,1190,5644,5
crowl,1512,1543,1426,192,971,5644,5
crush,1512,1543,990,945,654,5644,5
kingu,789,2239,1757,612,247,5644,5
apout,1698,336,1426,899,1284,5643,5
pyotr,1184,458,1426,1385,1190,5643,5
elfin,693,1193,271,1963,1522,5642,5
vinyl,404,2239,1757,271,971,5642,5
friml,847,1543,1668,612,971,5641,5
cymba,1512,458,885,423,2362,5640,5
chiou,1512,927,1668,1282,247,5636,5
jupon,446,1824,560,1282,1522,5634,5
umbel,420,327,664,3252,971,5634,5
axton,1698,83,1048,1282,1522,5633,5
browd,1555,1543,1426,192,917,5633,5
imbed,473,327,664,3252,917,5633,5
bchar,1555,338,334,2214,1190,5631,5
blunk,1555,1193,990,1391,502,5631,5
khvat,789,927,417,2214,1284,5631,5
wylma,596,458,1603,612,2362,5631,5
shedu,2206,927,1421,829,247,5630,5
shutz,2206,927,990,1385,122,5630,5
oujda,532,1824,81,829,2362,5628,5
redux,948,2863,774,899,144,5628,5
freud,847,1543,1421,899,917,5627,5
kleig,789,1193,1421,1963,261,5627,5
tweak,1264,226,1421,2214,502,5627,5
flype,847,1193,381,526,2679,5626,5
churl,1512,927,990,1225,971,5625,5
smich,2206,327,1668,770,654,5625,5
hokum,844,3069,406,899,406,5624,5
afton,1698,73,1048,1282,1522,5623,5
hybla,844,458,664,1295,2362,5623,5
utica,420,403,1668,770,2362,5623,5
biysk,1555,2239,381,945,502,5622,5
ovule,532,126,990,1295,2679,5622,5
dhyal,1128,927,381,2214,971,5621,5
frack,847,1543,1959,770,502,5621,5
crimp,1512,1543,1668,612,285,5620,5
spong,2206,336,1426,1391,261,5620,5
chirp,1512,927,1668,1225,285,5617,5
atour,1698,403,1426,899,1190,5616,5
adyge,1698,245,381,612,2679,5615,5
andor,1698,671,774,1282,1190,5615,5
knarl,789,671,1959,1225,971,5615,5
mufti,1225,1824,271,1385,910,5615,5
quadi,93,1824,1959,829,910,5615,5
otway,532,403,349,2214,2116,5614,5
litho,1046,2239,1048,423,857,5613,5
redub,948,2863,774,899,129,5613,5
unsty,420,671,1021,1385,2116,5613,5
crawm,1512,1543,1959,192,406,5612,5
scawd,2206,338,1959,192,917,5612,5
dheri,1128,927,1421,1225,910,5611,5
frust,847,1543,990,945,1284,5609,5
pluto,1184,1193,990,1385,857,5609,5
unwed,420,671,349,3252,917,5609,5
hyoid,844,458,1426,1963,917,5608,5
light,1046,2239,616,423,1284,5608,5
plack,1184,1193,1959,770,502,5608,5
switz,2206,226,1668,1385,122,5607,5
axson,1698,83,1021,1282,1522,5606,5
uplit,420,336,1603,1963,1284,5606,5
lyard,1046,458,1959,1225,917,5605,5
thuja,1264,927,990,61,2362,5604,5
wroth,596,1543,1426,1385,654,5604,5
csiro,1512,341,1668,1225,857,5603,5
quark,93,1824,1959,1225,502,5603,5
flori,847,1193,1426,1225,910,5601,5
ileac,473,1193,1421,2214,300,5601,5
abend,1698,172,1421,1391,917,5599,5
uther,420,403,334,3252,1190,5599,5
bloch,1555,1193,1426,770,654,5598,5
flash,847,1193,1959,945,654,5598,5
inrol,473,671,2201,1282,971,5598,5
onega,532,671,1421,612,2362,5598,5
ental,693,671,1048,2214,971,5597,5
strpg,2206,403,2201,526,261,5597,5
omuta,532,327,990,1385,2362,5596,5
mujik,1225,1824,81,1963,502,5595,5
richt,948,2239,701,423,1284,5595,5
nvram,647,126,2201,2214,406,5594,5
sperm,2206,336,1421,1225,406,5594,5
adest,1698,245,1421,945,1284,5593,5
almud,1698,1193,885,899,917,5592,5
crowd,1512,1543,1426,192,917,5590,5
mukri,1225,1824,406,1225,910,5590,5
clunk,1512,1193,990,1391,502,5588,5
aweto,1698,226,1421,1385,857,5587,5
efram,693,73,2201,2214,406,5587,5
ervil,693,1543,417,1963,971,5587,5
aleck,1698,1193,1421,770,502,5584,5
mysid,1225,458,1021,1963,917,5584,5
impel,473,327,560,3252,971,5583,5
jutic,446,1824,1048,1963,300,5581,5
spohr,2206,336,1426,423,1190,5581,5
chiru,1512,927,1668,1225,247,5579,5
alrzc,1698,1193,2201,186,300,5578,5
ixtle,473,83,1048,1295,2679,5578,5
azofy,1698,59,1426,278,2116,5577,5
qualm,93,1824,1959,1295,406,5577,5
njave,647,32,1959,259,2679,5576,5
snock,2206,671,1426,770,502,5575,5
xyrid,36,458,2201,1963,917,5575,5
awest,1698,226,1421,945,1284,5574,5
oxime,532,83,1668,612,2679,5574,5
unlid,420,671,1603,1963,917,5574,5
skift,2206,137,1668,278,1284,5573,5
fujio,847,1824,81,1963,857,5572,5
gulph,965,1824,1603,526,654,5572,5
stelu,2206,403,1421,1295,247,5572,5
whaur,596,927,1959,899,1190,5571,5
sneck,2206,671,1421,770,502,5570,5
ixora,473,83,1426,1225,2362,5569,5
tsuga,1264,341,990,612,2362,5569,5
tsuma,1264,341,990,612,2362,5569,5
cybil,1512,458,664,1963,971,5568,5
rybat,948,458,664,2214,1284,5568,5
quest,93,1824,1421,945,1284,5567,5
agend,1698,139,1421,1391,917,5566,5
adorl,1698,245,1426,1225,971,5565,5
bucko,1555,1824,701,628,857,5565,5
fritz,847,1543,1668,1385,122,5565,5
khoja,789,927,1426,61,2362,5565,5
ngaio,647,139,1959,1963,857,5565,5
squab,2206,25,990,2214,129,5564,5
wheam,596,927,1421,2214,406,5564,5
wisht,596,2239,1021,423,1284,5563,5
chawl,1512,927,1959,192,971,5561,5
clamp,1512,1193,1959,612,285,5561,5
linyu,1046,2239,1757,271,247,5560,5
astor,1698,341,1048,1282,1190,5559,5
edman,693,245,885,2214,1522,5559,5
rheic,948,927,1421,1963,300,5559,5
fitch,847,2239,1048,770,654,5558,5
oneil,532,671,1421,1963,971,5558,5
kragh,789,1543,1959,612,654,5557,5
squaw,2206,25,990,2214,122,5557,5
actor,1698,338,1048,1282,1190,5556,5
greco,965,1543,1421,770,857,5556,5
flour,847,1193,1426,899,1190,5555,5
frodi,847,1543,1426,829,910,5555,5
drunk,1128,1543,990,1391,502,5554,5
iztle,473,59,1048,1295,2679,5554,5
vodum,404,3069,774,899,406,5552,5
iapyx,473,4103,560,271,144,5551,5
fleur,847,1193,1421,899,1190,5550,5
fredi,847,1543,1421,829,910,5550,5
koshu,789,3069,1021,423,247,5549,5
stick,2206,403,1668,770,502,5549,5
cydon,1512,458,774,1282,1522,5548,5
ghost,965,927,1426,945,1284,5547,5
rhyme,948,927,381,612,2679,5547,5
tyson,1264,458,1021,1282,1522,5547,5
eniac,693,671,1668,2214,300,5546,5
klimt,789,1193,1668,612,1284,5546,5
scelp,2206,338,1421,1295,285,5545,5
skuld,2206,137,990,1295,917,5545,5
ascon,1698,341,701,1282,1522,5544,5
inoma,473,671,1426,612,2362,5544,5
entad,693,671,1048,2214,917,5543,5
untar,420,671,1048,2214,1190,5543,5
windz,596,2239,1757,829,122,5543,5
ancor,1698,671,701,1282,1190,5542,5
dhikr,1128,927,1668,628,1190,5541,5
amour,1698,327,1426,899,1190,5540,5
unrip,420,671,2201,1963,285,5540,5
flurt,847,1193,990,1225,1284,5539,5
rozum,948,3069,217,899,406,5539,5
hubli,844,1824,664,1295,910,5537,5
usher,420,341,334,3252,1190,5537,5
chyak,1512,927,381,2214,502,5536,5
trudi,1264,1543,990,829,910,5536,5
brusk,1555,1543,990,945,502,5535,5
jizya,446,2239,217,271,2362,5535,5
myton,1225,458,1048,1282,1522,5535,5
erund,693,1543,990,1391,917,5534,5
querl,93,1824,1421,1225,971,5534,5
justo,446,1824,1021,1385,857,5533,5
upher,420,336,334,3252,1190,5532,5
fisch,847,2239,1021,770,654,5531,5
unfed,420,671,271,3252,917,5531,5
frown,847,1543,1426,192,1522,5530,5
khasi,789,927,1959,945,910,5530,5
shoji,2206,927,1426,61,910,5530,5
imped,473,327,560,3252,917,5529,5
amero,1698,327,1421,1225,857,5528,5
twyla,1264,226,381,1295,2362,5528,5
cleuk,1512,1193,1421,899,502,5527,5
ophia,532,336,334,1963,2362,5527,5
ashir,1698,341,334,1963,1190,5526,5
tyche,1264,458,701,423,2679,5525,5
inkle,473,671,406,1295,2679,5524,5
japyx,446,4103,560,271,144,5524,5
unsly,420,671,1021,1295,2116,5523,5
jocum,446,3069,701,899,406,5521,5
mutch,1225,1824,1048,770,654,5521,5
skirp,2206,137,1668,1225,285,5521,5
tharf,1264,927,1959,1225,145,5520,5
chong,1512,927,1426,1391,261,5517,5
ovida,532,126,1668,829,2362,5517,5
drusi,1128,1543,990,945,910,5516,5
unrig,420,671,2201,1963,261,5516,5
flect,847,1193,1421,770,1284,5515,5
prahm,1184,1543,1959,423,406,5515,5
jesup,446,2863,1021,899,285,5514,5
eucti,693,1824,701,1385,910,5513,5
adult,1698,245,990,1295,1284,5512,5
bruch,1555,1543,990,770,654,5512,5
cheng,1512,927,1421,1391,261,5512,5
junko,446,1824,1757,628,857,5512,5
luxor,1046,1824,170,1282,1190,5512,5
adoxy,1698,245,1426,26,2116,5511,5
thing,1264,927,1668,1391,261,5511,5
right,948,2239,616,423,1284,5510,5
aluco,1698,1193,990,770,857,5508,5
knaur,789,671,1959,899,1190,5508,5
pylic,1184,458,1603,1963,300,5508,5
unsex,420,671,1021,3252,144,5508,5
likud,1046,2239,406,899,917,5507,5
animo,1698,671,1668,612,857,5506,5
frisk,847,1543,1668,945,502,5505,5
indra,473,671,774,1225,2362,5505,5
trock,1264,1543,1426,770,502,5505,5
arsyl,1698,1543,1021,271,971,5504,5
dibru,1128,2239,664,1225,247,5503,5
orpah,532,1543,560,2214,654,5503,5
fluor,847,1193,990,1282,1190,5502,5
hijaz,844,2239,81,2214,122,5500,5
ecart,693,338,1959,1225,1284,5499,5
drouk,1128,1543,1426,899,502,5498,5
indue,473,671,774,899,2679,5496,5
ljoka,1046,32,1426,628,2362,5494,5
osman,532,341,885,2214,1522,5494,5
ambon,1698,327,664,1282,1522,5493,5
shurf,2206,927,990,1225,145,5493,5
aleph,1698,1193,1421,526,654,5492,5
stunk,2206,403,990,1391,502,5492,5
necho,647,2863,701,423,857,5491,5
steyr,2206,403,1421,271,1190,5491,5
hugli,844,1824,616,1295,910,5489,5
nowch,647,3069,349,770,654,5489,5
thund,1264,927,990,1391,917,5489,5
uckia,420,338,406,1963,2362,5489,5
mexsp,1225,2863,170,945,285,5488,5
swazi,2206,226,1959,186,910,5487,5
unsew,420,671,1021,3252,122,5486,5
awink,1698,226,1668,1391,502,5485,5
spick,2206,336,1668,770,502,5482,5
blayk,1555,1193,1959,271,502,5480,5
skimo,2206,137,1668,612,857,5480,5
about,1698,172,1426,899,1284,5479,5
acryl,1698,338,2201,271,971,5479,5
alsop,1698,1193,1021,1282,285,5479,5
quink,93,1824,1668,1391,502,5478,5
umped,420,327,560,3252,917,5476,5
quash,93,1824,1959,945,654,5475,5
queri,93,1824,1421,1225,910,5473,5
licko,1046,2239,701,628,857,5471,5
typal,1264,458,560,2214,971,5467,5
abstr,1698,172,1021,1385,1190,5466,5
cyndi,1512,458,1757,829,910,5466,5
efrap,693,73,2201,2214,285,5466,5
phyma,1184,927,381,612,2362,5466,5
snowl,2206,671,1426,192,971,5466,5
skelm,2206,137,1421,1295,406,5465,5
stamp,2206,403,1959,612,285,5465,5
eldon,693,1193,774,1282,1522,5464,5
kniaz,789,671,1668,2214,122,5464,5
cumyl,1512,1824,885,271,971,5463,5
zombi,176,3069,885,423,910,5463,5
iduna,473,245,990,1391,2362,5461,5
knelt,789,671,1421,1295,1284,5460,5
wring,596,1543,1668,1391,261,5459,5
orach,532,1543,1959,770,654,5458,5
whort,596,927,1426,1225,1284,5458,5
angor,1698,671,616,1282,1190,5457,5
mboya,1225,172,1426,271,2362,5456,5
prudi,1184,1543,990,829,910,5456,5
stech,2206,403,1421,770,654,5454,5
evant,693,126,1959,1391,1284,5453,5
unoil,420,671,1426,1963,971,5451,5
khond,789,927,1426,1391,917,5450,5
limbo,1046,2239,885,423,857,5450,5
itsec,473,403,1021,3252,300,5449,5
phyfe,1184,927,381,278,2679,5449,5
abdon,1698,172,774,1282,1522,5448,5
adcon,1698,245,701,1282,1522,5448,5
sylph,2206,458,1603,526,654,5447,5
azoic,1698,59,1426,1963,300,5446,5
block,1555,1193,1426,770,502,5446,5
flask,847,1193,1959,945,502,5446,5
pyche,1184,458,701,423,2679,5445,5
bumph,1555,1824,885,526,654,5444,5
zinck,176,2239,1757,770,502,5444,5
crwth,1512,1543,349,1385,654,5443,5
fulvi,847,1824,1603,259,910,5443,5
gynic,965,458,1757,1963,300,5443,5
pygal,1184,458,616,2214,971,5443,5
zilch,176,2239,1603,770,654,5442,5
bleck,1555,1193,1421,770,502,5441,5
epiky,693,336,1668,628,2116,5441,5
chelp,1512,927,1421,1295,285,5440,5
tflap,1264,73,1603,2214,285,5439,5
abord,1698,172,1426,1225,917,5438,5
novum,647,3069,417,899,406,5438,5
omura,532,327,990,1225,2362,5436,5
ontal,532,671,1048,2214,971,5436,5
trabu,1264,1543,1959,423,247,5436,5
isman,473,341,885,2214,1522,5435,5
upway,420,336,349,2214,2116,5435,5
swelp,2206,226,1421,1295,285,5433,5
incra,473,671,701,1225,2362,5432,5
schwa,2206,338,334,192,2362,5432,5
azyme,1698,59,381,612,2679,5429,5
prebo,1184,1543,1421,423,857,5428,5
ombre,532,327,664,1225,2679,5427,5
ritsu,948,2239,1048,945,247,5427,5
orvil,532,1543,417,1963,971,5426,5
spunk,2206,336,990,1391,502,5425,5
dutch,1128,1824,1048,770,654,5424,5
pharb,1184,927,1959,1225,129,5424,5
glaum,965,1193,1959,899,406,5422,5
thack,1264,927,1959,770,502,5422,5
ating,1698,403,1668,1391,261,5421,5
eryon,693,1543,381,1282,1522,5421,5
phasm,1184,927,1959,945,406,5421,5
apocr,1698,336,1426,770,1190,5420,5
orpha,532,1543,560,423,2362,5420,5
whist,596,927,1668,945,1284,5420,5
igfet,473,139,271,3252,1284,5419,5
ergot,693,1543,616,1282,1284,5418,5
ingem,473,671,616,3252,406,5418,5
troup,1264,1543,1426,899,285,5417,5
frosh,847,1543,1426,945,654,5415,5
khadi,789,927,1959,829,910,5414,5
yupon,225,1824,560,1282,1522,5413,5
kombu,789,3069,885,423,247,5413,5
shemu,2206,927,1421,612,247,5413,5
awhir,1698,226,334,1963,1190,5411,5
dyson,1128,458,1021,1282,1522,5411,5
extra,693,83,1048,1225,2362,5411,5
tymon,1264,458,885,1282,1522,5411,5
fresh,847,1543,1421,945,654,5410,5
fight,847,2239,616,423,1284,5409,5
oleic,532,1193,1421,1963,300,5409,5
anzio,1698,671,217,1963,857,5406,5
clamb,1512,1193,1959,612,129,5405,5
grewt,965,1543,1421,192,1284,5405,5
kreng,789,1543,1421,1391,261,5405,5
bijou,1555,2239,81,1282,247,5404,5
inmew,473,671,885,3252,122,5403,5
nephi,647,2863,560,423,910,5403,5
edric,693,245,2201,1963,300,5402,5
miscf,1225,2239,1021,770,145,5400,5
scamp,2206,338,1959,612,285,5400,5
fusht,847,1824,1021,423,1284,5399,5
repub,948,2863,560,899,129,5399,5
cheki,1512,927,1421,628,910,5398,5
dzoba,1128,59,1426,423,2362,5398,5
kythe,789,458,1048,423,2679,5397,5
trush,1264,1543,990,945,654,5396,5
shuck,2206,927,990,770,502,5395,5
usant,420,341,1959,1391,1284,5395,5
scolb,2206,338,1426,1295,129,5394,5
antiq,1698,671,1048,1963,9,5389,5
dyche,1128,458,701,423,2679,5389,5
glack,965,1193,1959,770,502,5389,5
dygal,1128,458,616,2214,971,5387,5
ewart,693,226,1959,1225,1284,5387,5
whirl,596,927,1668,1225,971,5387,5
glomr,965,1193,1426,612,1190,5386,5
tweag,1264,226,1421,2214,261,5386,5
umble,420,327,664,1295,2679,5385,5
etiam,693,403,1668,2214,406,5384,5
quoth,93,1824,1426,1385,654,5382,5
storz,2206,403,1426,1225,122,5382,5
averi,1698,126,1421,1225,910,5380,5
cwlth,1512,226,1603,1385,654,5380,5
tsuba,1264,341,990,423,2362,5380,5
amido,1698,327,1668,829,857,5379,5
onfre,532,671,271,1225,2679,5378,5
enact,693,671,1959,770,1284,5377,5
snurp,2206,671,990,1225,285,5377,5
thurl,1264,927,990,1225,971,5377,5
wynot,596,458,1757,1282,1284,5377,5
guijo,965,1824,1668,61,857,5375,5
whank,596,927,1959,1391,502,5375,5
opsin,532,336,1021,1963,1522,5374,5
upjet,420,336,81,3252,1284,5373,5
swick,2206,226,1668,770,502,5372,5
scouk,2206,338,1426,899,502,5371,5
wrack,596,1543,1959,770,502,5370,5
msche,1225,341,701,423,2679,5369,5
ivory,473,126,1426,1225,2116,5366,5
rydal,948,458,774,2214,971,5365,5
dreck,1128,1543,1421,770,502,5364,5
gramp,965,1543,1959,612,285,5364,5
drogh,1128,1543,1426,612,654,5363,5
hepzi,844,2863,560,186,910,5363,5
snafu,2206,671,1959,278,247,5361,5
fling,847,1193,1668,1391,261,5360,5
orvah,532,1543,417,2214,654,5360,5
clawk,1512,1193,1959,192,502,5358,5
nitch,647,2239,1048,770,654,5358,5
acing,1698,338,1668,1391,261,5356,5
griph,965,1543,1668,526,654,5356,5
prahu,1184,1543,1959,423,247,5356,5
aping,1698,336,1668,1391,261,5354,5
brugh,1555,1543,990,612,654,5354,5
dwelt,1128,226,1421,1295,1284,5354,5
ilysa,473,1193,381,945,2362,5354,5
twirl,1264,226,1668,1225,971,5354,5
fplot,847,336,1603,1282,1284,5352,5
idant,473,245,1959,1391,1284,5352,5
dhoul,1128,927,1426,899,971,5351,5
unmew,420,671,885,3252,122,5350,5
albyn,1698,1193,664,271,1522,5348,5
clung,1512,1193,990,1391,261,5347,5
dhabi,1128,927,1959,423,910,5347,5
gudok,965,1824,774,1282,502,5347,5
ingra,473,671,616,1225,2362,5347,5
skelp,2206,137,1421,1295,285,5344,5
twank,1264,226,1959,1391,502,5342,5
druci,1128,1543,990,770,910,5341,5
embla,693,327,664,1295,2362,5341,5
dhuti,1128,927,990,1385,910,5340,5
fremd,847,1543,1421,612,917,5340,5
hymir,844,458,885,1963,1190,5340,5
avour,1698,126,1426,899,1190,5339,5
droyl,1128,1543,1426,271,971,5339,5
blush,1555,1193,990,945,654,5337,5
ecoid,693,338,1426,1963,917,5337,5
osric,532,341,2201,1963,300,5337,5
pflag,1184,73,1603,2214,261,5335,5
glitz,965,1193,1668,1385,122,5333,5
plotx,1184,1193,1426,1385,144,5332,5
thruv,1264,927,2201,899,41,5332,5
uzial,420,59,1668,2214,971,5332,5
vizor,404,2239,217,1282,1190,5332,5
edroi,693,245,2201,1282,910,5331,5
sculk,2206,338,990,1295,502,5331,5
frick,847,1543,1668,770,502,5330,5
nejdi,647,2863,81,829,910,5330,5
omlah,532,327,1603,2214,654,5330,5
ziwot,176,2239,349,1282,1284,5330,5
chego,1512,927,1421,612,857,5329,5
erich,693,1543,1668,770,654,5328,5
sturk,2206,403,990,1225,502,5326,5
azoxy,1698,59,1426,26,2116,5325,5
drawk,1128,1543,1959,192,502,5324,5
ideal,473,245,1421,2214,971,5324,5
amund,1698,327,990,1391,917,5323,5
chunk,1512,927,990,1391,502,5322,5
swego,2206,226,1421,612,857,5322,5
flosi,847,1193,1426,945,910,5321,5
objet,532,172,81,3252,1284,5321,5
fusco,847,1824,1021,770,857,5319,5
nehru,647,2863,334,1225,247,5316,5
prowl,1184,1543,1426,192,971,5316,5
indef,473,671,774,3252,145,5315,5
ocyte,532,338,381,1385,2679,5315,5
umbre,420,327,664,1225,2679,5315,5
exalt,693,83,1959,1295,1284,5314,5
index,473,671,774,3252,144,5314,5
blimp,1555,1193,1668,612,285,5313,5
drung,1128,1543,990,1391,261,5313,5
squib,2206,25,990,1963,129,5313,5
quirk,93,1824,1668,1225,502,5312,5
oscan,532,341,701,2214,1522,5310,5
plotz,1184,1193,1426,1385,122,5310,5
stijl,2206,403,1668,61,971,5309,5
ashil,1698,341,334,1963,971,5307,5
stock,2206,403,1426,770,502,5307,5
witch,596,2239,1048,770,654,5307,5
ascot,1698,341,701,1282,1284,5306,5
elgon,693,1193,616,1282,1522,5306,5
squiz,2206,25,990,1963,122,5306,5
onlap,532,671,1603,2214,285,5305,5
ovula,532,126,990,1295,2362,5305,5
anigh,1698,671,1668,612,654,5303,5
dukhn,1128,1824,406,423,1522,5303,5
tsadi,1264,341,1959,829,910,5303,5
kling,789,1193,1668,1391,261,5302,5
steck,2206,403,1421,770,502,5302,5
apish,1698,336,1668,945,654,5301,5
jingu,446,2239,1757,612,247,5301,5
stulm,2206,403,990,1295,406,5300,5
vulgo,404,1824,1603,612,857,5300,5
yclad,225,338,1603,2214,917,5297,5
kimpo,789,2239,885,526,857,5296,5
stegh,2206,403,1421,612,654,5296,5
champ,1512,927,1959,612,285,5295,5
vladi,404,1193,1959,829,910,5295,5
aviso,1698,126,1668,945,857,5294,5
nicht,647,2239,701,423,1284,5294,5
amish,1698,327,1668,945,654,5292,5
indew,473,671,774,3252,122,5292,5
ovant,532,126,1959,1391,1284,5292,5
jecho,446,2863,701,423,857,5290,5
optez,532,336,1048,3252,122,5290,5
swamp,2206,226,1959,612,285,5288,5
evart,693,126,1959,1225,1284,5287,5
gwent,965,226,1421,1391,1284,5287,5
slump,2206,1193,990,612,285,5286,5
gwari,965,226,1959,1225,910,5285,5
archd,1698,1543,701,423,917,5282,5
acrux,1698,338,2201,899,144,5280,5
eruct,693,1543,990,770,1284,5280,5
andri,1698,671,774,1225,910,5278,5
ogive,532,139,1668,259,2679,5277,5
yukio,225,1824,406,1963,857,5275,5
glisk,965,1193,1668,945,502,5273,5
scudi,2206,338,990,829,910,5273,5
cytol,1512,458,1048,1282,971,5271,5
flack,847,1193,1959,770,502,5271,5
thong,1264,927,1426,1391,261,5269,5
sfrpg,2206,73,2201,526,261,5267,5
ectal,693,338,1048,2214,971,5264,5
frosk,847,1543,1426,945,502,5263,5
wyano,596,458,1959,1391,857,5261,5
plunk,1184,1193,990,1391,502,5260,5
yukon,225,1824,406,1282,1522,5259,5
kvint,789,126,1668,1391,1284,5258,5
eight,693,2239,616,423,1284,5255,5
omega,532,327,1421,612,2362,5254,5
psend,1184,341,1421,1391,917,5254,5
hrolf,844,1543,1426,1295,145,5253,5
mycah,1225,458,701,2214,654,5252,5
alfur,1698,1193,271,899,1190,5251,5
anvik,1698,671,417,1963,502,5251,5
stung,2206,403,990,1391,261,5251,5
gteau,965,403,1421,2214,247,5250,5
alexi,1698,1193,1421,26,910,5248,5
aphid,1698,336,334,1963,917,5248,5
exion,693,83,1668,1282,1522,5248,5
crypt,1512,1543,381,526,1284,5246,5
awing,1698,226,1668,1391,261,5244,5
juxon,446,1824,170,1282,1522,5244,5
rutch,948,1824,1048,770,654,5244,5
osmin,532,341,885,1963,1522,5243,5
therm,1264,927,1421,1225,406,5243,5
unsad,420,671,1021,2214,917,5243,5
wicht,596,2239,701,423,1284,5243,5
gutow,965,1824,1048,1282,122,5241,5
rcldn,948,338,1603,829,1522,5240,5
spock,2206,336,1426,770,502,5240,5
ediya,693,245,1668,271,2362,5239,5
eglon,693,139,1603,1282,1522,5239,5
buxom,1555,1824,170,1282,406,5237,5
gyasi,965,458,1959,945,910,5237,5
oxman,532,83,885,2214,1522,5236,5
frech,847,1543,1421,770,654,5235,5
speck,2206,336,1421,770,502,5235,5
utqgs,420,403,32,612,3767,5234,5
gbari,965,172,1959,1225,910,5231,5
smock,2206,327,1426,770,502,5231,5
alejo,1698,1193,1421,61,857,5230,5
sturm,2206,403,990,1225,406,5230,5
msphe,1225,341,560,423,2679,5228,5
ediva,693,245,1668,259,2362,5227,5
ploch,1184,1193,1426,770,654,5227,5
astri,1698,341,1048,1225,910,5222,5
azoth,1698,59,1426,1385,654,5222,5
ikeda,473,137,1421,829,2362,5222,5
presb,1184,1543,1421,945,129,5222,5
scudo,2206,338,990,829,857,5220,5
altho,1698,1193,1048,423,857,5219,5
stoup,2206,403,1426,899,285,5219,5
wrong,596,1543,1426,1391,261,5217,5
angst,1698,671,616,945,1284,5214,5
chorz,1512,927,1426,1225,122,5212,5
olcha,532,1193,701,423,2362,5211,5
ectad,693,338,1048,2214,917,5210,5
aslop,1698,341,1603,1282,285,5209,5
grebo,965,1543,1421,423,857,5209,5
night,647,2239,616,423,1284,5209,5
ortiz,532,1543,1048,1963,122,5208,5
undry,420,671,774,1225,2116,5206,5
plouk,1184,1193,1426,899,502,5204,5
skelf,2206,137,1421,1295,145,5204,5
xview,36,126,1668,3252,122,5204,5
imban,473,327,664,2214,1522,5200,5
eplot,693,336,1603,1282,1284,5198,5
khami,789,927,1959,612,910,5197,5
dhruv,1128,927,2201,899,41,5196,5
enhat,693,671,334,2214,1284,5196,5
styli,2206,403,381,1295,910,5195,5
gnash,965,671,1959,945,654,5194,5
kimbo,789,2239,885,423,857,5193,5
unlap,420,671,1603,2214,285,5193,5
ickle,473,338,406,1295,2679,5191,5
preux,1184,1543,1421,899,144,5191,5
uncoy,420,671,701,1282,2116,5190,5
krepi,789,1543,1421,526,910,5189,5
ghoul,965,927,1426,899,971,5188,5
ngoma,647,139,1426,612,2362,5186,5
psalm,1184,341,1959,1295,406,5185,5
spung,2206,336,990,1391,261,5184,5
drugi,1128,1543,990,612,910,5183,5
whalm,596,927,1959,1295,406,5183,5
ogdan,532,139,774,2214,1522,5181,5
flown,847,1193,1426,192,1522,5180,5
zprsn,176,336,2201,945,1522,5180,5
adopt,1698,245,1426,526,1284,5179,5
envoy,693,671,417,1282,2116,5179,5
usbek,420,341,664,3252,502,5179,5
astur,1698,341,1048,899,1190,5176,5
erick,693,1543,1668,770,502,5176,5
adept,1698,245,1421,526,1284,5174,5
jepum,446,2863,560,899,406,5174,5
itusa,473,403,990,945,2362,5173,5
trouv,1264,1543,1426,899,41,5173,5
elvah,693,1193,417,2214,654,5171,5
blyth,1555,1193,381,1385,654,5168,5
hylic,844,458,1603,1963,300,5168,5
ethan,693,403,334,2214,1522,5166,5
shuzo,2206,927,990,186,857,5166,5
asuri,1698,341,990,1225,910,5164,5
ingar,473,671,616,2214,1190,5164,5
unpeg,420,671,560,3252,261,5164,5
adust,1698,245,990,945,1284,5162,5
amigo,1698,327,1668,612,857,5162,5
glaux,965,1193,1959,899,144,5160,5
bphil,1555,336,334,1963,971,5159,5
unbar,420,671,664,2214,1190,5159,5
wight,596,2239,616,423,1284,5158,5
ayelp,1698,458,1421,1295,285,5157,5
inact,473,671,1959,770,1284,5157,5
exaun,693,83,1959,899,1522,5156,5
aking,1698,137,1668,1391,261,5155,5
flisk,847,1193,1668,945,502,5155,5
scoup,2206,338,1426,899,285,5154,5
elish,693,1193,1668,945,654,5153,5
ruthi,948,1824,1048,423,910,5153,5
unboy,420,671,664,1282,2116,5153,5
unify,420,671,1668,278,2116,5153,5
uveal,420,126,1421,2214,971,5152,5
quack,93,1824,1959,770,502,5148,5
exody,693,83,1426,829,2116,5147,5
kufic,789,1824,271,1963,300,5147,5
whorl,596,927,1426,1225,971,5145,5
keywd,789,2863,381,192,917,5142,5
stylo,2206,403,381,1295,857,5142,5
djuka,1128,32,990,628,2362,5140,5
phlox,1184,927,1603,1282,144,5140,5
escar,693,341,701,2214,1190,5139,5
snuck,2206,671,990,770,502,5139,5
anglo,1698,671,616,1295,857,5137,5
axiom,1698,83,1668,1282,406,5137,5
inkra,473,671,406,1225,2362,5137,5
scyld,2206,338,381,1295,917,5137,5
whang,596,927,1959,1391,261,5134,5
akund,1698,137,990,1391,917,5133,5
enapt,693,671,1959,526,1284,5133,5
schav,2206,338,334,2214,41,5133,5
scowl,2206,338,1426,192,971,5133,5
ultor,420,1193,1048,1282,1190,5133,5
odyle,532,245,381,1295,2679,5132,5
thick,1264,927,1668,770,502,5131,5
umiak,420,327,1668,2214,502,5131,5
tromp,1264,1543,1426,612,285,5130,5
ensky,693,671,1021,628,2116,5129,5
hyson,844,458,1021,1282,1522,5127,5
msink,1225,341,1668,1391,502,5127,5
thorp,1264,927,1426,1225,285,5127,5
hexyl,844,2863,170,271,971,5119,5
omani,532,327,1959,1391,910,5119,5
flong,847,1193,1426,1391,261,5118,5
group,965,1543,1426,899,285,5118,5
flavo,847,1193,1959,259,857,5115,5
climb,1512,1193,1668,612,129,5114,5
pishu,1184,2239,1021,423,247,5114,5
sculp,2206,338,990,1295,285,5114,5
azido,1698,59,1668,829,857,5111,5
cymol,1512,458,885,1282,971,5108,5
ochre,532,338,334,1225,2679,5108,5
unmad,420,671,885,2214,917,5107,5
glomi,965,1193,1426,612,910,5106,5
unact,420,671,1959,770,1284,5104,5
among,1698,327,1426,1391,261,5103,5
octal,532,338,1048,2214,971,5103,5
gsbca,965,341,664,770,2362,5102,5
axing,1698,83,1668,1391,261,5101,5
twang,1264,226,1959,1391,261,5101,5
glick,965,1193,1668,770,502,5098,5
growl,965,1543,1426,192,971,5097,5
grush,965,1543,990,945,654,5097,5
scuft,2206,338,990,278,1284,5096,5
ukiah,420,137,1668,2214,654,5093,5
chawk,1512,927,1959,192,502,5092,5
dryth,1128,1543,381,1385,654,5091,5
ewald,693,226,1959,1295,917,5090,5
embar,693,327,664,2214,1190,5088,5
frock,847,1543,1426,770,502,5088,5
kutch,789,1824,1048,770,654,5085,5
lycid,1046,458,701,1963,917,5085,5
adown,1698,245,1426,192,1522,5083,5
freck,847,1543,1421,770,502,5083,5
inlaw,473,671,1603,2214,122,5083,5
lydon,1046,458,774,1282,1522,5082,5
chung,1512,927,990,1391,261,5081,5
empty,693,327,560,1385,2116,5081,5
scevo,2206,338,1421,259,857,5081,5
wrick,596,1543,1668,770,502,5079,5
orczy,532,1543,701,186,2116,5078,5
awork,1698,226,1426,1225,502,5077,5
shoyu,2206,927,1426,271,247,5077,5
asdic,1698,341,774,1963,300,5076,5
escry,693,341,701,1225,2116,5076,5
bynum,1555,458,1757,899,406,5075,5
plock,1184,1193,1426,770,502,5075,5
inert,473,671,1421,1225,1284,5074,5
swung,2206,226,990,1391,261,5074,5
thunk,1264,927,990,1391,502,5074,5
grimp,965,1543,1668,612,285,5073,5
until,420,671,1048,1963,971,5073,5
vipul,404,2239,560,899,971,5073,5
nicko,647,2239,701,628,857,5072,5
pleck,1184,1193,1421,770,502,5070,5
uredo,420,1543,1421,829,857,5070,5
knout,789,671,1426,899,1284,5069,5
truck,1264,1543,990,770,502,5069,5
afoul,1698,73,1426,899,971,5067,5
tchad,1264,338,334,2214,917,5067,5
typha,1264,458,560,423,2362,5067,5
ogema,532,139,1421,612,2362,5066,5
flosh,847,1193,1426,945,654,5065,5
oftly,532,73,1048,1295,2116,5064,5
rutyl,948,1824,1048,271,971,5062,5
whalp,596,927,1959,1295,285,5062,5
churm,1512,927,990,1225,406,5060,5
flesh,847,1193,1421,945,654,5060,5
gruft,965,1543,990,278,1284,5060,5
klong,789,1193,1426,1391,261,5060,5
tchai,1264,338,334,2214,910,5060,5
oscin,532,341,701,1963,1522,5059,5
kusch,789,1824,1021,770,654,5058,5
isoln,473,341,1426,1295,1522,5057,5
agust,1698,139,990,945,1284,5056,5
urich,420,1543,1668,770,654,5055,5
fslic,847,341,1603,1963,300,5054,5
apism,1698,336,1668,945,406,5053,5
irgun,473,1543,616,899,1522,5053,5
ctimo,1512,403,1668,612,857,5052,5
unlax,420,671,1603,2214,144,5052,5
twink,1264,226,1668,1391,502,5051,5
choup,1512,927,1426,899,285,5049,5
octad,532,338,1048,2214,917,5049,5
orium,532,1543,1668,899,406,5048,5
sympl,2206,458,885,526,971,5046,5
yezdi,225,2863,217,829,910,5044,5
epact,693,336,1959,770,1284,5042,5
imbue,473,327,664,899,2679,5042,5
tying,1264,458,1668,1391,261,5042,5
orelu,532,1543,1421,1295,247,5038,5
islam,473,341,1603,2214,406,5037,5
erupt,693,1543,990,526,1284,5036,5
alwyn,1698,1193,349,271,1522,5033,5
ypsce,225,336,1021,770,2679,5031,5
unlaw,420,671,1603,2214,122,5030,5
clomp,1512,1193,1426,612,285,5028,5
ghbor,965,927,664,1282,1190,5028,5
gucki,965,1824,701,628,910,5028,5
zulch,176,1824,1603,770,654,5027,5
embry,693,327,664,1225,2116,5025,5
itemy,473,403,1421,612,2116,5025,5
krogh,789,1543,1426,612,654,5024,5
upsit,420,336,1021,1963,1284,5024,5
ugric,420,139,2201,1963,300,5023,5
floyt,847,1193,1426,271,1284,5021,5
eward,693,226,1959,1225,917,5020,5
elurd,693,1193,990,1225,917,5018,5
theow,1264,927,1421,1282,122,5016,5
orick,532,1543,1668,770,502,5015,5
dwalm,1128,226,1959,1295,406,5014,5
lycon,1046,458,701,1282,1522,5009,5
nuevo,647,1824,1421,259,857,5008,5
apium,1698,336,1668,899,406,5007,5
klosh,789,1193,1426,945,654,5007,5
tchao,1264,338,334,2214,857,5007,5
brujo,1555,1543,990,61,857,5006,5
yokum,225,3069,406,899,406,5005,5
obeid,532,172,1421,1963,917,5005,5
chimp,1512,927,1668,612,285,5004,5
oryza,532,1543,381,186,2362,5004,5
zymin,176,458,885,1963,1522,5004,5
infra,473,671,271,1225,2362,5002,5
orbic,532,1543,664,1963,300,5002,5
unbit,420,671,664,1963,1284,5002,5
grosz,965,1543,1426,945,122,5001,5
whipt,596,927,1668,526,1284,5001,5
edify,693,245,1668,278,2116,5000,5
umbra,420,327,664,1225,2362,4998,5
idcue,473,245,701,899,2679,4997,5
snowk,2206,671,1426,192,502,4997,5
aknow,1698,137,1757,1282,122,4996,5
wramp,596,1543,1959,612,285,4995,5
obeah,532,172,1421,2214,654,4993,5
wharp,596,927,1959,1225,285,4992,5
amelu,1698,327,1421,1295,247,4988,5
unist,420,671,1668,945,1284,4988,5
whilk,596,927,1668,1295,502,4988,5
italo,473,403,1959,1295,857,4987,5
nexum,647,2863,170,899,406,4985,5
islot,473,341,1603,1282,1284,4983,5
aklog,1698,137,1603,1282,261,4981,5
rspca,948,341,560,770,2362,4981,5
eridu,693,1543,1668,829,247,4980,5
flick,847,1193,1668,770,502,4980,5
vlach,404,1193,1959,770,654,4980,5
frowl,847,1543,1426,192,971,4979,5
frush,847,1543,990,945,654,4979,5
khalq,789,927,1959,1295,9,4979,5
grouf,965,1543,1426,899,145,4978,5
oscar,532,341,701,2214,1190,4978,5
amorc,1698,327,1426,1225,300,4976,5
vtern,404,403,1421,1225,1522,4975,5
dnitz,1128,671,1668,1385,122,4974,5
jbeil,446,172,1421,1963,971,4973,5
bseng,1555,341,1421,1391,261,4969,5
quipo,93,1824,1668,526,857,4968,5
cterm,1512,403,1421,1225,406,4967,5
chimu,1512,927,1668,612,247,4966,5
plush,1184,1193,990,945,654,4966,5
amick,1698,327,1668,770,502,4965,5
dwang,1128,226,1959,1391,261,4965,5
invar,473,671,417,2214,1190,4965,5
elong,693,1193,1426,1391,261,4964,5
scyth,2206,338,381,1385,654,4964,5
schiz,2206,338,334,1963,122,4963,5
edlun,693,245,1603,899,1522,4962,5
imbat,473,327,664,2214,1284,4962,5
invoy,473,671,417,1282,2116,4959,5
edgar,693,245,616,2214,1190,4958,5
mbori,1225,172,1426,1225,910,4958,5
kylix,789,458,1603,1963,144,4957,5
ochna,532,338,334,1391,2362,4957,5
afyon,1698,73,381,1282,1522,4956,5
enarm,693,671,1959,1225,406,4954,5
gumbo,965,1824,885,423,857,4954,5
orgic,532,1543,616,1963,300,4954,5
omari,532,327,1959,1225,910,4953,5
smyth,2206,327,381,1385,654,4953,5
whamo,596,927,1959,612,857,4951,5
erizo,693,1543,1668,186,857,4947,5
ghazi,965,927,1959,186,910,4947,5
hbert,844,172,1421,1225,1284,4946,5
mugho,1225,1824,616,423,857,4945,5
dsect,1128,341,1421,770,1284,4944,5
crump,1512,1543,990,612,285,4942,5
ashot,1698,341,334,1282,1284,4939,5
lubow,1046,1824,664,1282,122,4938,5
usbeg,420,341,664,3252,261,4938,5
rumbo,948,1824,885,423,857,4937,5
almug,1698,1193,885,899,261,4936,5
dnepr,1128,671,1421,526,1190,4936,5
admix,1698,245,885,1963,144,4935,5
stomp,2206,403,1426,612,285,4932,5
umiac,420,327,1668,2214,300,4929,5
amowt,1698,327,1426,192,1284,4927,5
aperu,1698,336,1421,1225,247,4927,5
skewl,2206,137,1421,192,971,4927,5
epist,693,336,1668,945,1284,4926,5
nymil,647,458,885,1963,971,4924,5
fchar,847,338,334,2214,1190,4923,5
flunk,847,1193,990,1391,502,4923,5
unhat,420,671,334,2214,1284,4923,5
upali,420,336,1959,1295,910,4920,5
eprom,693,336,2201,1282,406,4918,5
egwan,693,139,349,2214,1522,4917,5
klotz,789,1193,1426,1385,122,4915,5
inapt,473,671,1959,526,1284,4913,5
skulp,2206,137,990,1295,285,4913,5
ashby,1698,341,334,423,2116,4912,5
icard,473,338,1959,1225,917,4912,5
choux,1512,927,1426,899,144,4908,5
skimp,2206,137,1668,612,285,4908,5
dying,1128,458,1668,1391,261,4906,5
scurf,2206,338,990,1225,145,4904,5
cheux,1512,927,1421,899,144,4903,5
xylon,36,458,1603,1282,1522,4901,5
yquem,225,25,990,3252,406,4898,5
uzbek,420,59,664,3252,502,4897,5
vlund,404,1193,990,1391,917,4895,5
osdit,532,341,774,1963,1284,4894,5
equal,693,25,990,2214,971,4893,5
xingu,36,2239,1757,612,247,4891,5
gizmo,965,2239,217,612,857,4890,5
urbic,420,1543,664,1963,300,4890,5
thock,1264,927,1426,770,502,4889,5
lynco,1046,458,1757,770,857,4888,5
cygni,1512,458,616,1391,910,4887,5
obuda,532,172,990,829,2362,4885,5
twirk,1264,226,1668,1225,502,4885,5
ishan,473,341,334,2214,1522,4884,5
ismal,473,341,885,2214,971,4884,5
whauk,596,927,1959,899,502,4883,5
wyson,596,458,1021,1282,1522,4879,5
ablow,1698,172,1603,1282,122,4877,5
nvlap,647,126,1603,2214,285,4875,5
clomb,1512,1193,1426,612,129,4872,5
stuck,2206,403,990,770,502,4871,5
updry,420,336,774,1225,2116,4871,5
zwart,176,226,1959,1225,1284,4870,5
opelt,532,336,1421,1295,1284,4868,5
aspic,1698,341,560,1963,300,4862,5
album,1698,1193,664,899,406,4860,5
unapt,420,671,1959,526,1284,4860,5
kyang,789,458,1959,1391,261,4858,5
ensor,693,671,1021,1282,1190,4857,5
quick,93,1824,1668,770,502,4857,5
usent,420,341,1421,1391,1284,4857,5
agism,1698,139,1668,945,406,4856,5
eshin,693,341,334,1963,1522,4853,5
wharf,596,927,1959,1225,145,4852,5
lucho,1046,1824,701,423,857,4851,5
jimbo,446,2239,885,423,857,4850,5
chimb,1512,927,1668,612,129,4848,5
umont,420,327,1426,1391,1284,4848,5
enami,693,671,1959,612,910,4845,5
aglow,1698,139,1603,1282,122,4844,5
eskar,693,341,406,2214,1190,4844,5
enjoy,693,671,81,1282,2116,4843,5
whing,596,927,1668,1391,261,4843,5
achor,1698,338,334,1282,1190,4842,5
etrog,693,403,2201,1282,261,4840,5
limbu,1046,2239,885,423,247,4840,5
jufti,446,1824,271,1385,910,4836,5
obmit,532,172,885,1963,1284,4836,5
elyot,693,1193,381,1282,1284,4833,5
humbo,844,1824,885,423,857,4833,5
thung,1264,927,990,1391,261,4833,5
wreck,596,1543,1421,770,502,4832,5
kumbi,789,1824,885,423,910,4831,5
inark,473,671,1959,1225,502,4830,5
krutz,789,1543,990,1385,122,4829,5
kwasi,789,226,1959,945,910,4829,5
mphil,1225,336,334,1963,971,4829,5
jehup,446,2863,334,899,285,4827,5
niftp,647,2239,271,1385,285,4827,5
lying,1046,458,1668,1391,261,4824,5
upbar,420,336,664,2214,1190,4824,5
unhex,420,671,334,3252,144,4821,5
unweb,420,671,349,3252,129,4821,5
isolt,473,341,1426,1295,1284,4819,5
mixup,1225,2239,170,899,285,4818,5
lytic,1046,458,1048,1963,300,4815,5
undye,420,671,774,271,2679,4815,5
dhobi,1128,927,1426,423,910,4814,5
ident,473,245,1421,1391,1284,4814,5
algum,1698,1193,616,899,406,4812,5
thurm,1264,927,990,1225,406,4812,5
acerb,1698,338,1421,1225,129,4811,5
zrich,176,1543,1668,770,654,4811,5
adolf,1698,245,1426,1295,145,4809,5
hyrum,844,458,2201,899,406,4808,5
umpty,420,327,560,1385,2116,4808,5
qeshm,93,2863,1021,423,406,4806,5
theyd,1264,927,1421,271,917,4800,5
upcry,420,336,701,1225,2116,4798,5
exact,693,83,1959,770,1284,4789,5
crumb,1512,1543,990,612,129,4786,5
bryum,1555,1543,381,899,406,4784,5
lyngi,1046,458,1757,612,910,4783,5
unwry,420,671,349,1225,2116,4781,5
usnic,420,341,1757,1963,300,4781,5
wrung,596,1543,990,1391,261,4781,5
ohing,532,927,1668,1391,261,4779,5
aflow,1698,73,1603,1282,122,4778,5
ambur,1698,327,664,899,1190,4778,5
esrog,693,341,2201,1282,261,4778,5
khnum,789,927,1757,899,406,4778,5
unark,420,671,1959,1225,502,4777,5
uledi,420,1193,1421,829,910,4773,5
edwin,693,245,349,1963,1522,4772,5
imply,473,327,560,1295,2116,4771,5
echar,693,338,334,2214,1190,4769,5
unfar,420,671,271,2214,1190,4766,5
avick,1698,126,1668,770,502,4764,5
gwelo,965,226,1421,1295,857,4764,5
impar,473,327,560,2214,1190,4764,5
edson,693,245,1021,1282,1522,4763,5
thuoc,1264,927,990,1282,300,4763,5
ubald,420,172,1959,1295,917,4763,5
chomp,1512,927,1426,612,285,4762,5
pseud,1184,341,1421,899,917,4762,5
ulmic,420,1193,885,1963,300,4761,5
mvsxa,1225,126,1021,26,2362,4760,5
inbye,473,671,664,271,2679,4758,5
aswim,1698,341,349,1963,406,4757,5
cmsgt,1512,327,1021,612,1284,4756,5
othin,532,403,334,1963,1522,4754,5
whack,596,927,1959,770,502,4754,5
dsbam,1128,341,664,2214,406,4753,5
whift,596,927,1668,278,1284,4753,5
vejoz,404,2863,81,1282,122,4752,5
bytom,1555,458,1048,1282,406,4749,5
isort,473,341,1426,1225,1284,4749,5
schul,2206,338,334,899,971,4748,5
elamp,693,1193,1959,612,285,4742,5
whelk,596,927,1421,1295,502,4741,5
bjork,1555,32,1426,1225,502,4740,5
exuma,693,83,990,612,2362,4740,5
flamb,847,1193,1959,612,129,4740,5
instr,473,671,1021,1385,1190,4740,5
flock,847,1193,1426,770,502,4738,5
unfew,420,671,271,3252,122,4736,5
inarm,473,671,1959,1225,406,4734,5
fleck,847,1193,1421,770,502,4733,5
dphil,1128,336,334,1963,971,4732,5
sybow,2206,458,664,1282,122,4732,5
yuzik,225,1824,217,1963,502,4731,5
oslav,532,341,1603,2214,41,4731,5
unold,420,671,1426,1295,917,4729,5
knish,789,671,1668,945,654,4727,5
bsadv,1555,341,1959,829,41,4725,5
dwyka,1128,226,381,628,2362,4725,5
glimp,965,1193,1668,612,285,4723,5
ugali,420,139,1959,1295,910,4723,5
antum,1698,671,1048,899,406,4722,5
zhang,176,927,1959,1391,261,4714,5
etang,693,403,1959,1391,261,4707,5
oswin,532,341,349,1963,1522,4707,5
fuchi,847,1824,701,423,910,4705,5
ignaw,473,139,1757,2214,122,4705,5
ignaz,473,139,1757,2214,122,4705,5
ungka,420,671,616,628,2362,4697,5
unrow,420,671,2201,1282,122,4696,5
erugo,693,1543,990,612,857,4695,5
trump,1264,1543,990,612,285,4694,5
askip,1698,341,406,1963,285,4693,5
wixom,596,2239,170,1282,406,4693,5
intap,473,671,1048,2214,285,4691,5
athol,1698,403,334,1282,971,4688,5
hyrup,844,458,2201,899,285,4687,5
unwit,420,671,349,1963,1284,4687,5
lynch,1046,458,1757,770,654,4685,5
dwarf,1128,226,1959,1225,145,4683,5
oskar,532,341,406,2214,1190,4683,5
flung,847,1193,990,1391,261,4682,5
hwang,844,226,1959,1391,261,4681,5
unarm,420,671,1959,1225,406,4681,5
ought,532,1824,616,423,1284,4679,5
tseng,1264,341,1421,1391,261,4678,5
abhor,1698,172,334,1282,1190,4676,5
iglau,473,139,1603,2214,247,4676,5
odist,532,245,1668,945,1284,4674,5
exist,693,83,1668,945,1284,4673,5
unhit,420,671,334,1963,1284,4672,5
ashti,1698,341,334,1385,910,4668,5
twirp,1264,226,1668,1225,285,4668,5
egwin,693,139,349,1963,1522,4666,5
whaup,596,927,1959,899,285,4666,5
edoni,693,245,1426,1391,910,4665,5
tcawi,1264,338,1959,192,910,4663,5
skemp,2206,137,1421,612,285,4661,5
edict,693,245,1668,770,1284,4660,5
tyigh,1264,458,1668,612,654,4656,5
uzbeg,420,59,664,3252,261,4656,5
bypro,1555,458,560,1225,857,4655,5
krubi,789,1543,990,423,910,4655,5
floyd,847,1193,1426,271,917,4654,5
uwcsa,420,226,701,945,2362,4654,5
unshy,420,671,1021,423,2116,4651,5
acoup,1698,338,1426,899,285,4646,5
knurl,789,671,990,1225,971,4646,5
edith,693,245,1668,1385,654,4645,5
whelm,596,927,1421,1295,406,4645,5
phylo,1184,927,381,1295,857,4644,5
umist,420,327,1668,945,1284,4644,5
stchi,2206,403,701,423,910,4643,5
pluck,1184,1193,990,770,502,4639,5
umiaq,420,327,1668,2214,9,4638,5
untap,420,671,1048,2214,285,4638,5
whisk,596,927,1668,945,502,4638,5
askoi,1698,341,406,1282,910,4637,5
mycol,1225,458,701,1282,971,4637,5
dncri,1128,671,701,1225,910,4635,5
unbid,420,671,664,1963,917,4635,5
obert,532,172,1421,1225,1284,4634,5
izard,473,59,1959,1225,917,4633,5
pfalz,1184,73,1959,1295,122,4633,5
flush,847,1193,990,945,654,4629,5
exton,693,83,1048,1282,1522,4628,5
edmon,693,245,885,1282,1522,4627,5
kwang,789,226,1959,1391,261,4626,5
jyoti,446,458,1426,1385,910,4625,5
adunc,1698,245,990,1391,300,4624,5
hying,844,458,1668,1391,261,4622,5
vucom,404,1824,701,1282,406,4617,5
ethal,693,403,334,2214,971,4615,5
vhsic,404,927,1021,1963,300,4615,5
cypro,1512,458,560,1225,857,4612,5
uncio,420,671,701,1963,857,4612,5
endor,693,671,774,1282,1190,4610,5
unfit,420,671,271,1963,1284,4609,5
upton,420,336,1048,1282,1522,4608,5
azoch,1698,59,1426,770,654,4607,5
ohmic,532,927,885,1963,300,4607,5
flimp,847,1193,1668,612,285,4605,5
quegh,93,1824,1421,612,654,4604,5
asyut,1698,341,381,899,1284,4603,5
rheum,948,927,1421,899,406,4601,5
epoxy,693,336,1426,26,2116,4597,5
clump,1512,1193,990,612,285,4592,5
akebi,1698,137,1421,423,910,4589,5
equid,693,25,990,1963,917,4588,5
overt,532,126,1421,1225,1284,4588,5
afgod,1698,73,616,1282,917,4586,5
fluyt,847,1193,990,271,1284,4585,5
pneum,1184,671,1421,899,406,4581,5
upson,420,336,1021,1282,1522,4581,5
ashli,1698,341,334,1295,910,4578,5
ibert,473,172,1421,1225,1284,4575,5
uxmal,420,83,885,2214,971,4573,5
uleki,420,1193,1421,628,910,4572,5
unami,420,671,1959,612,910,4572,5
quawk,93,1824,1959,192,502,4570,5
bluhm,1555,1193,990,423,406,4567,5
rhynd,948,927,381,1391,917,4564,5
chowk,1512,927,1426,192,502,4559,5
amylo,1698,327,381,1295,857,4558,5
ewold,693,226,1426,1295,917,4557,5
unhad,420,671,334,2214,917,4556,5
ovist,532,126,1668,945,1284,4555,5
pfund,1184,73,990,1391,917,4555,5
ulick,420,1193,1668,770,502,4553,5
mjico,1225,32,1668,770,857,4552,5
utend,420,403,1421,1391,917,4552,5
asgmt,1698,341,616,612,1284,4551,5
ector,693,338,1048,1282,1190,4551,5
ochry,532,338,334,1225,2116,4545,5
typic,1264,458,560,1963,300,4545,5
plomb,1184,1193,1426,612,129,4544,5
iyang,473,458,1959,1391,261,4542,5
evict,693,126,1668,770,1284,4541,5
pfosi,1184,73,1426,945,910,4538,5
pluvi,1184,1193,990,259,910,4536,5
egadi,693,139,1959,829,910,4530,5
whelp,596,927,1421,1295,285,4524,5
unamo,420,671,1959,612,857,4519,5
mcgaw,1225,338,616,2214,122,4515,5
abdul,1698,172,774,899,971,4514,5
ontic,532,671,1048,1963,300,4514,5
wyeth,596,458,1421,1385,654,4514,5
fjeld,847,32,1421,1295,917,4512,5
stowp,2206,403,1426,192,285,4512,5
nhlbi,647,927,1603,423,910,4510,5
krivu,789,1543,1668,259,247,4506,5
wheft,596,927,1421,278,1284,4506,5
esbon,693,341,664,1282,1522,4502,5
uwton,420,226,1048,1282,1522,4498,5
untax,420,671,1048,2214,144,4497,5
eboli,693,172,1426,1295,910,4496,5
stump,2206,403,990,612,285,4496,5
emigr,693,327,1668,612,1190,4490,5
knuth,789,671,990,1385,654,4489,5
chivw,1512,927,1668,259,122,4488,5
alkyd,1698,1193,406,271,917,4485,5
undam,420,671,774,2214,406,4485,5
upend,420,336,1421,1391,917,4485,5
wheki,596,927,1421,628,910,4482,5
ocque,532,338,32,899,2679,4480,5
flegm,847,1193,1421,612,406,4479,5
klutz,789,1193,990,1385,122,4479,5
udasi,420,245,1959,945,910,4479,5
flusk,847,1193,990,945,502,4477,5
mtech,1225,403,1421,770,654,4473,5
eying,693,458,1668,1391,261,4471,5
ibson,473,172,1021,1282,1522,4470,5
uviol,420,126,1668,1282,971,4467,5
oxlip,532,83,1603,1963,285,4466,5
whick,596,927,1668,770,502,4463,5
ashur,1698,341,334,899,1190,4462,5
risqu,948,2239,1021,5,247,4460,5
tryck,1264,1543,381,770,502,4460,5
abush,1698,172,990,945,654,4459,5
fichu,847,2239,701,423,247,4457,5
uvito,420,126,1668,1385,857,4456,5
ampul,1698,327,560,899,971,4455,5
ikeja,473,137,1421,61,2362,4454,5
bsmtp,1555,341,885,1385,285,4451,5
etyma,693,403,381,612,2362,4451,5
oleum,532,1193,1421,899,406,4451,5
fjord,847,32,1426,1225,917,4447,5
khoum,789,927,1426,899,406,4447,5
unido,420,671,1668,829,857,4445,5
itcze,473,403,701,186,2679,4442,5
fixup,847,2239,170,899,285,4440,5
upfly,420,336,271,1295,2116,4438,5
jumbo,446,1824,885,423,857,4435,5
zygal,176,458,616,2214,971,4435,5
evang,693,126,1959,1391,261,4430,5
twick,1264,226,1668,770,502,4430,5
agush,1698,139,990,945,654,4426,5
estab,693,341,1048,2214,129,4425,5
enorm,693,671,1426,1225,406,4421,5
twerp,1264,226,1421,1225,285,4421,5
whisp,596,927,1668,945,285,4421,5
elfic,693,1193,271,1963,300,4420,5
gluck,965,1193,990,770,502,4420,5
ostap,532,341,1048,2214,285,4420,5
insol,473,671,1021,1282,971,4418,5
emlyn,693,327,1603,271,1522,4416,5
irazu,473,1543,1959,186,247,4408,5
idmon,473,245,885,1282,1522,4407,5
oswal,532,341,349,2214,971,4407,5
schou,2206,338,334,1282,247,4407,5
gweyn,965,226,1421,271,1522,4405,5
imroz,473,327,2201,1282,122,4405,5
bsphn,1555,341,560,423,1522,4401,5
tzong,1264,59,1426,1391,261,4401,5
ocuby,532,338,990,423,2116,4399,5
umest,420,327,1421,945,1284,4397,5
grump,965,1543,990,612,285,4395,5
vrouw,404,1543,1426,899,122,4394,5
ileum,473,1193,1421,899,406,4392,5
twisp,1264,226,1668,945,285,4388,5
adusk,1698,245,990,945,502,4380,5
uteri,420,403,1421,1225,910,4379,5
whamp,596,927,1959,612,285,4379,5
unkid,420,671,406,1963,917,4377,5
inept,473,671,1421,526,1284,4375,5
eskil,693,341,406,1963,971,4374,5
inrub,473,671,2201,899,129,4373,5
upbye,420,336,664,271,2679,4370,5
idest,473,245,1421,945,1284,4368,5
otaru,532,403,1959,1225,247,4366,5
inust,473,671,990,945,1284,4363,5
xylic,36,458,1603,1963,300,4360,5
ighly,473,139,334,1295,2116,4357,5
ophir,532,336,334,1963,1190,4355,5
chyou,1512,927,381,1282,247,4349,5
iqbal,473,25,664,2214,971,4347,5
schmo,2206,338,334,612,857,4347,5
uparm,420,336,1959,1225,406,4346,5
exult,693,83,990,1295,1284,4345,5
flexo,847,1193,1421,26,857,4344,5
mweru,1225,226,1421,1225,247,4344,5
sdump,2206,245,990,612,285,4338,5
nyack,647,458,1959,770,502,4336,5
edlyn,693,245,1603,271,1522,4334,5
abdom,1698,172,774,1282,406,4332,5
obeli,532,172,1421,1295,910,4330,5
rumpf,948,1824,885,526,145,4328,5
chump,1512,927,990,612,285,4326,5
ingot,473,671,616,1282,1284,4326,5
utero,420,403,1421,1225,857,4326,5
adfix,1698,245,271,1963,144,4321,5
incor,473,671,701,1282,1190,4317,5
ethid,693,403,334,1963,917,4310,5
whulk,596,927,990,1295,502,4310,5
msfor,1225,341,271,1282,1190,4309,5
ovest,532,126,1421,945,1284,4308,5
xport,36,336,1426,1225,1284,4307,5
unhid,420,671,334,1963,917,4305,5
ankou,1698,671,406,1282,247,4304,5
escot,693,341,701,1282,1284,4301,5
upbid,420,336,664,1963,917,4300,5
oxfly,532,83,271,1295,2116,4297,5
uncap,420,671,701,2214,285,4291,5
fhlmc,847,927,1603,612,300,4289,5
atpco,1698,403,560,770,857,4288,5
amuck,1698,327,990,770,502,4287,5
bscom,1555,341,701,1282,406,4285,5
schow,2206,338,334,1282,122,4282,5
frump,847,1543,990,612,285,4277,5
ozark,532,59,1959,1225,502,4277,5
intro,473,671,1048,1225,857,4274,5
ungot,420,671,616,1282,1284,4273,5
adsum,1698,245,1021,899,406,4269,5
actup,1698,338,1048,899,285,4268,5
njord,647,32,1426,1225,917,4247,5
osyka,532,341,381,628,2362,4244,5
clwyd,1512,1193,349,271,917,4242,5
ewing,693,226,1668,1391,261,4239,5
undim,420,671,774,1963,406,4234,5
klehm,789,1193,1421,423,406,4232,5
unbag,420,671,664,2214,261,4230,5
imago,473,327,1959,612,857,4228,5
elihu,693,1193,1668,423,247,4224,5
crfmp,1512,1543,271,612,285,4223,5
unpot,420,671,560,1282,1284,4217,5
enoch,693,671,1426,770,654,4214,5
hydri,844,458,774,1225,910,4211,5
abihu,1698,172,1668,423,247,4208,5
idgah,473,245,616,2214,654,4202,5
admrx,1698,245,885,1225,144,4197,5
inerm,473,671,1421,1225,406,4196,5
clywd,1512,1193,381,192,917,4195,5
pshaw,1184,341,334,2214,122,4195,5
rnzaf,948,671,217,2214,145,4195,5
oping,532,336,1668,1391,261,4188,5
ostic,532,341,1048,1963,300,4184,5
qishm,93,2239,1021,423,406,4182,5
vying,404,458,1668,1391,261,4182,5
ngapi,647,139,1959,526,910,4181,5
optic,532,336,1048,1963,300,4179,5
knyaz,789,671,381,2214,122,4177,5
imcnt,473,327,701,1391,1284,4176,5
onium,532,671,1668,899,406,4176,5
osirm,532,341,1668,1225,406,4172,5
epulo,693,336,990,1295,857,4171,5
indol,473,671,774,1282,971,4171,5
cheju,1512,927,1421,61,247,4168,5
aksum,1698,137,1021,899,406,4161,5
gconv,965,338,1426,1391,41,4161,5
idryl,473,245,2201,271,971,4161,5
flowk,847,1193,1426,192,502,4160,5
hydro,844,458,774,1225,857,4158,5
ashok,1698,341,334,1282,502,4157,5
admov,1698,245,885,1282,41,4151,5
eking,693,137,1668,1391,261,4150,5
abohm,1698,172,1426,423,406,4125,5
fldxt,847,1193,774,26,1284,4124,5
erump,693,1543,990,612,285,4123,5
icasm,473,338,1959,945,406,4121,5
iguac,473,139,990,2214,300,4116,5
itchy,473,403,701,423,2116,4116,5
knosp,789,671,1426,945,285,4116,5
pshav,1184,341,334,2214,41,4114,5
async,1698,341,381,1391,300,4111,5
unism,420,671,1668,945,406,4110,5
plumb,1184,1193,990,612,129,4108,5
entom,693,671,1048,1282,406,4100,5
dlupg,1128,1193,990,526,261,4098,5
emong,693,327,1426,1391,261,4098,5
elvyn,693,1193,417,271,1522,4096,5
exing,693,83,1668,1391,261,4096,5
thymi,1264,927,381,612,910,4094,5
undig,420,671,774,1963,261,4089,5
nudzh,647,1824,774,186,654,4085,5
omagh,532,327,1959,612,654,4084,5
yuchi,225,1824,701,423,910,4083,5
unmix,420,671,885,1963,144,4083,5
using,420,341,1668,1391,261,4081,5
ejido,693,32,1668,829,857,4079,5
owing,532,226,1668,1391,261,4078,5
thump,1264,927,990,612,285,4078,5
extol,693,83,1048,1282,971,4077,5
twimc,1264,226,1668,612,300,4070,5
gryph,965,1543,381,526,654,4069,5
ushga,420,341,334,612,2362,4069,5
awful,1698,226,271,899,971,4065,5
oculi,532,338,990,1295,910,4065,5
okapi,532,137,1959,526,910,4064,5
utchy,420,403,701,423,2116,4063,5
inorg,473,671,1426,1225,261,4056,5
zygon,176,458,616,1282,1522,4054,5
dweck,1128,226,1421,770,502,4047,5
zweig,176,226,1421,1963,261,4047,5
glump,965,1193,990,612,285,4045,5
fconv,847,338,1426,1391,41,4043,5
rhomb,948,927,1426,612,129,4042,5
schug,2206,338,334,899,261,4038,5
abmho,1698,172,885,423,857,4035,5
vycor,404,458,701,1282,1190,4035,5
otyak,532,403,381,2214,502,4032,5
okrug,532,137,2201,899,261,4030,5
elwyn,693,1193,349,271,1522,4028,5
incut,473,671,701,899,1284,4028,5
osmic,532,341,885,1963,300,4021,5
exopt,693,83,1426,526,1284,4012,5
vtarj,404,403,1959,1225,10,4001,5
exust,693,83,990,945,1284,3995,5
unhot,420,671,334,1282,1284,3991,5
educt,693,245,990,770,1284,3982,5
ormuz,532,1543,885,899,122,3981,5
anjou,1698,671,81,1282,247,3979,5
knezi,789,671,1421,186,910,3977,5
vibhu,404,2239,664,423,247,3977,5
envoi,693,671,417,1282,910,3973,5
pytho,1184,458,1048,423,857,3970,5
ervum,693,1543,417,899,406,3958,5
idaho,473,245,1959,423,857,3957,5
equip,693,25,990,1963,285,3956,5
elbow,693,1193,664,1282,122,3954,5
undro,420,671,774,1225,857,3947,5
episc,693,336,1668,945,300,3942,5
incur,473,671,701,899,1190,3934,5
udish,420,245,1668,945,654,3932,5
flump,847,1193,990,612,285,3927,5
impot,473,327,560,1282,1284,3926,5
inorb,473,671,1426,1225,129,3924,5
unhap,420,671,334,2214,285,3924,5
thumb,1264,927,990,612,129,3922,5
amphi,1698,327,560,423,910,3918,5
lbeck,1046,172,1421,770,502,3911,5
otium,532,403,1668,899,406,3908,5
ungod,420,671,616,1282,917,3906,5
wmscr,596,327,1021,770,1190,3904,5
anhyd,1698,671,334,271,917,3891,5
kyung,789,458,990,1391,261,3889,5
input,473,671,560,899,1284,3887,5
epoch,693,336,1426,770,654,3879,5
tsubo,1264,341,990,423,857,3875,5
klump,789,1193,990,612,285,3869,5
elcho,693,1193,701,423,857,3867,5
uzbak,420,59,664,2214,502,3859,5
actpu,1698,338,1048,526,247,3857,5
xsect,36,341,1421,770,1284,3852,5
whomp,596,927,1426,612,285,3846,5
opium,532,336,1668,899,406,3841,5
ephor,693,336,334,1282,1190,3835,5
opelu,532,336,1421,1295,247,3831,5
nugmw,647,1824,616,612,122,3821,5
ogmic,532,139,885,1963,300,3819,5
ushak,420,341,334,2214,502,3811,5
xysti,36,458,1021,1385,910,3810,5
zhmud,176,927,885,899,917,3804,5
khuzi,789,927,990,186,910,3802,5
mtbrp,1225,403,664,1225,285,3802,5
unwax,420,671,349,2214,144,3798,5
engud,693,671,616,899,917,3796,5
unjam,420,671,81,2214,406,3792,5
elymi,693,1193,381,612,910,3789,5
egham,693,139,334,2214,406,3786,5
zymic,176,458,885,1963,300,3782,5
dvigu,1128,126,1668,612,247,3781,5
obeng,532,172,1421,1391,261,3777,5
utham,420,403,334,2214,406,3777,5
oscrl,532,341,701,1225,971,3770,5
askov,1698,341,406,1282,41,3768,5
utick,420,403,1668,770,502,3763,5
olchi,532,1193,701,423,910,3759,5
odium,532,245,1668,899,406,3750,5
upmix,420,336,885,1963,144,3748,5
epsom,693,336,1021,1282,406,3738,5
nberg,647,172,1421,1225,261,3726,5
oshac,532,341,334,2214,300,3721,5
glyph,965,1193,381,526,654,3719,5
equiv,693,25,990,1963,41,3712,5
upham,420,336,334,2214,406,3710,5
ygapo,225,139,1959,526,857,3706,5
untop,420,671,1048,1282,285,3706,5
tycho,1264,458,701,423,857,3703,5
ethic,693,403,334,1963,300,3693,5
bsgph,1555,341,616,526,654,3692,5
exptl,693,83,560,1385,971,3692,5
adpcm,1698,245,560,770,406,3679,5
ovism,532,126,1668,945,406,3677,5
unhip,420,671,334,1963,285,3673,5
iconv,473,338,1426,1391,41,3669,5
estoc,693,341,1048,1282,300,3664,5
unwig,420,671,349,1963,261,3664,5
umeko,420,327,1421,628,857,3653,5
jfmip,446,73,885,1963,285,3652,5
insko,473,671,1021,628,857,3650,5
dvmrp,1128,126,885,1225,285,3649,5
estop,693,341,1048,1282,285,3649,5
expwy,693,83,560,192,2116,3644,5
isamu,473,341,1959,612,247,3632,5
ithun,473,403,334,899,1522,3631,5
ogham,532,139,334,2214,406,3625,5
ichor,473,338,334,1282,1190,3617,5
oberg,532,172,1421,1225,261,3611,5
rhumb,948,927,990,612,129,3606,5
iform,473,73,1426,1225,406,3603,5
abysm,1698,172,381,945,406,3602,5
vpisu,404,336,1668,945,247,3600,5
ejusd,693,32,990,945,917,3577,5
lymph,1046,458,885,526,654,3569,5
excur,693,83,701,899,1190,3566,5
uspto,420,341,560,1385,857,3563,5
ephod,693,336,334,1282,917,3562,5
unzip,420,671,217,1963,285,3556,5
ephoi,693,336,334,1282,910,3555,5
imput,473,327,560,899,1284,3543,5
endow,693,671,774,1282,122,3542,5
iseum,473,341,1421,899,406,3540,5
ortyx,532,1543,1048,271,144,3538,5
gjuki,965,32,990,628,910,3525,5
fcomp,847,338,1426,612,285,3508,5
ulphi,420,1193,560,423,910,3506,5
odeum,532,245,1421,899,406,3503,5
wysox,596,458,1021,1282,144,3501,5
eyght,693,458,616,423,1284,3474,5
dcpsk,1128,338,560,945,502,3473,5
unfix,420,671,271,1963,144,3469,5
ophic,532,336,334,1963,300,3465,5
ibagu,473,172,1959,612,247,3463,5
upwax,420,336,349,2214,144,3463,5
expdt,693,83,560,829,1284,3449,5
whump,596,927,990,612,285,3410,5
undog,420,671,774,1282,261,3408,5
intuc,473,671,1048,899,300,3391,5
incog,473,671,701,1282,261,3388,5
osugi,532,341,990,612,910,3385,5
unhcr,420,671,334,770,1190,3385,5
edyth,693,245,381,1385,654,3358,5
zwick,176,226,1668,770,502,3342,5
psych,1184,341,381,770,654,3330,5
indow,473,671,774,1282,122,3322,5
inglu,473,671,616,1295,247,3302,5
unbog,420,671,664,1282,261,3298,5
excud,693,83,701,899,917,3293,5
osyth,532,341,381,1385,654,3293,5
kljuc,789,1193,81,899,300,3262,5
pskov,1184,341,406,1282,41,3254,5
obulg,532,172,990,1295,261,3250,5
encup,693,671,701,899,285,3249,5
wburg,596,172,990,1225,261,3244,5
inkom,473,671,406,1282,406,3238,5
embog,693,327,664,1282,261,3227,5
inbow,473,671,664,1282,122,3212,5
uncow,420,671,701,1282,122,3196,5
idoux,473,245,1426,899,144,3187,5
unbox,420,671,664,1282,144,3181,5
intsv,473,671,1048,945,41,3178,5
nymph,647,458,885,526,654,3170,5
indyl,473,671,774,271,971,3160,5
octyl,532,338,1048,271,971,3160,5
unbow,420,671,664,1282,122,3159,5
exurb,693,83,990,1225,129,3120,5
induc,473,671,774,899,300,3117,5
embox,693,327,664,1282,144,3110,5
embow,693,327,664,1282,122,3088,5
owght,532,226,616,423,1284,3081,5
lpcdf,1046,336,701,829,145,3057,5
exhbn,693,83,334,423,1522,3055,5
tchwi,1264,338,334,192,910,3038,5
egypt,693,139,381,526,1284,3023,5
ampyx,1698,327,560,271,144,3000,5
tscpf,1264,341,701,526,145,2977,5
rnwmp,948,671,349,612,285,2865,5
igdyr,473,139,774,271,1190,2847,5
upbow,420,336,664,1282,122,2824,5
bshyg,1555,341,334,271,261,2762,5
ilgwu,473,1193,616,192,247,2721,5
icftu,473,338,271,1385,247,2714,5
isthm,473,341,1048,423,406,2691,5
gschu,965,341,701,423,247,2677,5
ethyl,693,403,334,271,971,2672,5
iflwu,473,73,1603,192,247,2588,5
ishum,473,341,334,899,406,2453,5
ozkum,532,59,406,899,406,2302,5
enzym,693,671,217,271,406,2258,5
isfug,473,341,271,899,261,2245,5
xdmcp,36,245,885,770,285,2221,5
izyum,473,59,381,899,406,2218,5
osfcw,532,341,271,770,122,2036,5
oghuz,532,139,334,899,122,2026,5
sanes,2206,4103,1757,3252,3767,15085,4
sales,2206,4103,1603,3252,3767,14931,4
sores,2206,3069,2201,3252,3767,14495,4
saree,2206,4103,2201,3252,2679,14441,4
sates,2206,4103,1048,3252,3767,14376,4
rares,948,4103,2201,3252,3767,14271,4
saris,2206,4103,2201,1963,3767,14240,4
sades,2206,4103,774,3252,3767,14102,4
sones,2206,3069,1757,3252,3767,14051,4
sabes,2206,4103,664,3252,3767,13992,4
sages,2206,4103,616,3252,3767,13944,4
soles,2206,3069,1603,3252,3767,13897,4
baras,1555,4103,2201,2214,3767,13840,4
caras,1512,4103,2201,2214,3767,13797,4
saves,2206,4103,417,3252,3767,13745,4
sakes,2206,4103,406,3252,3767,13734,4
bases,1555,4103,1021,3252,3767,13698,4
sires,2206,2239,2201,3252,3767,13665,4
sarts,2206,4103,2201,1385,3767,13662,4
cases,1512,4103,1021,3252,3767,13655,4
safes,2206,4103,271,3252,3767,13599,4
ceres,1512,2863,2201,3252,3767,13595,4
eanes,693,4103,1757,3252,3767,13572,4
saros,2206,4103,2201,1282,3767,13559,4
nanes,647,4103,1757,3252,3767,13526,4
maras,1225,4103,2201,2214,3767,13510,4
saxes,2206,4103,170,3252,3767,13498,4
barea,1555,4103,2201,3252,2362,13473,4
paras,1184,4103,2201,2214,3767,13469,4
soras,2206,3069,2201,2214,3767,13457,4
tates,1264,4103,1048,3252,3767,13434,4
soree,2206,3069,2201,3252,2679,13407,4
teres,1264,2863,2201,3252,3767,13347,4
babes,1555,4103,664,3252,3767,13341,4
pases,1184,4103,1021,3252,3767,13327,4
meres,1225,2863,2201,3252,3767,13308,4
laree,1046,4103,2201,3252,2679,13281,4
peres,1184,2863,2201,3252,3767,13267,4
sures,2206,1824,2201,3252,3767,13250,4
balas,1555,4103,1603,2214,3767,13242,4
sines,2206,2239,1757,3252,3767,13221,4
calas,1512,4103,1603,2214,3767,13199,4
benes,1555,2863,1757,3252,3767,13194,4
lases,1046,4103,1021,3252,3767,13189,4
tarea,1264,4103,2201,3252,2362,13182,4
sarus,2206,4103,2201,899,3767,13176,4
sains,2206,4103,1668,1391,3767,13135,4
haras,844,4103,2201,2214,3767,13129,4
gases,965,4103,1021,3252,3767,13108,4
sards,2206,4103,2201,829,3767,13106,4
rases,948,4103,1021,3252,3767,13091,4
satis,2206,4103,1048,1963,3767,13087,4
karas,789,4103,2201,2214,3767,13074,4
manas,1225,4103,1757,2214,3767,13066,4
salts,2206,4103,1603,1385,3767,13064,4
sails,2206,4103,1668,1295,3767,13039,4
karee,789,4103,2201,3252,2679,13024,4
coees,1512,3069,1421,3252,3767,13021,4
canea,1512,4103,1757,3252,2362,12986,4
danas,1128,4103,1757,2214,3767,12969,4
talas,1264,4103,1603,2214,3767,12951,4
feres,847,2863,2201,3252,3767,12930,4
heres,844,2863,2201,3252,3767,12927,4
sarks,2206,4103,2201,628,3767,12905,4
tenes,1264,2863,1757,3252,3767,12903,4
lanas,1046,4103,1757,2214,3767,12887,4
keres,789,2863,2201,3252,3767,12872,4
palas,1184,4103,1603,2214,3767,12871,4
menes,1225,2863,1757,3252,3767,12864,4
malee,1225,4103,1603,3252,2679,12862,4
penes,1184,2863,1757,3252,3767,12823,4
sadis,2206,4103,774,1963,3767,12813,4
carrs,1512,4103,2201,1225,3767,12808,4
aaren,1698,4103,2201,3252,1522,12776,4
denes,1128,2863,1757,3252,3767,12767,4
boree,1555,3069,2201,3252,2679,12756,4
teles,1264,2863,1603,3252,3767,12749,4
ranee,948,4103,1757,3252,2679,12739,4
tarts,1264,4103,2201,1385,3767,12720,4
coree,1512,3069,2201,3252,2679,12713,4
meles,1225,2863,1603,3252,3767,12710,4
gages,965,4103,616,3252,3767,12703,4
raias,948,4103,1668,2214,3767,12700,4
sokes,2206,3069,406,3252,3767,12700,4
varas,404,4103,2201,2214,3767,12689,4
lenes,1046,2863,1757,3252,3767,12685,4
baals,1555,4103,1959,1295,3767,12679,4
oases,532,4103,1021,3252,3767,12675,4
peles,1184,2863,1603,3252,3767,12669,4
sands,2206,4103,1757,829,3767,12662,4
galas,965,4103,1603,2214,3767,12652,4
sorns,2206,3069,2201,1391,3767,12634,4
kanas,789,4103,1757,2214,3767,12630,4
sorts,2206,3069,2201,1385,3767,12628,4
coses,1512,3069,1021,3252,3767,12621,4
sayee,2206,4103,381,3252,2679,12621,4
deles,1128,2863,1603,3252,3767,12613,4
solis,2206,3069,1603,1963,3767,12608,4
genes,965,2863,1757,3252,3767,12604,4
galee,965,4103,1603,3252,2679,12602,4
renes,948,2863,1757,3252,3767,12587,4
salus,2206,4103,1603,899,3767,12578,4
siree,2206,2239,2201,3252,2679,12577,4
banns,1555,4103,1757,1391,3767,12573,4
saids,2206,4103,1668,829,3767,12573,4
tarrs,1264,4103,2201,1225,3767,12560,4
vases,404,4103,1021,3252,3767,12547,4
halas,844,4103,1603,2214,3767,12531,4
jeres,446,2863,2201,3252,3767,12529,4
sites,2206,2239,1048,3252,3767,12512,4
palea,1184,4103,1603,3252,2362,12504,4
nones,647,3069,1757,3252,3767,12492,4
betes,1555,2863,1048,3252,3767,12485,4
camas,1512,4103,885,2214,3767,12481,4
parrs,1184,4103,2201,1225,3767,12480,4
dalea,1128,4103,1603,3252,2362,12448,4
sakis,2206,4103,406,1963,3767,12445,4
cetes,1512,2863,1048,3252,3767,12442,4
reles,948,2863,1603,3252,3767,12433,4
marae,1225,4103,2201,2214,2679,12422,4
sarre,2206,4103,2201,1225,2679,12414,4
basis,1555,4103,1021,1963,3767,12409,4
totes,1264,3069,1048,3252,3767,12400,4
naias,647,4103,1668,2214,3767,12399,4
poree,1184,3069,2201,3252,2679,12385,4
sauls,2206,4103,990,1295,3767,12361,4
aedes,1698,2863,774,3252,3767,12354,4
moses,1225,3069,1021,3252,3767,12334,4
doree,1128,3069,2201,3252,2679,12329,4
balls,1555,4103,1603,1295,3767,12323,4
batea,1555,4103,1048,3252,2362,12320,4
cadee,1512,4103,774,3252,2679,12320,4
patas,1184,4103,1048,2214,3767,12316,4
barer,1555,4103,2201,3252,1190,12301,4
poses,1184,3069,1021,3252,3767,12293,4
galea,965,4103,1603,3252,2362,12285,4
calls,1512,4103,1603,1295,3767,12280,4
maars,1225,4103,1959,1225,3767,12279,4
crres,1512,1543,2201,3252,3767,12275,4
patee,1184,4103,1048,3252,2679,12266,4
sarna,2206,4103,2201,1391,2362,12263,4
cabas,1512,4103,664,2214,3767,12260,4
carer,1512,4103,2201,3252,1190,12258,4
loree,1046,3069,2201,3252,2679,12247,4
saran,2206,4103,2201,2214,1522,12246,4
samos,2206,4103,885,1282,3767,12243,4
salay,2206,4103,1603,2214,2116,12242,4
sides,2206,2239,774,3252,3767,12238,4
doses,1128,3069,1021,3252,3767,12237,4
berea,1555,2863,2201,3252,2362,12233,4
tamas,1264,4103,885,2214,3767,12233,4
eaves,693,4103,417,3252,3767,12232,4
soars,2206,3069,1959,1225,3767,12226,4
baiae,1555,4103,1668,2214,2679,12219,4
suras,2206,1824,2201,2214,3767,12212,4
saxis,2206,4103,170,1963,3767,12209,4
salps,2206,4103,1603,526,3767,12205,4
momes,1225,3069,885,3252,3767,12198,4
seney,2206,2863,1757,3252,2116,12194,4
baray,1555,4103,2201,2214,2116,12189,4
baria,1555,4103,2201,1963,2362,12184,4
sinas,2206,2239,1757,2214,3767,12183,4
seats,2206,2863,1959,1385,3767,12180,4
saare,2206,4103,1959,1225,2679,12172,4
cedes,1512,2863,774,3252,3767,12168,4
goree,965,3069,2201,3252,2679,12166,4
sices,2206,2239,701,3252,3767,12165,4
loses,1046,3069,1021,3252,3767,12155,4
metes,1225,2863,1048,3252,3767,12155,4
sorus,2206,3069,2201,899,3767,12142,4
caria,1512,4103,2201,1963,2362,12141,4
somas,2206,3069,885,2214,3767,12141,4
xeres,36,2863,2201,3252,3767,12119,4
petes,1184,2863,1048,3252,3767,12114,4
damas,1128,4103,885,2214,3767,12097,4
seals,2206,2863,1959,1295,3767,12090,4
jalee,446,4103,1603,3252,2679,12083,4
sords,2206,3069,2201,829,3767,12072,4
sooey,2206,3069,1426,3252,2116,12069,4
roses,948,3069,1021,3252,3767,12057,4
babis,1555,4103,664,1963,3767,12052,4
barbs,1555,4103,2201,423,3767,12049,4
baiss,1555,4103,1668,945,3767,12038,4
pasis,1184,4103,1021,1963,3767,12038,4
sodas,2206,3069,774,2214,3767,12030,4
silas,2206,2239,1603,2214,3767,12029,4
sipes,2206,2239,560,3252,3767,12024,4
sears,2206,2863,1959,1225,3767,12020,4
lamas,1046,4103,885,2214,3767,12015,4
soils,2206,3069,1668,1295,3767,12005,4
malls,1225,4103,1603,1295,3767,11993,4
berey,1555,2863,2201,3252,2116,11987,4
monee,1225,3069,1757,3252,2679,11982,4
sents,2206,2863,1757,1385,3767,11978,4
sagos,2206,4103,616,1282,3767,11974,4
pacas,1184,4103,701,2214,3767,11969,4
lamee,1046,4103,885,3252,2679,11965,4
cepes,1512,2863,560,3252,3767,11954,4
hoses,844,3069,1021,3252,3767,11953,4
palls,1184,4103,1603,1295,3767,11952,4
roris,948,3069,2201,1963,3767,11948,4
gamas,965,4103,885,2214,3767,11934,4
parer,1184,4103,2201,3252,1190,11930,4
magas,1225,4103,616,2214,3767,11925,4
sorer,2206,3069,2201,3252,1190,11918,4
tapas,1264,4103,560,2214,3767,11908,4
liles,1046,2239,1603,3252,3767,11907,4
sacae,2206,4103,701,2214,2679,11903,4
saeed,2206,4103,1421,3252,917,11899,4
haars,844,4103,1959,1225,3767,11898,4
demes,1128,2863,885,3252,3767,11895,4
somis,2206,3069,885,1963,3767,11890,4
salle,2206,4103,1603,1295,2679,11886,4
donee,1128,3069,1757,3252,2679,11885,4
pagas,1184,4103,616,2214,3767,11884,4
danae,1128,4103,1757,2214,2679,11881,4
magee,1225,4103,616,3252,2679,11875,4
darer,1128,4103,2201,3252,1190,11874,4
katee,789,4103,1048,3252,2679,11871,4
sikes,2206,2239,406,3252,3767,11870,4
ramee,948,4103,885,3252,2679,11867,4
perea,1184,2863,2201,3252,2362,11862,4
maray,1225,4103,2201,2214,2116,11859,4
batts,1555,4103,1048,1385,3767,11858,4
maria,1225,4103,2201,1963,2362,11854,4
sloes,2206,1193,1426,3252,3767,11844,4
pedes,1184,2863,774,3252,3767,11840,4
bises,1555,2239,1021,3252,3767,11834,4
popes,1184,3069,560,3252,3767,11832,4
basts,1555,4103,1021,1385,3767,11831,4
sudes,2206,1824,774,3252,3767,11823,4
shies,2206,927,1668,3252,3767,11820,4
santa,2206,4103,1757,1385,2362,11813,4
latea,1046,4103,1048,3252,2362,11811,4
lonee,1046,3069,1757,3252,2679,11803,4
lanae,1046,4103,1757,2214,2679,11799,4
casts,1512,4103,1021,1385,3767,11788,4
baaed,1555,4103,1959,3252,917,11786,4
lacee,1046,4103,701,3252,2679,11781,4
fetes,847,2863,1048,3252,3767,11777,4
barre,1555,4103,2201,1225,2679,11763,4
kamas,789,4103,885,2214,3767,11758,4
daria,1128,4103,2201,1963,2362,11757,4
noses,647,3069,1021,3252,3767,11756,4
lagas,1046,4103,616,2214,3767,11746,4
bania,1555,4103,1757,1963,2362,11740,4
galls,965,4103,1603,1295,3767,11733,4
basos,1555,4103,1021,1282,3767,11728,4
naren,647,4103,2201,3252,1522,11725,4
meges,1225,2863,616,3252,3767,11723,4
waals,596,4103,1959,1295,3767,11720,4
madea,1225,4103,774,3252,2362,11716,4
ralls,948,4103,1603,1295,3767,11716,4
auras,1698,1824,2201,2214,3767,11704,4
hadas,844,4103,774,2214,3767,11702,4
siros,2206,2239,2201,1282,3767,11695,4
sauks,2206,4103,990,628,3767,11694,4
mayas,1225,4103,381,2214,3767,11690,4
satay,2206,4103,1048,2214,2116,11687,4
torts,1264,3069,2201,1385,3767,11686,4
semis,2206,2863,885,1963,3767,11684,4
sizes,2206,2239,217,3252,3767,11681,4
laria,1046,4103,2201,1963,2362,11675,4
debes,1128,2863,664,3252,3767,11674,4
sorbs,2206,3069,2201,423,3767,11666,4
nines,647,2239,1757,3252,3767,11662,4
nants,647,4103,1757,1385,3767,11659,4
salta,2206,4103,1603,1385,2362,11659,4
ragas,948,4103,616,2214,3767,11648,4
joree,446,3069,2201,3252,2679,11647,4
cavea,1512,4103,417,3252,2362,11646,4
sarad,2206,4103,2201,2214,917,11641,4
soyas,2206,3069,381,2214,3767,11637,4
sixes,2206,2239,170,3252,3767,11634,4
tarte,1264,4103,2201,1385,2679,11632,4
soaks,2206,3069,1959,628,3767,11629,4
sonds,2206,3069,1757,829,3767,11628,4
ainee,1698,2239,1757,3252,2679,11625,4
falls,847,4103,1603,1295,3767,11615,4
femes,847,2863,885,3252,3767,11614,4
barna,1555,4103,2201,1391,2362,11612,4
halls,844,4103,1603,1295,3767,11612,4
raiae,948,4103,1668,2214,2679,11612,4
hemes,844,2863,885,3252,3767,11611,4
supes,2206,1824,560,3252,3767,11609,4
barta,1555,4103,2201,1385,2362,11606,4
redes,948,2863,774,3252,3767,11604,4
dared,1128,4103,2201,3252,917,11601,4
payee,1184,4103,381,3252,2679,11599,4
ragee,948,4103,616,3252,2679,11598,4
hanae,844,4103,1757,2214,2679,11597,4
farer,847,4103,2201,3252,1190,11593,4
lebes,1046,2863,664,3252,3767,11592,4
toros,1264,3069,2201,1282,3767,11583,4
mamey,1225,4103,885,3252,2116,11581,4
shoes,2206,927,1426,3252,3767,11578,4
golee,965,3069,1603,3252,2679,11568,4
snies,2206,671,1668,3252,3767,11564,4
joses,446,3069,1021,3252,3767,11555,4
svres,2206,126,2201,3252,3767,11552,4
eadas,693,4103,774,2214,3767,11551,4
lavas,1046,4103,417,2214,3767,11547,4
leges,1046,2863,616,3252,3767,11544,4
moros,1225,3069,2201,1282,3767,11544,4
solus,2206,3069,1603,899,3767,11544,4
calia,1512,4103,1603,1963,2362,11543,4
kanae,789,4103,1757,2214,2679,11542,4
bonns,1555,3069,1757,1391,3767,11539,4
brees,1555,1543,1421,3252,3767,11538,4
salse,2206,4103,1603,945,2679,11536,4
matts,1225,4103,1048,1385,3767,11528,4
soaps,2206,3069,1959,526,3767,11527,4
sofas,2206,3069,271,2214,3767,11527,4
spaes,2206,336,1959,3252,3767,11520,4
samia,2206,4103,885,1963,2362,11519,4
tauts,1264,4103,990,1385,3767,11509,4
mises,1225,2239,1021,3252,3767,11504,4
poros,1184,3069,2201,1282,3767,11503,4
masts,1225,4103,1021,1385,3767,11501,4
conns,1512,3069,1757,1391,3767,11496,4
zalea,176,4103,1603,3252,2362,11496,4
crees,1512,1543,1421,3252,3767,11495,4
toois,1264,3069,1426,1963,3767,11489,4
samps,2206,4103,885,526,3767,11487,4
saeta,2206,4103,1421,1385,2362,11477,4
faria,847,4103,2201,1963,2362,11476,4
carla,1512,4103,2201,1295,2362,11473,4
pekes,1184,2863,406,3252,3767,11472,4
tarre,1264,4103,2201,1225,2679,11472,4
ailee,1698,2239,1603,3252,2679,11471,4
sials,2206,2239,1959,1295,3767,11466,4
caroa,1512,4103,2201,1282,2362,11460,4
pasts,1184,4103,1021,1385,3767,11460,4
nonas,647,3069,1757,2214,3767,11454,4
teaey,1264,2863,1959,3252,2116,11454,4
tania,1264,4103,1757,1963,2362,11449,4
reges,948,2863,616,3252,3767,11446,4
sered,2206,2863,2201,3252,917,11439,4
kapas,789,4103,560,2214,3767,11433,4
bonos,1555,3069,1757,1282,3767,11430,4
feces,847,2863,701,3252,3767,11430,4
aotea,1698,3069,1048,3252,2362,11429,4
sends,2206,2863,1757,829,3767,11422,4
rared,948,4103,2201,3252,917,11421,4
buses,1555,1824,1021,3252,3767,11419,4
karia,789,4103,2201,1963,2362,11418,4
dekes,1128,2863,406,3252,3767,11416,4
rayas,948,4103,381,2214,3767,11413,4
songs,2206,3069,1757,612,3767,11411,4
mania,1225,4103,1757,1963,2362,11410,4
salat,2206,4103,1603,2214,1284,11410,4
slues,2206,1193,990,3252,3767,11408,4
seams,2206,2863,1959,612,3767,11407,4
sacks,2206,4103,701,628,3767,11405,4
aerie,1698,2863,2201,1963,2679,11404,4
dorrs,1128,3069,2201,1225,3767,11390,4
hebes,844,2863,664,3252,3767,11390,4
majas,1225,4103,81,2214,3767,11390,4
rakee,948,4103,406,3252,2679,11388,4
oasis,532,4103,1021,1963,3767,11386,4
sarah,2206,4103,2201,2214,654,11378,4
jetes,446,2863,1048,3252,3767,11376,4
cooey,1512,3069,1426,3252,2116,11375,4
maims,1225,4103,1668,612,3767,11375,4
panay,1184,4103,1757,2214,2116,11374,4
mimes,1225,2239,885,3252,3767,11368,4
loros,1046,3069,2201,1282,3767,11365,4
cayey,1512,4103,381,3252,2116,11364,4
walls,596,4103,1603,1295,3767,11364,4
barat,1555,4103,2201,2214,1284,11357,4
warer,596,4103,2201,3252,1190,11342,4
aurea,1698,1824,2201,3252,2362,11337,4
sojas,2206,3069,81,2214,3767,11337,4
souls,2206,3069,990,1295,3767,11327,4
sally,2206,4103,1603,1295,2116,11323,4
lasts,1046,4103,1021,1385,3767,11322,4
salar,2206,4103,1603,2214,1190,11316,4
serfs,2206,2863,2201,278,3767,11315,4
carat,1512,4103,2201,2214,1284,11314,4
selie,2206,2863,1603,1963,2679,11314,4
dania,1128,4103,1757,1963,2362,11313,4
simas,2206,2239,885,2214,3767,11311,4
malms,1225,4103,1603,612,3767,11310,4
leyes,1046,2863,381,3252,3767,11309,4
taran,1264,4103,2201,2214,1522,11304,4
casus,1512,4103,1021,899,3767,11302,4
sabia,2206,4103,664,1963,2362,11298,4
sties,2206,403,1668,3252,3767,11296,4
talia,1264,4103,1603,1963,2362,11295,4
kavas,789,4103,417,2214,3767,11290,4
bolls,1555,3069,1603,1295,3767,11289,4
codee,1512,3069,774,3252,2679,11286,4
marna,1225,4103,2201,1391,2362,11282,4
arses,1698,1543,1021,3252,3767,11281,4
lewes,1046,2863,349,3252,3767,11277,4
bolos,1555,3069,1603,1282,3767,11276,4
marta,1225,4103,2201,1385,2362,11276,4
ailis,1698,2239,1603,1963,3767,11270,4
borer,1555,3069,2201,3252,1190,11267,4
carce,1512,4103,2201,770,2679,11265,4
shree,2206,927,2201,3252,2679,11265,4
cocas,1512,3069,701,2214,3767,11263,4
malay,1225,4103,1603,2214,2116,11261,4
sours,2206,3069,990,1225,3767,11257,4
malia,1225,4103,1603,1963,2362,11256,4
nunes,647,1824,1757,3252,3767,11247,4
trees,1264,1543,1421,3252,3767,11247,4
serle,2206,2863,2201,1295,2679,11244,4
gasts,965,4103,1021,1385,3767,11241,4
teats,1264,2863,1959,1385,3767,11238,4
spies,2206,336,1668,3252,3767,11229,4
rises,948,2239,1021,3252,3767,11227,4
corer,1512,3069,2201,3252,1190,11224,4
paran,1184,4103,2201,2214,1522,11224,4
palay,1184,4103,1603,2214,2116,11220,4
tacts,1264,4103,701,1385,3767,11220,4
gazee,965,4103,217,3252,2679,11216,4
liris,1046,2239,2201,1963,3767,11216,4
papey,1184,4103,560,3252,2116,11215,4
lajas,1046,4103,81,2214,3767,11211,4
boons,1555,3069,1426,1391,3767,11208,4
gangs,965,4103,1757,612,3767,11204,4
boots,1555,3069,1426,1385,3767,11202,4
barry,1555,4103,2201,1225,2116,11200,4
sachs,2206,4103,701,423,3767,11200,4
silts,2206,2239,1603,1385,3767,11200,4
razee,948,4103,217,3252,2679,11199,4
waacs,596,4103,1959,770,3767,11195,4
calle,1512,4103,1603,1295,2679,11192,4
sanai,2206,4103,1757,2214,910,11190,4
marla,1225,4103,2201,1295,2362,11186,4
palps,1184,4103,1603,526,3767,11183,4
dexes,1128,2863,170,3252,3767,11180,4
sereh,2206,2863,2201,3252,654,11176,4
maroa,1225,4103,2201,1282,2362,11173,4
arris,1698,1543,2201,1963,3767,11172,4
saida,2206,4103,1668,829,2362,11168,4
prees,1184,1543,1421,3252,3767,11167,4
eared,693,4103,2201,3252,917,11166,4
coons,1512,3069,1426,1391,3767,11165,4
coots,1512,3069,1426,1385,3767,11159,4
dalia,1128,4103,1603,1963,2362,11159,4
carry,1512,4103,2201,1225,2116,11157,4
beret,1555,2863,2201,3252,1284,11155,4
toits,1264,3069,1668,1385,3767,11153,4
lezes,1046,2863,217,3252,3767,11145,4
puree,1184,1824,2201,3252,2679,11140,4
rania,948,4103,1757,1963,2362,11133,4
fasts,847,4103,1021,1385,3767,11123,4
panne,1184,4103,1757,1391,2679,11114,4
seler,2206,2863,1603,3252,1190,11114,4
rajas,948,4103,81,2214,3767,11113,4
drees,1128,1543,1421,3252,3767,11111,4
heyes,844,2863,381,3252,3767,11107,4
aulas,1698,1824,1603,2214,3767,11106,4
zetes,176,2863,1048,3252,3767,11106,4
vagas,404,4103,616,2214,3767,11104,4
monos,1225,3069,1757,1282,3767,11100,4
taite,1264,4103,1668,1385,2679,11099,4
lexes,1046,2863,170,3252,3767,11098,4
silos,2206,2239,1603,1282,3767,11097,4
satan,2206,4103,1048,2214,1522,11093,4
mesas,1225,2863,1021,2214,3767,11090,4
darla,1128,4103,2201,1295,2362,11089,4
muses,1225,1824,1021,3252,3767,11089,4
aeria,1698,2863,2201,1963,2362,11087,4
wakas,596,4103,406,2214,3767,11086,4
duree,1128,1824,2201,3252,2679,11084,4
bells,1555,2863,1603,1295,3767,11083,4
carua,1512,4103,2201,899,2362,11077,4
mayey,1225,4103,381,3252,2116,11077,4
hewes,844,2863,349,3252,3767,11075,4
norns,647,3069,2201,1391,3767,11075,4
basks,1555,4103,1021,628,3767,11074,4
toret,1264,3069,2201,3252,1284,11070,4
cools,1512,3069,1426,1295,3767,11069,4
tarty,1264,4103,2201,1385,2116,11069,4
shris,2206,927,2201,1963,3767,11064,4
sorra,2206,3069,2201,1225,2362,11063,4
ponos,1184,3069,1757,1282,3767,11059,4
tatie,1264,4103,1048,1963,2679,11057,4
sanka,2206,4103,1757,628,2362,11056,4
dados,1128,4103,774,1282,3767,11054,4
harre,844,4103,2201,1225,2679,11052,4
keyes,789,2863,381,3252,3767,11052,4
sauna,2206,4103,990,1391,2362,11052,4
jolee,446,3069,1603,3252,2679,11049,4
puses,1184,1824,1021,3252,3767,11048,4
salad,2206,4103,1603,2214,917,11043,4
boors,1555,3069,1426,1225,3767,11042,4
cells,1512,2863,1603,1295,3767,11040,4
mlles,1225,1193,1603,3252,3767,11040,4
sanga,2206,4103,1757,612,2362,11040,4
tents,1264,2863,1757,1385,3767,11036,4
varia,404,4103,2201,1963,2362,11033,4
fania,847,4103,1757,1963,2362,11032,4
batia,1555,4103,1048,1963,2362,11031,4
casks,1512,4103,1021,628,3767,11031,4
skies,2206,137,1668,3252,3767,11030,4
kakis,789,4103,406,1963,3767,11028,4
marat,1225,4103,2201,2214,1284,11027,4
ernes,693,1543,1757,3252,3767,11012,4
setae,2206,2863,1048,2214,2679,11010,4
balta,1555,4103,1603,1385,2362,11008,4
basia,1555,4103,1021,1963,2362,11004,4
pipes,1184,2239,560,3252,3767,11002,4
seale,2206,2863,1959,1295,2679,11002,4
rexes,948,2863,170,3252,3767,11000,4
coors,1512,3069,1426,1225,3767,10999,4
tolls,1264,3069,1603,1295,3767,10998,4
balan,1555,4103,1603,2214,1522,10997,4
barca,1555,4103,2201,770,2362,10991,4
beets,1555,2863,1421,1385,3767,10991,4
barad,1555,4103,2201,2214,917,10990,4
babus,1555,4103,664,899,3767,10988,4
birrs,1555,2239,2201,1225,3767,10987,4
cacus,1512,4103,701,899,3767,10982,4
kania,789,4103,1757,1963,2362,10974,4
earle,693,4103,2201,1295,2679,10971,4
yarer,225,4103,2201,3252,1190,10971,4
easts,693,4103,1021,1385,3767,10969,4
roars,948,3069,1959,1225,3767,10968,4
hakea,844,4103,406,3252,2362,10967,4
barbe,1555,4103,2201,423,2679,10961,4
casia,1512,4103,1021,1963,2362,10961,4
molls,1225,3069,1603,1295,3767,10959,4
cacie,1512,4103,701,1963,2679,10958,4
calan,1512,4103,1603,2214,1522,10954,4
haafs,844,4103,1959,278,3767,10951,4
minis,1225,2239,1757,1963,3767,10951,4
saiga,2206,4103,1668,612,2362,10951,4
dosis,1128,3069,1021,1963,3767,10948,4
grees,965,1543,1421,3252,3767,10948,4
javas,446,4103,417,2214,3767,10947,4
fezes,847,2863,217,3252,3767,10946,4
neves,647,2863,417,3252,3767,10946,4
sosie,2206,3069,1021,1963,2679,10938,4
darat,1128,4103,2201,2214,1284,10930,4
saman,2206,4103,885,2214,1522,10930,4
arnee,1698,1543,1757,3252,2679,10929,4
cavae,1512,4103,417,2214,2679,10925,4
eries,693,1543,1668,3252,3767,10923,4
sects,2206,2863,701,1385,3767,10922,4
polls,1184,3069,1603,1295,3767,10918,4
toons,1264,3069,1426,1391,3767,10917,4
banat,1555,4103,1757,2214,1284,10913,4
looey,1046,3069,1426,3252,2116,10909,4
tarry,1264,4103,2201,1225,2116,10909,4
polos,1184,3069,1603,1282,3767,10905,4
watts,596,4103,1048,1385,3767,10899,4
hexes,844,2863,170,3252,3767,10896,4
porer,1184,3069,2201,3252,1190,10896,4
sumas,2206,1824,885,2214,3767,10896,4
arias,1698,1543,1668,2214,3767,10890,4
salma,2206,4103,1603,612,2362,10886,4
saura,2206,4103,990,1225,2362,10886,4
canny,1512,4103,1757,1391,2116,10879,4
moons,1225,3069,1426,1391,3767,10878,4
rinee,948,2239,1757,3252,2679,10875,4
wises,596,2239,1021,3252,3767,10875,4
moots,1225,3069,1426,1385,3767,10872,4
wasts,596,4103,1021,1385,3767,10872,4
marry,1225,4103,2201,1225,2116,10870,4
lilas,1046,2239,1603,2214,3767,10869,4
saraf,2206,4103,2201,2214,145,10869,4
sinus,2206,2239,1757,899,3767,10868,4
dolls,1128,3069,1603,1295,3767,10862,4
rorie,948,3069,2201,1963,2679,10860,4
saiid,2206,4103,1668,1963,917,10857,4
serra,2206,2863,2201,1225,2362,10857,4
tater,1264,4103,1048,3252,1190,10857,4
mamie,1225,4103,885,1963,2679,10855,4
suits,2206,1824,1668,1385,3767,10850,4
dolos,1128,3069,1603,1282,3767,10849,4
karna,789,4103,2201,1391,2362,10846,4
sivas,2206,2239,417,2214,3767,10843,4
kexes,789,2863,170,3252,3767,10841,4
samoa,2206,4103,885,1282,2362,10838,4
oozes,532,3069,217,3252,3767,10837,4
poons,1184,3069,1426,1391,3767,10837,4
verey,404,2863,2201,3252,2116,10836,4
manta,1225,4103,1757,1385,2362,10832,4
beers,1555,2863,1421,1225,3767,10831,4
camay,1512,4103,885,2214,2116,10830,4
frees,847,1543,1421,3252,3767,10830,4
parry,1184,4103,2201,1225,2116,10829,4
gooey,965,3069,1426,3252,2116,10828,4
surds,2206,1824,2201,829,3767,10827,4
botts,1555,3069,1048,1385,3767,10824,4
topee,1264,3069,560,3252,2679,10824,4
tools,1264,3069,1426,1295,3767,10821,4
zapas,176,4103,560,2214,3767,10820,4
secos,2206,2863,701,1282,3767,10819,4
zoaea,176,3069,1959,3252,2362,10818,4
niris,647,2239,2201,1963,3767,10817,4
sorry,2206,3069,2201,1225,2116,10817,4
sasin,2206,4103,1021,1963,1522,10815,4
ruses,948,1824,1021,3252,3767,10812,4
arrey,1698,1543,2201,3252,2116,10810,4
dalle,1128,4103,1603,1295,2679,10808,4
oasts,532,4103,1021,1385,3767,10808,4
seine,2206,2863,1668,1391,2679,10807,4
aaron,1698,4103,2201,1282,1522,10806,4
zaria,176,4103,2201,1963,2362,10805,4
ferae,847,2863,2201,2214,2679,10804,4
salpa,2206,4103,1603,526,2362,10800,4
belen,1555,2863,1603,3252,1522,10795,4
tells,1264,2863,1603,1295,3767,10792,4
panta,1184,4103,1757,1385,2362,10791,4
carga,1512,4103,2201,612,2362,10790,4
carma,1512,4103,2201,612,2362,10790,4
tasks,1264,4103,1021,628,3767,10783,4
mools,1225,3069,1426,1295,3767,10782,4
seifs,2206,2863,1668,278,3767,10782,4
seana,2206,2863,1959,1391,2362,10781,4
septs,2206,2863,560,1385,3767,10781,4
arlee,1698,1543,1603,3252,2679,10775,4
darry,1128,4103,2201,1225,2116,10773,4
linis,1046,2239,1757,1963,3767,10772,4
gauss,965,4103,990,945,3767,10770,4
tanoa,1264,4103,1757,1282,2362,10768,4
baber,1555,4103,664,3252,1190,10764,4
rears,948,2863,1959,1225,3767,10762,4
rarde,948,4103,2201,829,2679,10760,4
balat,1555,4103,1603,2214,1284,10759,4
pilis,1184,2239,1603,1963,3767,10756,4
costs,1512,3069,1021,1385,3767,10754,4
aimee,1698,2239,885,3252,2679,10753,4
mells,1225,2863,1603,1295,3767,10753,4
karla,789,4103,2201,1295,2362,10750,4
cered,1512,2863,2201,3252,917,10745,4
dudes,1128,1824,774,3252,3767,10745,4
masks,1225,4103,1021,628,3767,10744,4
pools,1184,3069,1426,1295,3767,10741,4
stree,2206,403,2201,3252,2679,10741,4
aulea,1698,1824,1603,3252,2362,10739,4
danta,1128,4103,1757,1385,2362,10735,4
segos,2206,2863,616,1282,3767,10734,4
citee,1512,2239,1048,3252,2679,10730,4
semen,2206,2863,885,3252,1522,10728,4
selfs,2206,2863,1603,278,3767,10717,4
aitis,1698,2239,1048,1963,3767,10715,4
aorta,1698,3069,2201,1385,2362,10715,4
sodus,2206,3069,774,899,3767,10715,4
maral,1225,4103,2201,2214,971,10714,4
tasia,1264,4103,1021,1963,2362,10713,4
moors,1225,3069,1426,1225,3767,10712,4
benet,1555,2863,1757,3252,1284,10711,4
cacks,1512,4103,701,628,3767,10711,4
fuses,847,1824,1021,3252,3767,10711,4
saban,2206,4103,664,2214,1522,10709,4
hooey,844,3069,1426,3252,2116,10707,4
teens,1264,2863,1421,1391,3767,10706,4
baese,1555,4103,1421,945,2679,10703,4
waafs,596,4103,1959,278,3767,10703,4
dilis,1128,2239,1603,1963,3767,10700,4
loons,1046,3069,1426,1391,3767,10699,4
softs,2206,3069,271,1385,3767,10698,4
salba,2206,4103,1603,423,2362,10697,4
hayey,844,4103,381,3252,2116,10696,4
loots,1046,3069,1426,1385,3767,10693,4
tarai,1264,4103,2201,2214,910,10692,4
larry,1046,4103,2201,1225,2116,10691,4
celss,1512,2863,1603,945,3767,10690,4
berne,1555,2863,2201,1391,2679,10689,4
berte,1555,2863,2201,1385,2679,10683,4
vises,404,2239,1021,3252,3767,10683,4
rolls,948,3069,1603,1295,3767,10682,4
vasts,404,4103,1021,1385,3767,10680,4
malta,1225,4103,1603,1385,2362,10678,4
gorer,965,3069,2201,3252,1190,10677,4
scree,2206,338,2201,3252,2679,10676,4
subas,2206,1824,664,2214,3767,10675,4
spree,2206,336,2201,3252,2679,10674,4
surer,2206,1824,2201,3252,1190,10673,4
bally,1555,4103,1603,1295,2116,10672,4
malan,1225,4103,1603,2214,1522,10667,4
belie,1555,2863,1603,1963,2679,10663,4
meets,1225,2863,1421,1385,3767,10661,4
sagan,2206,4103,616,2214,1522,10661,4
patia,1184,4103,1048,1963,2362,10660,4
souks,2206,3069,990,628,3767,10660,4
larsa,1046,4103,2201,945,2362,10657,4
dells,1128,2863,1603,1295,3767,10656,4
earla,693,4103,2201,1295,2362,10654,4
baggs,1555,4103,616,612,3767,10653,4
lanta,1046,4103,1757,1385,2362,10653,4
warta,596,4103,2201,1385,2362,10647,4
galle,965,4103,1603,1295,2679,10645,4
silds,2206,2239,1603,829,3767,10644,4
areas,1698,1543,1421,2214,3767,10643,4
denae,1128,2863,1757,2214,2679,10641,4
pasay,1184,4103,1021,2214,2116,10638,4
palta,1184,4103,1603,1385,2362,10637,4
pasia,1184,4103,1021,1963,2362,10633,4
jania,446,4103,1757,1963,2362,10631,4
tamms,1264,4103,885,612,3767,10631,4
tanny,1264,4103,1757,1391,2116,10631,4
cally,1512,4103,1603,1295,2116,10629,4
peens,1184,2863,1421,1391,3767,10626,4
telae,1264,2863,1603,2214,2679,10623,4
taira,1264,4103,1668,1225,2362,10622,4
papen,1184,4103,560,3252,1522,10621,4
sosia,2206,3069,1021,1963,2362,10621,4
celie,1512,2863,1603,1963,2679,10620,4
parca,1184,4103,2201,770,2362,10620,4
eaten,693,4103,1048,3252,1522,10618,4
goons,965,3069,1426,1391,3767,10618,4
aurae,1698,1824,2201,2214,2679,10616,4
doors,1128,3069,1426,1225,3767,10615,4
serry,2206,2863,2201,1225,2116,10611,4
garry,965,4103,2201,1225,2116,10610,4
teels,1264,2863,1421,1295,3767,10610,4
banda,1555,4103,1757,829,2362,10606,4
sapan,2206,4103,560,2214,1522,10605,4
taccs,1264,4103,701,770,3767,10605,4
tacet,1264,4103,701,3252,1284,10604,4
suets,2206,1824,1421,1385,3767,10603,4
banal,1555,4103,1757,2214,971,10600,4
mapss,1225,4103,560,945,3767,10600,4
jefes,446,2863,271,3252,3767,10599,4
glees,965,1193,1421,3252,3767,10598,4
saiva,2206,4103,1668,259,2362,10598,4
samar,2206,4103,885,2214,1190,10598,4
torte,1264,3069,2201,1385,2679,10598,4
sacra,2206,4103,701,1225,2362,10597,4
sinks,2206,2239,1757,628,3767,10597,4
roots,948,3069,1426,1385,3767,10595,4
manny,1225,4103,1757,1391,2116,10592,4
bests,1555,2863,1021,1385,3767,10591,4
karat,789,4103,2201,2214,1284,10591,4
vania,404,4103,1757,1963,2362,10589,4
manat,1225,4103,1757,2214,1284,10583,4
sadat,2206,4103,774,2214,1284,10581,4
sings,2206,2239,1757,612,3767,10581,4
airer,1698,2239,2201,3252,1190,10580,4
beroe,1555,2863,2201,1282,2679,10580,4
senna,2206,2863,1757,1391,2362,10579,4
vasos,404,4103,1021,1282,3767,10577,4
barak,1555,4103,2201,2214,502,10575,4
niais,647,2239,1959,1963,3767,10575,4
finis,847,2239,1757,1963,3767,10573,4
bitis,1555,2239,1048,1963,3767,10572,4
burrs,1555,1824,2201,1225,3767,10572,4
ganta,965,4103,1757,1385,2362,10572,4
dalan,1128,4103,1603,2214,1522,10570,4
laina,1046,4103,1668,1391,2362,10570,4
balsa,1555,4103,1603,945,2362,10568,4
tabet,1264,4103,664,3252,1284,10567,4
deets,1128,2863,1421,1385,3767,10564,4
serge,2206,2863,2201,612,2679,10561,4
sabra,2206,4103,664,1225,2362,10560,4
parao,1184,4103,2201,2214,857,10559,4
bomos,1555,3069,885,1282,3767,10558,4
soups,2206,3069,990,526,3767,10558,4
canal,1512,4103,1757,2214,971,10557,4
ferie,847,2863,2201,1963,2679,10553,4
spues,2206,336,990,3252,3767,10551,4
ronen,948,3069,1757,3252,1522,10548,4
banca,1555,4103,1757,770,2362,10547,4
deads,1128,2863,1959,829,3767,10546,4
babel,1555,4103,664,3252,971,10545,4
atees,1698,403,1421,3252,3767,10541,4
rater,948,4103,1048,3252,1190,10541,4
alias,1698,1193,1668,2214,3767,10540,4
lorel,1046,3069,2201,3252,971,10539,4
sonny,2206,3069,1757,1391,2116,10539,4
sheas,2206,927,1421,2214,3767,10535,4
salva,2206,4103,1603,259,2362,10533,4
garua,965,4103,2201,899,2362,10530,4
haase,844,4103,1959,945,2679,10530,4
peels,1184,2863,1421,1295,3767,10530,4
currs,1512,1824,2201,1225,3767,10529,4
teaer,1264,2863,1959,3252,1190,10528,4
halle,844,4103,1603,1295,2679,10524,4
sekos,2206,2863,406,1282,3767,10524,4
gools,965,3069,1426,1295,3767,10522,4
latia,1046,4103,1048,1963,2362,10522,4
marka,1225,4103,2201,628,2362,10519,4
raser,948,4103,1021,3252,1190,10514,4
soths,2206,3069,1048,423,3767,10513,4
merel,1225,2863,2201,3252,971,10512,4
sagra,2206,4103,616,1225,2362,10512,4
kolos,789,3069,1603,1282,3767,10510,4
slats,2206,1193,1959,1385,3767,10510,4
canad,1512,4103,1757,2214,917,10503,4
marga,1225,4103,2201,612,2362,10503,4
meers,1225,2863,1421,1225,3767,10501,4
danny,1128,4103,1757,1391,2116,10495,4
foots,847,3069,1426,1385,3767,10494,4
motts,1225,3069,1048,1385,3767,10494,4
hoots,844,3069,1426,1385,3767,10491,4
circs,1512,2239,2201,770,3767,10489,4
harry,844,4103,2201,1225,2116,10489,4
daira,1128,4103,1668,1225,2362,10486,4
leets,1046,2863,1421,1385,3767,10482,4
satai,2206,4103,1048,2214,910,10481,4
tozee,1264,3069,217,3252,2679,10481,4
flees,847,1193,1421,3252,3767,10480,4
baram,1555,4103,2201,2214,406,10479,4
cacei,1512,4103,701,3252,910,10478,4
genae,965,2863,1757,2214,2679,10478,4
parka,1184,4103,2201,628,2362,10478,4
medea,1225,2863,774,3252,2362,10476,4
touts,1264,3069,990,1385,3767,10475,4
raina,948,4103,1668,1391,2362,10472,4
daccs,1128,4103,701,770,3767,10469,4
kalle,789,4103,1603,1295,2679,10469,4
capps,1512,4103,560,526,3767,10468,4
josee,446,3069,1021,3252,2679,10467,4
mosts,1225,3069,1021,1385,3767,10467,4
lauia,1046,4103,990,1963,2362,10464,4
lovee,1046,3069,417,3252,2679,10463,4
petey,1184,2863,1048,3252,2116,10463,4
tapet,1264,4103,560,3252,1284,10463,4
parma,1184,4103,2201,612,2362,10462,4
sakta,2206,4103,406,1385,2362,10462,4
renae,948,2863,1757,2214,2679,10461,4
varna,404,4103,2201,1391,2362,10461,4
garda,965,4103,2201,829,2362,10460,4
peers,1184,2863,1421,1225,3767,10460,4
batna,1555,4103,1048,1391,2362,10459,4
bills,1555,2239,1603,1295,3767,10459,4
mered,1225,2863,2201,3252,917,10458,4
vexes,404,2863,170,3252,3767,10456,4
kikes,789,2239,406,3252,3767,10453,4
potts,1184,3069,1048,1385,3767,10453,4
taste,1264,4103,1021,1385,2679,10452,4
bonne,1555,3069,1757,1391,2679,10451,4
carya,1512,4103,2201,271,2362,10449,4
cooer,1512,3069,1426,3252,1190,10449,4
dated,1128,4103,1048,3252,917,10448,4
beane,1555,2863,1959,1391,2679,10447,4
books,1555,3069,1426,628,3767,10445,4
oorie,532,3069,2201,1963,2679,10444,4
paean,1184,4103,1421,2214,1522,10444,4
varan,404,4103,2201,2214,1522,10444,4
silks,2206,2239,1603,628,3767,10443,4
suers,2206,1824,1421,1225,3767,10443,4
batan,1555,4103,1048,2214,1522,10442,4
damia,1128,4103,885,1963,2362,10441,4
matte,1225,4103,1048,1385,2679,10440,4
torre,1264,3069,2201,1225,2679,10438,4
nasus,647,4103,1021,899,3767,10437,4
secus,2206,2863,701,899,3767,10436,4
tarah,1264,4103,2201,2214,654,10436,4
karry,789,4103,2201,1225,2116,10434,4
weren,596,2863,2201,3252,1522,10434,4
booms,1555,3069,1426,612,3767,10429,4
madia,1225,4103,774,1963,2362,10427,4
basta,1555,4103,1021,1385,2362,10426,4
coroa,1512,3069,2201,1282,2362,10426,4
posts,1184,3069,1021,1385,3767,10426,4
faade,847,4103,1959,829,2679,10417,4
basan,1555,4103,1021,2214,1522,10415,4
sesia,2206,2863,1021,1963,2362,10415,4
lanny,1046,4103,1757,1391,2116,10413,4
tints,1264,2239,1757,1385,3767,10412,4
sfree,2206,73,2201,3252,2679,10411,4
namen,647,4103,885,3252,1522,10409,4
galan,965,4103,1603,2214,1522,10407,4
banka,1555,4103,1757,628,2362,10405,4
deers,1128,2863,1421,1225,3767,10404,4
fools,847,3069,1426,1295,3767,10404,4
cooks,1512,3069,1426,628,3767,10402,4
garad,965,4103,2201,2214,917,10400,4
catan,1512,4103,1048,2214,1522,10399,4
patte,1184,4103,1048,1385,2679,10399,4
barby,1555,4103,2201,423,2116,10398,4
terne,1264,2863,2201,1391,2679,10398,4
marah,1225,4103,2201,2214,654,10397,4
rasia,948,4103,1021,1963,2362,10397,4
bauta,1555,4103,990,1385,2362,10395,4
moxee,1225,3069,170,3252,2679,10395,4
sawan,2206,4103,349,2214,1522,10394,4
sinhs,2206,2239,1757,423,3767,10392,4
motos,1225,3069,1048,1282,3767,10391,4
sexts,2206,2863,170,1385,3767,10391,4
denie,1128,2863,1757,1963,2679,10390,4
banga,1555,4103,1757,612,2362,10389,4
balai,1555,4103,1603,2214,910,10385,4
syces,2206,458,701,3252,3767,10384,4
casta,1512,4103,1021,1385,2362,10383,4
gasps,965,4103,1021,526,3767,10382,4
tally,1264,4103,1603,1295,2116,10381,4
samal,2206,4103,885,2214,971,10379,4
ramer,948,4103,885,3252,1190,10378,4
kaete,789,4103,1421,1385,2679,10377,4
fifes,847,2239,271,3252,3767,10376,4
raila,948,4103,1668,1295,2362,10376,4
sugis,2206,1824,616,1963,3767,10376,4
fells,847,2863,1603,1295,3767,10375,4
talar,1264,4103,1603,2214,1190,10374,4
barac,1555,4103,2201,2214,300,10373,4
hells,844,2863,1603,1295,3767,10372,4
eyres,693,458,2201,3252,3767,10371,4
faina,847,4103,1668,1391,2362,10371,4
socks,2206,3069,701,628,3767,10371,4
paola,1184,4103,1426,1295,2362,10370,4
nolos,647,3069,1603,1282,3767,10368,4
rasps,948,4103,1021,526,3767,10365,4
sarsi,2206,4103,2201,945,910,10365,4
lamia,1046,4103,885,1963,2362,10359,4
cavia,1512,4103,417,1963,2362,10357,4
tegea,1264,2863,616,3252,2362,10357,4
parah,1184,4103,2201,2214,654,10356,4
rokee,948,3069,406,3252,2679,10354,4
beale,1555,2863,1959,1295,2679,10351,4
potos,1184,3069,1048,1282,3767,10350,4
maera,1225,4103,1421,1225,2362,10336,4
malar,1225,4103,1603,2214,1190,10335,4
melie,1225,2863,1603,1963,2679,10333,4
balao,1555,4103,1603,2214,857,10332,4
dalat,1128,4103,1603,2214,1284,10332,4
ganny,965,4103,1757,1391,2116,10332,4
ghees,965,927,1421,3252,3767,10332,4
mimas,1225,2239,885,2214,3767,10330,4
sella,2206,2863,1603,1295,2362,10329,4
laona,1046,4103,1426,1391,2362,10328,4
maggs,1225,4103,616,612,3767,10323,4
three,1264,927,2201,3252,2679,10323,4
bahay,1555,4103,334,2214,2116,10322,4
leers,1046,2863,1421,1225,3767,10322,4
darpa,1128,4103,2201,526,2362,10320,4
hatia,844,4103,1048,1963,2362,10320,4
pacay,1184,4103,701,2214,2116,10318,4
bahia,1555,4103,334,1963,2362,10317,4
moods,1225,3069,1426,829,3767,10316,4
carap,1512,4103,2201,2214,285,10315,4
ranny,948,4103,1757,1391,2116,10315,4
darii,1128,4103,2201,1963,910,10305,4
aahed,1698,4103,334,3252,917,10304,4
terle,1264,2863,2201,1295,2679,10302,4
pally,1184,4103,1603,1295,2116,10301,4
coops,1512,3069,1426,526,3767,10300,4
bable,1555,4103,664,1295,2679,10296,4
bunns,1555,1824,1757,1391,3767,10294,4
palar,1184,4103,1603,2214,1190,10294,4
reels,948,2863,1421,1295,3767,10294,4
leiss,1046,2863,1668,945,3767,10289,4
paper,1184,4103,560,3252,1190,10289,4
solly,2206,3069,1603,1295,2116,10289,4
metts,1225,2863,1048,1385,3767,10288,4
eater,693,4103,1048,3252,1190,10286,4
seder,2206,2863,774,3252,1190,10285,4
gamay,965,4103,885,2214,2116,10283,4
farad,847,4103,2201,2214,917,10282,4
beare,1555,2863,1959,1225,2679,10281,4
torta,1264,3069,2201,1385,2362,10281,4
snyes,2206,671,381,3252,3767,10277,4
manda,1225,4103,1757,829,2362,10276,4
surfs,2206,1824,2201,278,3767,10276,4
akees,1698,137,1421,3252,3767,10275,4
poods,1184,3069,1426,829,3767,10275,4
sence,2206,2863,1757,770,2679,10275,4
artas,1698,1543,1048,2214,3767,10270,4
baeda,1555,4103,1421,829,2362,10270,4
manal,1225,4103,1757,2214,971,10270,4
basra,1555,4103,1021,1225,2362,10266,4
eilis,693,2239,1603,1963,3767,10265,4
iasus,473,4103,1021,899,3767,10263,4
merle,1225,2863,2201,1295,2679,10263,4
paisa,1184,4103,1668,945,2362,10262,4
hasps,844,4103,1021,526,3767,10261,4
casse,1512,4103,1021,945,2679,10260,4
seven,2206,2863,417,3252,1522,10260,4
easer,693,4103,1021,3252,1190,10259,4
tilts,1264,2239,1603,1385,3767,10258,4
dacia,1128,4103,701,1963,2362,10257,4
lamel,1046,4103,885,3252,971,10257,4
derte,1128,2863,2201,1385,2679,10256,4
tapia,1264,4103,560,1963,2362,10252,4
meroe,1225,2863,2201,1282,2679,10250,4
woons,596,3069,1426,1391,3767,10249,4
loess,1046,3069,1421,945,3767,10248,4
sylas,2206,458,1603,2214,3767,10248,4
dally,1128,4103,1603,1295,2116,10245,4
kokas,789,3069,406,2214,3767,10245,4
seena,2206,2863,1421,1391,2362,10243,4
mitis,1225,2239,1048,1963,3767,10242,4
murrs,1225,1824,2201,1225,3767,10242,4
dalar,1128,4103,1603,2214,1190,10238,4
caman,1512,4103,885,2214,1522,10236,4
gaeta,965,4103,1421,1385,2362,10236,4
panda,1184,4103,1757,829,2362,10235,4
sirra,2206,2239,2201,1225,2362,10233,4
kalan,789,4103,1603,2214,1522,10231,4
keens,789,2863,1421,1391,3767,10231,4
genie,965,2863,1757,1963,2679,10227,4
keets,789,2863,1421,1385,3767,10225,4
allis,1698,1193,1603,1963,3767,10224,4
perle,1184,2863,2201,1295,2679,10222,4
senex,2206,2863,1757,3252,144,10222,4
jodee,446,3069,774,3252,2679,10220,4
pests,1184,2863,1021,1385,3767,10220,4
banon,1555,4103,1757,1282,1522,10219,4
booed,1555,3069,1426,3252,917,10219,4
signs,2206,2239,616,1391,3767,10219,4
slits,2206,1193,1668,1385,3767,10219,4
kaila,789,4103,1668,1295,2362,10217,4
fanny,847,4103,1757,1391,2116,10214,4
lansa,1046,4103,1757,945,2362,10213,4
eadie,693,4103,774,1963,2679,10212,4
lotos,1046,3069,1048,1282,3767,10212,4
hanny,844,4103,1757,1391,2116,10211,4
renie,948,2863,1757,1963,2679,10210,4
geiss,965,2863,1668,945,3767,10208,4
serve,2206,2863,2201,259,2679,10208,4
soony,2206,3069,1426,1391,2116,10208,4
tarfa,1264,4103,2201,278,2362,10208,4
batty,1555,4103,1048,1385,2116,10207,4
berra,1555,2863,2201,1225,2362,10206,4
sooty,2206,3069,1426,1385,2116,10202,4
purrs,1184,1824,2201,1225,3767,10201,4
linns,1046,2239,1757,1391,3767,10200,4
meier,1225,2863,1668,3252,1190,10198,4
coala,1512,3069,1959,1295,2362,10197,4
haloa,844,4103,1603,1282,2362,10194,4
racer,948,4103,701,3252,1190,10194,4
feels,847,2863,1421,1295,3767,10193,4
sewen,2206,2863,349,3252,1522,10192,4
reiss,948,2863,1668,945,3767,10191,4
heels,844,2863,1421,1295,3767,10190,4
maida,1225,4103,1668,829,2362,10187,4
pomos,1184,3069,885,1282,3767,10187,4
looie,1046,3069,1426,1963,2679,10183,4
ailie,1698,2239,1603,1963,2679,10182,4
lerne,1046,2863,2201,1391,2679,10180,4
basat,1555,4103,1021,2214,1284,10177,4
semel,2206,2863,885,3252,971,10177,4
canon,1512,4103,1757,1282,1522,10176,4
cooed,1512,3069,1426,3252,917,10176,4
eemis,693,2863,885,1963,3767,10171,4
gongs,965,3069,1757,612,3767,10170,4
marfa,1225,4103,2201,278,2362,10169,4
badan,1555,4103,774,2214,1522,10168,4
tills,1264,2239,1603,1295,3767,10168,4
louls,1046,3069,990,1295,3767,10167,4
salol,2206,4103,1603,1282,971,10165,4
catty,1512,4103,1048,1385,2116,10164,4
marya,1225,4103,2201,271,2362,10162,4
tyees,1264,458,1421,3252,3767,10162,4
warua,596,4103,2201,899,2362,10161,4
tonne,1264,3069,1757,1391,2679,10160,4
situs,2206,2239,1048,899,3767,10159,4
sabal,2206,4103,664,2214,971,10158,4
camla,1512,4103,885,1295,2362,10157,4
siana,2206,2239,1959,1391,2362,10157,4
wools,596,3069,1426,1295,3767,10153,4
caraz,1512,4103,2201,2214,122,10152,4
palua,1184,4103,1603,899,2362,10151,4
marva,1225,4103,2201,259,2362,10150,4
balpa,1555,4103,1603,526,2362,10149,4
iives,473,2239,417,3252,3767,10148,4
kanat,789,4103,1757,2214,1284,10147,4
tirer,1264,2239,2201,3252,1190,10146,4
cibis,1512,2239,664,1963,3767,10145,4
durrs,1128,1824,2201,1225,3767,10145,4
narda,647,4103,2201,829,2362,10142,4
harka,844,4103,2201,628,2362,10138,4
labia,1046,4103,664,1963,2362,10138,4
zarla,176,4103,2201,1295,2362,10137,4
keels,789,2863,1421,1295,3767,10135,4
miass,1225,2239,1959,945,3767,10135,4
tarot,1264,4103,2201,1282,1284,10134,4
sensa,2206,2863,1757,945,2362,10133,4
beeps,1555,2863,1421,526,3767,10132,4
gansa,965,4103,1757,945,2362,10132,4
banak,1555,4103,1757,2214,502,10131,4
gotos,965,3069,1048,1282,3767,10131,4
mills,1225,2239,1603,1295,3767,10129,4
gager,965,4103,616,3252,1190,10126,4
lyles,1046,458,1603,3252,3767,10126,4
volos,404,3069,1603,1282,3767,10125,4
beata,1555,2863,1959,1385,2362,10124,4
faena,847,4103,1421,1391,2362,10124,4
wells,596,2863,1603,1295,3767,10124,4
corry,1512,3069,2201,1225,2116,10123,4
malda,1225,4103,1603,829,2362,10122,4
genet,965,2863,1757,3252,1284,10121,4
boone,1555,3069,1426,1391,2679,10120,4
pesos,1184,2863,1021,1282,3767,10117,4
salli,2206,4103,1603,1295,910,10117,4
gange,965,4103,1757,612,2679,10116,4
nonie,647,3069,1757,1963,2679,10115,4
boote,1555,3069,1426,1385,2679,10114,4
rotos,948,3069,1048,1282,3767,10114,4
tanka,1264,4103,1757,628,2362,10114,4
danai,1128,4103,1757,2214,910,10112,4
wawls,596,4103,349,1295,3767,10110,4
letts,1046,2863,1048,1385,3767,10109,4
rager,948,4103,616,3252,1190,10109,4
tavia,1264,4103,417,1963,2362,10109,4
param,1184,4103,2201,2214,406,10108,4
kamay,789,4103,885,2214,2116,10107,4
henie,844,2863,1757,1963,2679,10106,4
meeds,1225,2863,1421,829,3767,10105,4
renet,948,2863,1757,3252,1284,10104,4
talca,1264,4103,1603,770,2362,10102,4
tanga,1264,4103,1757,612,2362,10098,4
landa,1046,4103,1757,829,2362,10097,4
nasia,647,4103,1021,1963,2362,10096,4
neons,647,2863,1426,1391,3767,10094,4
sonsy,2206,3069,1757,945,2116,10093,4
laded,1046,4103,774,3252,917,10092,4
jarry,446,4103,2201,1225,2116,10091,4
warda,596,4103,2201,829,2362,10091,4
sykes,2206,458,406,3252,3767,10089,4
patna,1184,4103,1048,1391,2362,10088,4
pills,1184,2239,1603,1295,3767,10088,4
camra,1512,4103,885,1225,2362,10087,4
lulea,1046,1824,1603,3252,2362,10087,4
calah,1512,4103,1603,2214,654,10086,4
hosts,844,3069,1021,1385,3767,10086,4
dabbs,1128,4103,664,423,3767,10085,4
masan,1225,4103,1021,2214,1522,10085,4
arrie,1698,1543,2201,1963,2679,10084,4
helen,844,2863,1603,3252,1522,10084,4
sauba,2206,4103,990,423,2362,10084,4
valle,404,4103,1603,1295,2679,10084,4
selly,2206,2863,1603,1295,2116,10083,4
gally,965,4103,1603,1295,2116,10082,4
morra,1225,3069,2201,1225,2362,10082,4
terek,1264,2863,2201,3252,502,10082,4
bokos,1555,3069,406,1282,3767,10079,4
vives,404,2239,417,3252,3767,10079,4
kerel,789,2863,2201,3252,971,10076,4
podos,1184,3069,774,1282,3767,10076,4
apses,1698,336,1021,3252,3767,10074,4
conan,1512,3069,1757,2214,1522,10074,4
karma,789,4103,2201,612,2362,10067,4
darya,1128,4103,2201,271,2362,10065,4
rally,948,4103,1603,1295,2116,10065,4
malca,1225,4103,1603,770,2362,10063,4
sezen,2206,2863,217,3252,1522,10060,4
hatte,844,4103,1048,1385,2679,10059,4
manga,1225,4103,1757,612,2362,10059,4
goods,965,3069,1426,829,3767,10056,4
pasta,1184,4103,1021,1385,2362,10055,4
boyos,1555,3069,381,1282,3767,10054,4
motss,1225,3069,1048,945,3767,10054,4
raper,948,4103,560,3252,1190,10053,4
coofs,1512,3069,1426,278,3767,10052,4
sagai,2206,4103,616,2214,910,10049,4
sosna,2206,3069,1021,1391,2362,10049,4
auria,1698,1824,2201,1963,2362,10048,4
banya,1555,4103,1757,271,2362,10048,4
yawey,225,4103,349,3252,2116,10045,4
bulls,1555,1824,1603,1295,3767,10044,4
pasan,1184,4103,1021,2214,1522,10044,4
talao,1264,4103,1603,2214,857,10041,4
bosks,1555,3069,1021,628,3767,10040,4
casar,1512,4103,1021,2214,1190,10040,4
easel,693,4103,1021,3252,971,10040,4
lilts,1046,2239,1603,1385,3767,10040,4
rabia,948,4103,664,1963,2362,10040,4
roods,948,3069,1426,829,3767,10039,4
weens,596,2863,1421,1391,3767,10038,4
harpa,844,4103,2201,526,2362,10036,4
label,1046,4103,664,3252,971,10036,4
beala,1555,2863,1959,1295,2362,10034,4
dills,1128,2239,1603,1295,3767,10032,4
weets,596,2863,1421,1385,3767,10032,4
sufis,2206,1824,271,1963,3767,10031,4
lanai,1046,4103,1757,2214,910,10030,4
metae,1225,2863,1048,2214,2679,10029,4
pavia,1184,4103,417,1963,2362,10029,4
tarau,1264,4103,2201,2214,247,10029,4
seige,2206,2863,1668,612,2679,10028,4
sulks,2206,1824,1603,628,3767,10028,4
gaige,965,4103,1668,612,2679,10027,4
sophs,2206,3069,560,423,3767,10025,4
boole,1555,3069,1426,1295,2679,10024,4
bubas,1555,1824,664,2214,3767,10024,4
donne,1128,3069,1757,1391,2679,10024,4
berar,1555,2863,2201,2214,1190,10023,4
memos,1225,2863,885,1282,3767,10022,4
deane,1128,2863,1959,1391,2679,10020,4
farah,847,4103,2201,2214,654,10019,4
aulae,1698,1824,1603,2214,2679,10018,4
panga,1184,4103,1757,612,2362,10018,4
ceile,1512,2863,1668,1295,2679,10017,4
ganda,965,4103,1757,829,2362,10016,4
stoas,2206,403,1426,2214,3767,10016,4
caban,1512,4103,664,2214,1522,10015,4
taula,1264,4103,990,1295,2362,10014,4
wasps,596,4103,1021,526,3767,10013,4
tasse,1264,4103,1021,945,2679,10012,4
coyos,1512,3069,381,1282,3767,10011,4
hansa,844,4103,1757,945,2362,10011,4
direr,1128,2239,2201,3252,1190,10010,4
konks,789,3069,1757,628,3767,10010,4
nemea,647,2863,885,3252,2362,10009,4
nonet,647,3069,1757,3252,1284,10009,4
styes,2206,403,381,3252,3767,10009,4
taiga,1264,4103,1668,612,2362,10009,4
taima,1264,4103,1668,612,2362,10009,4
alans,1698,1193,1959,1391,3767,10008,4
sooke,2206,3069,1426,628,2679,10008,4
saadi,2206,4103,1959,829,910,10007,4
orris,532,1543,2201,1963,3767,10006,4
naira,647,4103,1668,1225,2362,10005,4
dooms,1128,3069,1426,612,3767,10002,4
lapps,1046,4103,560,526,3767,10002,4
culls,1512,1824,1603,1295,3767,10001,4
finns,847,2239,1757,1391,3767,10001,4
gests,965,2863,1021,1385,3767,10001,4
maror,1225,4103,2201,1282,1190,10001,4
randa,948,4103,1757,829,2362,9999,4
sylis,2206,458,1603,1963,3767,9997,4
barri,1555,4103,2201,1225,910,9994,4
bitts,1555,2239,1048,1385,3767,9994,4
kalat,789,4103,1603,2214,1284,9993,4
ranal,948,4103,1757,2214,971,9993,4
arsis,1698,1543,1021,1963,3767,9992,4
tanah,1264,4103,1757,2214,654,9992,4
eased,693,4103,1021,3252,917,9986,4
rests,948,2863,1021,1385,3767,9984,4
safar,2206,4103,271,2214,1190,9984,4
ferne,847,2863,2201,1391,2679,9981,4
peale,1184,2863,1959,1295,2679,9980,4
curer,1512,1824,2201,3252,1190,9979,4
samba,2206,4103,885,423,2362,9979,4
arret,1698,1543,2201,3252,1284,9978,4
herne,844,2863,2201,1391,2679,9978,4
balak,1555,4103,1603,2214,502,9977,4
lanao,1046,4103,1757,2214,857,9977,4
slots,2206,1193,1426,1385,3767,9977,4
coele,1512,3069,1421,1295,2679,9976,4
facia,847,4103,701,1963,2362,9976,4
beset,1555,2863,1021,3252,1284,9975,4
baffs,1555,4103,271,278,3767,9974,4
jells,446,2863,1603,1295,3767,9974,4
masse,1225,4103,1021,945,2679,9973,4
larva,1046,4103,2201,259,2362,9971,4
jaina,446,4103,1668,1391,2362,9970,4
kaela,789,4103,1421,1295,2362,9970,4
maiga,1225,4103,1668,612,2362,9970,4
agree,1698,139,2201,3252,2679,9969,4
doled,1128,3069,1603,3252,917,9969,4
midis,1225,2239,774,1963,3767,9968,4
beden,1555,2863,774,3252,1522,9966,4
seave,2206,2863,1959,259,2679,9966,4
cohos,1512,3069,334,1282,3767,9964,4
fally,847,4103,1603,1295,2116,9964,4
sumos,2206,1824,885,1282,3767,9964,4
matra,1225,4103,1048,1225,2362,9963,4
tafia,1264,4103,271,1963,2362,9963,4
wanny,596,4103,1757,1391,2116,9963,4
whees,596,927,1421,3252,3767,9963,4
hally,844,4103,1603,1295,2116,9961,4
berry,1555,2863,2201,1225,2116,9960,4
mogos,1225,3069,616,1282,3767,9959,4
shins,2206,927,1668,1391,3767,9959,4
cease,1512,2863,1959,945,2679,9958,4
dalai,1128,4103,1603,2214,910,9958,4
kansa,789,4103,1757,945,2362,9956,4
nance,647,4103,1757,770,2679,9956,4
kotos,789,3069,1048,1282,3767,9955,4
turus,1264,1824,2201,899,3767,9955,4
anlas,1698,671,1603,2214,3767,9953,4
shits,2206,927,1668,1385,3767,9953,4
marja,1225,4103,2201,61,2362,9952,4
terse,1264,2863,2201,945,2679,9952,4
carri,1512,4103,2201,1225,910,9951,4
relet,948,2863,1603,3252,1284,9950,4
cocus,1512,3069,701,899,3767,9948,4
darac,1128,4103,2201,2214,300,9946,4
derek,1128,2863,2201,3252,502,9946,4
talma,1264,4103,1603,612,2362,9944,4
lonne,1046,3069,1757,1391,2679,9942,4
topos,1264,3069,560,1282,3767,9942,4
narka,647,4103,2201,628,2362,9941,4
yarly,225,4103,2201,1295,2116,9940,4
foods,847,3069,1426,829,3767,9938,4
geier,965,2863,1668,3252,1190,9938,4
sinan,2206,2239,1757,2214,1522,9938,4
looks,1046,3069,1426,628,3767,9936,4
hoods,844,3069,1426,829,3767,9935,4
paula,1184,4103,990,1295,2362,9934,4
dandy,1128,4103,1757,829,2116,9933,4
lapel,1046,4103,560,3252,971,9932,4
passe,1184,4103,1021,945,2679,9932,4
sever,2206,2863,417,3252,1190,9928,4
taraf,1264,4103,2201,2214,145,9927,4
teems,1264,2863,1421,612,3767,9927,4
berke,1555,2863,2201,628,2679,9926,4
leeds,1046,2863,1421,829,3767,9926,4
cists,1512,2239,1021,1385,3767,9924,4
deale,1128,2863,1959,1295,2679,9924,4
mafia,1225,4103,271,1963,2362,9924,4
arcas,1698,1543,701,2214,3767,9923,4
kerne,789,2863,2201,1391,2679,9923,4
gabbs,965,4103,664,423,3767,9922,4
sammy,2206,4103,885,612,2116,9922,4
ceara,1512,2863,1959,1225,2362,9921,4
malka,1225,4103,1603,628,2362,9921,4
sansi,2206,4103,1757,945,910,9921,4
innes,473,671,1757,3252,3767,9920,4
looms,1046,3069,1426,612,3767,9920,4
erbes,693,1543,664,3252,3767,9919,4
seker,2206,2863,406,3252,1190,9917,4
venae,404,2863,1757,2214,2679,9917,4
notts,647,3069,1048,1385,3767,9916,4
terra,1264,2863,2201,1225,2362,9915,4
merse,1225,2863,2201,945,2679,9913,4
causa,1512,4103,990,945,2362,9912,4
saval,2206,4103,417,2214,971,9911,4
berme,1555,2863,2201,612,2679,9910,4
dobos,1128,3069,664,1282,3767,9910,4
raver,948,4103,417,3252,1190,9910,4
tanha,1264,4103,1757,423,2362,9909,4
tazia,1264,4103,217,1963,2362,9909,4
kally,789,4103,1603,1295,2116,9906,4
maura,1225,4103,990,1225,2362,9905,4
meeks,1225,2863,1421,628,3767,9904,4
seely,2206,2863,1421,1295,2116,9901,4
knees,789,671,1421,3252,3767,9900,4
morar,1225,3069,2201,2214,1190,9899,4
raker,948,4103,406,3252,1190,9899,4
varda,404,4103,2201,829,2362,9899,4
ladle,1046,4103,774,1295,2679,9897,4
lanka,1046,4103,1757,628,2362,9896,4
faded,847,4103,774,3252,917,9893,4
fanal,847,4103,1757,2214,971,9892,4
telei,1264,2863,1603,3252,910,9892,4
bozos,1555,3069,217,1282,3767,9890,4
haded,844,4103,774,3252,917,9890,4
manon,1225,4103,1757,1282,1522,9889,4
mooed,1225,3069,1426,3252,917,9889,4
souse,2206,3069,990,945,2679,9889,4
tasty,1264,4103,1021,1385,2116,9889,4
bonny,1555,3069,1757,1391,2116,9888,4
hagia,844,4103,616,1963,2362,9888,4
beefs,1555,2863,1421,278,3767,9884,4
roneo,948,3069,1757,3252,857,9883,4
jarad,446,4103,2201,2214,917,9881,4
hests,844,2863,1021,1385,3767,9880,4
motet,1225,3069,1048,3252,1284,9878,4
matty,1225,4103,1048,1385,2116,9877,4
maiid,1225,4103,1668,1963,917,9876,4
lauan,1046,4103,990,2214,1522,9875,4
purus,1184,1824,2201,899,3767,9875,4
sayal,2206,4103,381,2214,971,9875,4
torry,1264,3069,2201,1225,2116,9875,4
airan,1698,2239,2201,2214,1522,9874,4
baiza,1555,4103,1668,186,2362,9874,4
warga,596,4103,2201,612,2362,9874,4
perse,1184,2863,2201,945,2679,9872,4
canap,1512,4103,1757,2214,285,9871,4
molle,1225,3069,1603,1295,2679,9871,4
manba,1225,4103,1757,423,2362,9870,4
gills,965,2239,1603,1295,3767,9869,4
poohs,1184,3069,1426,423,3767,9869,4
sifts,2206,2239,271,1385,3767,9868,4
locos,1046,3069,701,1282,3767,9865,4
basal,1555,4103,1021,2214,971,9864,4
maiah,1225,4103,1668,2214,654,9864,4
nouns,647,3069,990,1391,3767,9864,4
palma,1184,4103,1603,612,2362,9864,4
minie,1225,2239,1757,1963,2679,9863,4
peeks,1184,2863,1421,628,3767,9863,4
alley,1698,1193,1603,3252,2116,9862,4
gonne,965,3069,1757,1391,2679,9861,4
sewer,2206,2863,349,3252,1190,9860,4
talpa,1264,4103,1603,526,2362,9858,4
annis,1698,671,1757,1963,3767,9856,4
gooks,965,3069,1426,628,3767,9855,4
layia,1046,4103,381,1963,2362,9855,4
deare,1128,2863,1959,1225,2679,9854,4
eager,693,4103,616,3252,1190,9854,4
tyree,1264,458,2201,3252,2679,9854,4
gaged,965,4103,616,3252,917,9853,4
daman,1128,4103,885,2214,1522,9852,4
rills,948,2239,1603,1295,3767,9852,4
nadia,647,4103,774,1963,2362,9849,4
homos,844,3069,885,1282,3767,9847,4
conny,1512,3069,1757,1391,2116,9845,4
momus,1225,3069,885,899,3767,9845,4
ronne,948,3069,1757,1391,2679,9844,4
tonna,1264,3069,1757,1391,2362,9843,4
rawer,948,4103,349,3252,1190,9842,4
colla,1512,3069,1603,1295,2362,9841,4
yogee,225,3069,616,3252,2679,9841,4
sabah,2206,4103,664,2214,654,9841,4
tanak,1264,4103,1757,2214,502,9840,4
calva,1512,4103,1603,259,2362,9839,4
sakai,2206,4103,406,2214,910,9839,4
tamra,1264,4103,885,1225,2362,9839,4
weiss,596,2863,1668,945,3767,9839,4
argas,1698,1543,616,2214,3767,9838,4
rooks,948,3069,1426,628,3767,9838,4
batad,1555,4103,1048,2214,917,9837,4
lelia,1046,2863,1603,1963,2362,9837,4
morry,1225,3069,2201,1225,2116,9836,4
patty,1184,4103,1048,1385,2116,9836,4
ratan,948,4103,1048,2214,1522,9835,4
kanal,789,4103,1757,2214,971,9834,4
loops,1046,3069,1426,526,3767,9834,4
pazia,1184,4103,217,1963,2362,9829,4
toone,1264,3069,1426,1391,2679,9829,4
zoons,176,3069,1426,1391,3767,9829,4
lobos,1046,3069,664,1282,3767,9828,4
reeds,948,2863,1421,829,3767,9828,4
tereu,1264,2863,2201,3252,247,9827,4
caoba,1512,4103,1426,423,2362,9826,4
gasan,965,4103,1021,2214,1522,9825,4
bobet,1555,3069,664,3252,1284,9824,4
conin,1512,3069,1757,1963,1522,9823,4
maxia,1225,4103,170,1963,2362,9823,4
toter,1264,3069,1048,3252,1190,9823,4
gorra,965,3069,2201,1225,2362,9822,4
rooms,948,3069,1426,612,3767,9822,4
casal,1512,4103,1021,2214,971,9821,4
tacna,1264,4103,701,1391,2362,9821,4
narah,647,4103,2201,2214,654,9819,4
surra,2206,1824,2201,1225,2362,9818,4
linen,1046,2239,1757,3252,1522,9816,4
siums,2206,2239,990,612,3767,9814,4
basad,1555,4103,1021,2214,917,9810,4
gavia,965,4103,417,1963,2362,9810,4
balza,1555,4103,1603,186,2362,9809,4
haida,844,4103,1668,829,2362,9806,4
julee,446,1824,1603,3252,2679,9804,4
tacan,1264,4103,701,2214,1522,9804,4
faial,847,4103,1668,2214,971,9803,4
bunus,1555,1824,1757,899,3767,9802,4
gigas,965,2239,616,2214,3767,9801,4
manak,1225,4103,1757,2214,502,9801,4
merde,1225,2863,2201,829,2679,9797,4
cauda,1512,4103,990,829,2362,9796,4
airla,1698,2239,2201,1295,2362,9795,4
porry,1184,3069,2201,1225,2116,9795,4
sacha,2206,4103,701,423,2362,9795,4
lasse,1046,4103,1021,945,2679,9794,4
canun,1512,4103,1757,899,1522,9793,4
ravia,948,4103,417,1963,2362,9793,4
tipis,1264,2239,560,1963,3767,9793,4
daraf,1128,4103,2201,2214,145,9791,4
deems,1128,2863,1421,612,3767,9791,4
lamna,1046,4103,885,1391,2362,9787,4
bsaee,1555,341,1959,3252,2679,9786,4
peine,1184,2863,1668,1391,2679,9785,4
douds,1128,3069,990,829,3767,9783,4
gerek,965,2863,2201,3252,502,9783,4
rakia,948,4103,406,1963,2362,9782,4
logos,1046,3069,616,1282,3767,9780,4
matar,1225,4103,1048,2214,1190,9780,4
terce,1264,2863,2201,770,2679,9777,4
anoas,1698,671,1426,2214,3767,9776,4
balac,1555,4103,1603,2214,300,9775,4
nerte,647,2863,2201,1385,2679,9775,4
aemia,1698,2863,885,1963,2362,9771,4
vanny,404,4103,1757,1391,2116,9771,4
burbs,1555,1824,2201,423,3767,9770,4
brass,1555,1543,1959,945,3767,9769,4
getae,965,2863,1048,2214,2679,9769,4
cavan,1512,4103,417,2214,1522,9768,4
haram,844,4103,2201,2214,406,9768,4
macan,1225,4103,701,2214,1522,9765,4
nally,647,4103,1603,1295,2116,9764,4
rafer,948,4103,271,3252,1190,9764,4
toyos,1264,3069,381,1282,3767,9763,4
capra,1512,4103,560,1225,2362,9762,4
sayao,2206,4103,381,2214,857,9761,4
panak,1184,4103,1757,2214,502,9760,4
adrea,1698,245,2201,3252,2362,9758,4
almas,1698,1193,885,2214,3767,9757,4
tanya,1264,4103,1757,271,2362,9757,4
cense,1512,2863,1757,945,2679,9756,4
tofts,1264,3069,271,1385,3767,9756,4
nelie,647,2863,1603,1963,2679,9755,4
gagne,965,4103,616,1391,2679,9754,4
mudee,1225,1824,774,3252,2679,9754,4
benue,1555,2863,1757,899,2679,9753,4
goops,965,3069,1426,526,3767,9753,4
yells,225,2863,1603,1295,3767,9753,4
maraj,1225,4103,2201,2214,10,9753,4
bepen,1555,2863,560,3252,1522,9752,4
fills,847,2239,1603,1295,3767,9751,4
sibie,2206,2239,664,1963,2679,9751,4
dawed,1128,4103,349,3252,917,9749,4
beore,1555,2863,1426,1225,2679,9748,4
hills,844,2239,1603,1295,3767,9748,4
reran,948,2863,2201,2214,1522,9748,4
gobos,965,3069,664,1282,3767,9747,4
falda,847,4103,1603,829,2362,9744,4
halda,844,4103,1603,829,2362,9741,4
bassy,1555,4103,1021,945,2116,9740,4
dorry,1128,3069,2201,1225,2116,9739,4
hevea,844,2863,417,3252,2362,9738,4
merce,1225,2863,2201,770,2679,9738,4
petie,1184,2863,1048,1963,2679,9737,4
slags,2206,1193,1959,612,3767,9737,4
slams,2206,1193,1959,612,3767,9737,4
botte,1555,3069,1048,1385,2679,9736,4
conoy,1512,3069,1757,1282,2116,9736,4
pacta,1184,4103,701,1385,2362,9735,4
hooks,844,3069,1426,628,3767,9734,4
toole,1264,3069,1426,1295,2679,9733,4
garau,965,4103,2201,2214,247,9730,4
meile,1225,2863,1668,1295,2679,9730,4
derep,1128,2863,2201,3252,285,9729,4
firer,847,2239,2201,3252,1190,9729,4
rasla,948,4103,1021,1295,2362,9729,4
roana,948,3069,1959,1391,2362,9729,4
roleo,948,3069,1603,3252,857,9729,4
bahan,1555,4103,334,2214,1522,9728,4
feeds,847,2863,1421,829,3767,9727,4
crass,1512,1543,1959,945,3767,9726,4
hirer,844,2239,2201,3252,1190,9726,4
laura,1046,4103,990,1225,2362,9726,4
stans,2206,403,1959,1391,3767,9726,4
leeks,1046,2863,1421,628,3767,9725,4
heeds,844,2863,1421,829,3767,9724,4
poofs,1184,3069,1426,278,3767,9724,4
balau,1555,4103,1603,2214,247,9722,4
jeers,446,2863,1421,1225,3767,9722,4
rorty,948,3069,2201,1385,2116,9719,4
fasta,847,4103,1021,1385,2362,9718,4
manya,1225,4103,1757,271,2362,9718,4
saidi,2206,4103,1668,829,910,9716,4
hasta,844,4103,1021,1385,2362,9715,4
mulls,1225,1824,1603,1295,3767,9714,4
wally,596,4103,1603,1295,2116,9713,4
shots,2206,927,1426,1385,3767,9711,4
looed,1046,3069,1426,3252,917,9710,4
mosks,1225,3069,1021,628,3767,9710,4
netts,647,2863,1048,1385,3767,9710,4
razer,948,4103,217,3252,1190,9710,4
taint,1264,4103,1668,1391,1284,9710,4
tease,1264,2863,1959,945,2679,9710,4
dewey,1128,2863,349,3252,2116,9708,4
donna,1128,3069,1757,1391,2362,9707,4
deeps,1128,2863,1421,526,3767,9705,4
forra,847,3069,2201,1225,2362,9704,4
hasan,844,4103,1021,2214,1522,9704,4
deana,1128,2863,1959,1391,2362,9703,4
koroa,789,3069,2201,1282,2362,9703,4
tarri,1264,4103,2201,1225,910,9703,4
bombs,1555,3069,885,423,3767,9699,4
latty,1046,4103,1048,1385,2116,9698,4
solio,2206,3069,1603,1963,857,9698,4
cassy,1512,4103,1021,945,2116,9697,4
magna,1225,4103,616,1391,2362,9697,4
perce,1184,2863,2201,770,2679,9697,4
snits,2206,671,1668,1385,3767,9697,4
aoede,1698,3069,1421,829,2679,9696,4
rasse,948,4103,1021,945,2679,9696,4
levey,1046,2863,417,3252,2116,9694,4
oasys,532,4103,1021,271,3767,9694,4
cotte,1512,3069,1048,1385,2679,9693,4
doone,1128,3069,1426,1391,2679,9693,4
fauna,847,4103,990,1391,2362,9693,4
kills,789,2239,1603,1295,3767,9693,4
susie,2206,1824,1021,1963,2679,9693,4
ninos,647,2239,1757,1282,3767,9692,4
verel,404,2863,2201,3252,971,9691,4
betel,1555,2863,1048,3252,971,9689,4
bsdes,1555,341,774,3252,3767,9689,4
madra,1225,4103,774,1225,2362,9689,4
sisel,2206,2239,1021,3252,971,9689,4
shads,2206,927,1959,829,3767,9688,4
tabla,1264,4103,664,1295,2362,9688,4
maeve,1225,4103,1421,259,2679,9687,4
woods,596,3069,1426,829,3767,9687,4
talak,1264,4103,1603,2214,502,9686,4
atlas,1698,403,1603,2214,3767,9685,4
cahan,1512,4103,334,2214,1522,9685,4
warba,596,4103,2201,423,2362,9685,4
cuvee,1512,1824,417,3252,2679,9684,4
linie,1046,2239,1757,1963,2679,9684,4
phaea,1184,927,1959,3252,2362,9684,4
nests,647,2863,1021,1385,3767,9683,4
ramta,948,4103,885,1385,2362,9683,4
benny,1555,2863,1757,1391,2116,9682,4
solon,2206,3069,1603,1282,1522,9682,4
fanga,847,4103,1757,612,2362,9681,4
keane,789,2863,1959,1391,2679,9681,4
magan,1225,4103,616,2214,1522,9680,4
veers,404,2863,1421,1225,3767,9680,4
belem,1555,2863,1603,3252,406,9679,4
cilia,1512,2239,1603,1963,2362,9679,4
bella,1555,2863,1603,1295,2362,9678,4
yalta,225,4103,1603,1385,2362,9678,4
cocks,1512,3069,701,628,3767,9677,4
mohos,1225,3069,334,1282,3767,9677,4
sesra,2206,2863,1021,1225,2362,9677,4
bafta,1555,4103,271,1385,2362,9676,4
amias,1698,327,1668,2214,3767,9674,4
boose,1555,3069,1426,945,2679,9674,4
secre,2206,2863,701,1225,2679,9674,4
pulls,1184,1824,1603,1295,3767,9673,4
raman,948,4103,885,2214,1522,9672,4
mease,1225,2863,1959,945,2679,9671,4
norna,647,3069,2201,1391,2362,9670,4
terry,1264,2863,2201,1225,2116,9669,4
venie,404,2863,1757,1963,2679,9666,4
mitts,1225,2239,1048,1385,3767,9664,4
scans,2206,338,1959,1391,3767,9661,4
benin,1555,2863,1757,1963,1522,9660,4
malmy,1225,4103,1603,612,2116,9659,4
spans,2206,336,1959,1391,3767,9659,4
yirrs,225,2239,2201,1225,3767,9657,4
lorry,1046,3069,2201,1225,2116,9657,4
gurus,965,1824,2201,899,3767,9656,4
pepos,1184,2863,560,1282,3767,9656,4
tamar,1264,4103,885,2214,1190,9656,4
eaver,693,4103,417,3252,1190,9655,4
samau,2206,4103,885,2214,247,9655,4
scats,2206,338,1959,1385,3767,9655,4
simia,2206,2239,885,1963,2362,9655,4
cayla,1512,4103,381,1295,2362,9653,4
poole,1184,3069,1426,1295,2679,9653,4
saggy,2206,4103,616,612,2116,9653,4
spats,2206,336,1959,1385,3767,9653,4
meloe,1225,2863,1603,1282,2679,9652,4
bakra,1555,4103,406,1225,2362,9651,4
purer,1184,1824,2201,3252,1190,9651,4
slaps,2206,1193,1959,526,3767,9651,4
cadua,1512,4103,774,899,2362,9650,4
goala,965,3069,1959,1295,2362,9650,4
nomos,647,3069,885,1282,3767,9650,4
wanda,596,4103,1757,829,2362,9647,4
aalto,1698,4103,1603,1385,857,9646,4
aldas,1698,1193,774,2214,3767,9646,4
varve,404,4103,2201,259,2679,9646,4
gaura,965,4103,990,1225,2362,9645,4
visas,404,2239,1021,2214,3767,9645,4
geeks,965,2863,1421,628,3767,9644,4
waded,596,4103,774,3252,917,9642,4
sewel,2206,2863,349,3252,971,9641,4
pagan,1184,4103,616,2214,1522,9639,4
tikis,1264,2239,406,1963,3767,9639,4
bolly,1555,3069,1603,1295,2116,9638,4
mists,1225,2239,1021,1385,3767,9637,4
atlee,1698,403,1603,3252,2679,9635,4
cella,1512,2863,1603,1295,2362,9635,4
meara,1225,2863,1959,1225,2362,9634,4
aalst,1698,4103,1603,945,1284,9633,4
hoops,844,3069,1426,526,3767,9632,4
rente,948,2863,1757,1385,2679,9632,4
wests,596,2863,1021,1385,3767,9632,4
merry,1225,2863,2201,1225,2116,9630,4
pease,1184,2863,1959,945,2679,9630,4
ardea,1698,1543,774,3252,2362,9629,4
boron,1555,3069,2201,1282,1522,9629,4
jaela,446,4103,1421,1295,2362,9627,4
reeks,948,2863,1421,628,3767,9627,4
hobos,844,3069,664,1282,3767,9626,4
lonna,1046,3069,1757,1391,2362,9625,4
ionia,473,3069,1757,1963,2362,9624,4
kirks,789,2239,2201,628,3767,9624,4
moore,1225,3069,1426,1225,2679,9624,4
fusee,847,1824,1021,3252,2679,9623,4
kanga,789,4103,1757,612,2362,9623,4
pitts,1184,2239,1048,1385,3767,9623,4
simps,2206,2239,885,526,3767,9623,4
perez,1184,2863,2201,3252,122,9622,4
danya,1128,4103,1757,271,2362,9621,4
aeger,1698,2863,616,3252,1190,9619,4
boggs,1555,3069,616,612,3767,9619,4
dazed,1128,4103,217,3252,917,9617,4
dulls,1128,1824,1603,1295,3767,9617,4
houss,844,3069,990,945,3767,9615,4
dodie,1128,3069,774,1963,2679,9613,4
rooed,948,3069,1426,3252,917,9612,4
naida,647,4103,1668,829,2362,9609,4
cakra,1512,4103,406,1225,2362,9608,4
ierne,473,2863,2201,1391,2679,9607,4
culus,1512,1824,1603,899,3767,9605,4
haika,844,4103,1668,628,2362,9605,4
talya,1264,4103,1603,271,2362,9603,4
seize,2206,2863,1668,186,2679,9602,4
dagna,1128,4103,616,1391,2362,9600,4
jinns,446,2239,1757,1391,3767,9600,4
ratty,948,4103,1048,1385,2116,9600,4
titos,1264,2239,1048,1282,3767,9600,4
belue,1555,2863,1603,899,2679,9599,4
goloe,965,3069,1603,1282,2679,9598,4
doole,1128,3069,1426,1295,2679,9597,4
treey,1264,1543,1421,3252,2116,9596,4
araks,1698,1543,1959,628,3767,9595,4
colly,1512,3069,1603,1295,2116,9595,4
durer,1128,1824,2201,3252,1190,9595,4
bawra,1555,4103,349,1225,2362,9594,4
skros,2206,137,2201,1282,3767,9593,4
hasse,844,4103,1021,945,2679,9592,4
panza,1184,4103,1757,186,2362,9592,4
ceder,1512,2863,774,3252,1190,9591,4
perry,1184,2863,2201,1225,2116,9589,4
segre,2206,2863,616,1225,2679,9589,4
aecia,1698,2863,701,1963,2362,9587,4
sewed,2206,2863,349,3252,917,9587,4
teaty,1264,2863,1959,1385,2116,9587,4
loofs,1046,3069,1426,278,3767,9586,4
rekey,948,2863,406,3252,2116,9585,4
tinia,1264,2239,1757,1963,2362,9585,4
dagan,1128,4103,616,2214,1522,9583,4
yulee,225,1824,1603,3252,2679,9583,4
poore,1184,3069,1426,1225,2679,9583,4
menan,1225,2863,1757,2214,1522,9581,4
merge,1225,2863,2201,612,2679,9580,4
butts,1555,1824,1048,1385,3767,9579,4
cauma,1512,4103,990,612,2362,9579,4
meter,1225,2863,1048,3252,1190,9578,4
gorry,965,3069,2201,1225,2116,9576,4
varah,404,4103,2201,2214,654,9576,4
cadal,1512,4103,774,2214,971,9574,4
broos,1555,1543,1426,1282,3767,9573,4
narva,647,4103,2201,259,2362,9572,4
sousa,2206,3069,990,945,2362,9572,4
surry,2206,1824,2201,1225,2116,9572,4
daroo,1128,4103,2201,1282,857,9571,4
tapoa,1264,4103,560,1282,2362,9571,4
beget,1555,2863,616,3252,1284,9570,4
haman,844,4103,885,2214,1522,9568,4
boded,1555,3069,774,3252,917,9567,4
janua,446,4103,1757,899,2362,9567,4
herem,844,2863,2201,3252,406,9566,4
bagge,1555,4103,616,612,2679,9565,4
mozos,1225,3069,217,1282,3767,9560,4
stars,2206,403,1959,1225,3767,9560,4
zoeae,176,3069,1421,2214,2679,9559,4
monny,1225,3069,1757,1391,2116,9558,4
boony,1555,3069,1426,1391,2116,9557,4
penna,1184,2863,1757,1391,2362,9557,4
meade,1225,2863,1959,829,2679,9555,4
mamry,1225,4103,885,1225,2116,9554,4
molla,1225,3069,1603,1295,2362,9554,4
abbes,1698,172,664,3252,3767,9553,4
busts,1555,1824,1021,1385,3767,9552,4
malva,1225,4103,1603,259,2362,9552,4
booty,1555,3069,1426,1385,2116,9551,4
nills,647,2239,1603,1295,3767,9551,4
toted,1264,3069,1048,3252,917,9550,4
laban,1046,4103,664,2214,1522,9549,4
naiad,647,4103,1668,2214,917,9549,4
pupas,1184,1824,560,2214,3767,9549,4
reine,948,2863,1668,1391,2679,9549,4
swans,2206,226,1959,1391,3767,9549,4
slabs,2206,1193,1959,423,3767,9548,4
daffs,1128,4103,271,278,3767,9547,4
gonna,965,3069,1757,1391,2362,9544,4
jaggs,446,4103,616,612,3767,9544,4
lyses,1046,458,1021,3252,3767,9544,4
nalda,647,4103,1603,829,2362,9544,4
sidia,2206,2239,774,1963,2362,9544,4
swats,2206,226,1959,1385,3767,9543,4
tedie,1264,2863,774,1963,2679,9543,4
sicks,2206,2239,701,628,3767,9541,4
sluts,2206,1193,990,1385,3767,9541,4
sunna,2206,1824,1757,1391,2362,9540,4
galah,965,4103,1603,2214,654,9539,4
jabia,446,4103,664,1963,2362,9538,4
verne,404,2863,2201,1391,2679,9538,4
nooks,647,3069,1426,628,3767,9537,4
peter,1184,2863,1048,3252,1190,9537,4
albas,1698,1193,664,2214,3767,9536,4
cahra,1512,4103,334,1225,2362,9536,4
aosta,1698,3069,1021,1385,2362,9535,4
beice,1555,2863,1668,770,2679,9535,4
misos,1225,2239,1021,1282,3767,9534,4
oelet,532,2863,1603,3252,1284,9534,4
derry,1128,2863,2201,1225,2116,9533,4
silin,2206,2239,1603,1963,1522,9533,4
wooer,596,3069,1426,3252,1190,9533,4
herse,844,2863,2201,945,2679,9532,4
syrus,2206,458,2201,899,3767,9531,4
gehey,965,2863,334,3252,2116,9530,4
dorad,1128,3069,2201,2214,917,9529,4
bezae,1555,2863,217,2214,2679,9528,4
rewey,948,2863,349,3252,2116,9528,4
needs,647,2863,1421,829,3767,9527,4
ronna,948,3069,1757,1391,2362,9527,4
alsea,1698,1193,1021,3252,2362,9526,4
behen,1555,2863,334,3252,1522,9526,4
gorge,965,3069,2201,612,2679,9526,4
lanam,1046,4103,1757,2214,406,9526,4
sawah,2206,4103,349,2214,654,9526,4
rorke,948,3069,2201,628,2679,9525,4
coded,1512,3069,774,3252,917,9524,4
halma,844,4103,1603,612,2362,9524,4
aknee,1698,137,1757,3252,2679,9523,4
vally,404,4103,1603,1295,2116,9521,4
daiva,1128,4103,1668,259,2362,9520,4
damar,1128,4103,885,2214,1190,9520,4
lagna,1046,4103,616,1391,2362,9518,4
reata,948,2863,1959,1385,2362,9517,4
keare,789,2863,1959,1225,2679,9515,4
coony,1512,3069,1426,1391,2116,9514,4
lurer,1046,1824,2201,3252,1190,9513,4
sansk,2206,4103,1757,945,502,9513,4
sabby,2206,4103,664,423,2116,9512,4
toona,1264,3069,1426,1391,2362,9512,4
fanon,847,4103,1757,1282,1522,9511,4
sappy,2206,4103,560,526,2116,9511,4
ronan,948,3069,1757,2214,1522,9510,4
cooty,1512,3069,1426,1385,2116,9508,4
tense,1264,2863,1757,945,2679,9508,4
duads,1128,1824,1959,829,3767,9507,4
roter,948,3069,1048,3252,1190,9507,4
goofs,965,3069,1426,278,3767,9505,4
sivie,2206,2239,417,1963,2679,9504,4
aegia,1698,2863,616,1963,2362,9502,4
toity,1264,3069,1668,1385,2116,9502,4
denna,1128,2863,1757,1391,2362,9501,4
lagan,1046,4103,616,2214,1522,9501,4
loral,1046,3069,2201,2214,971,9501,4
retie,948,2863,1048,1963,2679,9501,4
matai,1225,4103,1048,2214,910,9500,4
sakha,2206,4103,406,423,2362,9500,4
wills,596,2239,1603,1295,3767,9500,4
fatty,847,4103,1048,1385,2116,9499,4
hatty,844,4103,1048,1385,2116,9496,4
herra,844,2863,2201,1225,2362,9495,4
luaus,1046,1824,1959,899,3767,9495,4
scars,2206,338,1959,1225,3767,9495,4
boece,1555,3069,1421,770,2679,9494,4
gantt,965,4103,1757,1385,1284,9494,4
spars,2206,336,1959,1225,3767,9493,4
jaded,446,4103,774,3252,917,9492,4
lease,1046,2863,1959,945,2679,9492,4
batha,1555,4103,1048,423,2362,9491,4
holle,844,3069,1603,1295,2679,9490,4
genre,965,2863,1757,1225,2679,9489,4
zamia,176,4103,885,1963,2362,9489,4
algas,1698,1193,616,2214,3767,9488,4
roofs,948,3069,1426,278,3767,9488,4
shaks,2206,927,1959,628,3767,9487,4
albee,1698,1193,664,3252,2679,9486,4
malwa,1225,4103,1603,192,2362,9485,4
capsa,1512,4103,560,945,2362,9482,4
jests,446,2863,1021,1385,3767,9482,4
calic,1512,4103,1603,1963,300,9481,4
deter,1128,2863,1048,3252,1190,9481,4
kurus,789,1824,2201,899,3767,9480,4
roser,948,3069,1021,3252,1190,9480,4
briss,1555,1543,1668,945,3767,9478,4
megen,1225,2863,616,3252,1522,9478,4
trass,1264,1543,1959,945,3767,9478,4
wirer,596,2239,2201,3252,1190,9478,4
adlee,1698,245,1603,3252,2679,9477,4
weeds,596,2863,1421,829,3767,9476,4
bajan,1555,4103,81,2214,1522,9475,4
keten,789,2863,1048,3252,1522,9474,4
koala,789,3069,1959,1295,2362,9474,4
kente,789,2863,1757,1385,2679,9473,4
masai,1225,4103,1021,2214,910,9473,4
shags,2206,927,1959,612,3767,9471,4
shams,2206,927,1959,612,3767,9471,4
cabda,1512,4103,664,829,2362,9470,4
ellas,693,1193,1603,2214,3767,9470,4
remen,948,2863,885,3252,1522,9470,4
mense,1225,2863,1757,945,2679,9469,4
wasta,596,4103,1021,1385,2362,9467,4
balli,1555,4103,1603,1295,910,9466,4
benge,1555,2863,1757,612,2679,9466,4
vener,404,2863,1757,3252,1190,9466,4
cabal,1512,4103,664,2214,971,9464,4
seema,2206,2863,1421,612,2362,9464,4
exies,693,83,1668,3252,3767,9463,4
tenue,1264,2863,1757,899,2679,9462,4
booly,1555,3069,1426,1295,2116,9461,4
donny,1128,3069,1757,1391,2116,9461,4
ceste,1512,2863,1021,1385,2679,9460,4
silly,2206,2239,1603,1295,2116,9459,4
lists,1046,2239,1021,1385,3767,9458,4
bisie,1555,2239,1021,1963,2679,9457,4
leden,1046,2863,774,3252,1522,9457,4
galba,965,4103,1603,423,2362,9456,4
horry,844,3069,2201,1225,2116,9455,4
peace,1184,2863,1959,770,2679,9455,4
popie,1184,3069,560,1963,2679,9455,4
snots,2206,671,1426,1385,3767,9455,4
vanda,404,4103,1757,829,2362,9455,4
gulls,965,1824,1603,1295,3767,9454,4
lanza,1046,4103,1757,186,2362,9454,4
skats,2206,137,1959,1385,3767,9454,4
zarga,176,4103,2201,612,2362,9454,4
qanat,93,4103,1757,2214,1284,9451,4
somme,2206,3069,885,612,2679,9451,4
bayly,1555,4103,381,1295,2116,9450,4
texts,1264,2863,170,1385,3767,9449,4
catha,1512,4103,1048,423,2362,9448,4
slims,2206,1193,1668,612,3767,9446,4
cayce,1512,4103,381,770,2679,9445,4
ganam,965,4103,1757,2214,406,9445,4
heine,844,2863,1668,1391,2679,9445,4
mayan,1225,4103,381,2214,1522,9445,4
sooky,2206,3069,1426,628,2116,9445,4
bayar,1555,4103,381,2214,1190,9443,4
neale,647,2863,1959,1295,2679,9443,4
wauna,596,4103,990,1391,2362,9442,4
pavan,1184,4103,417,2214,1522,9440,4
vests,404,2863,1021,1385,3767,9440,4
lamar,1046,4103,885,2214,1190,9438,4
tamal,1264,4103,885,2214,971,9437,4
capua,1512,4103,560,899,2362,9436,4
isles,473,341,1603,3252,3767,9436,4
cobbs,1512,3069,664,423,3767,9435,4
criss,1512,1543,1668,945,3767,9435,4
seedy,2206,2863,1421,829,2116,9435,4
copps,1512,3069,560,526,3767,9434,4
goole,965,3069,1426,1295,2679,9434,4
gerar,965,2863,2201,2214,1190,9433,4
belly,1555,2863,1603,1295,2116,9432,4
cajan,1512,4103,81,2214,1522,9432,4
poona,1184,3069,1426,1391,2362,9432,4
snads,2206,671,1959,829,3767,9432,4
pomps,1184,3069,885,526,3767,9431,4
tilia,1264,2239,1603,1963,2362,9431,4
bacao,1555,4103,701,2214,857,9430,4
wanga,596,4103,1757,612,2362,9430,4
deben,1128,2863,664,3252,1522,9429,4
kalil,789,4103,1603,1963,971,9429,4
pense,1184,2863,1757,945,2679,9428,4
beera,1555,2863,1421,1225,2362,9426,4
mojos,1225,3069,81,1282,3767,9424,4
calli,1512,4103,1603,1295,910,9423,4
honna,844,3069,1757,1391,2362,9423,4
batak,1555,4103,1048,2214,502,9422,4
casha,1512,4103,1021,423,2362,9421,4
vitis,404,2239,1048,1963,3767,9421,4
masao,1225,4103,1021,2214,857,9420,4
ferde,847,2863,2201,829,2679,9419,4
lenna,1046,2863,1757,1391,2362,9419,4
tanti,1264,4103,1757,1385,910,9419,4
teise,1264,2863,1668,945,2679,9419,4
zeiss,176,2863,1668,945,3767,9419,4
cache,1512,4103,701,423,2679,9418,4
cooly,1512,3069,1426,1295,2116,9418,4
samaj,2206,4103,885,2214,10,9418,4
shaia,2206,927,1959,1963,2362,9417,4
valsa,404,4103,1603,945,2362,9417,4
sleds,2206,1193,1421,829,3767,9416,4
bedel,1555,2863,774,3252,971,9415,4
doted,1128,3069,1048,3252,917,9414,4
ballo,1555,4103,1603,1295,857,9413,4
beggs,1555,2863,616,612,3767,9413,4
olnee,532,1193,1757,3252,2679,9413,4
bebay,1555,2863,664,2214,2116,9412,4
bamah,1555,4103,885,2214,654,9411,4
gease,965,2863,1959,945,2679,9411,4
massy,1225,4103,1021,945,2116,9410,4
garoo,965,4103,2201,1282,857,9408,4
sexed,2206,2863,170,3252,917,9408,4
damme,1128,4103,885,612,2679,9407,4
desks,1128,2863,1021,628,3767,9407,4
torii,1264,3069,2201,1963,910,9407,4
foote,847,3069,1426,1385,2679,9406,4
honan,844,3069,1757,2214,1522,9406,4
motte,1225,3069,1048,1385,2679,9406,4
patao,1184,4103,1048,2214,857,9406,4
apnea,1698,336,1757,3252,2362,9405,4
gaitt,965,4103,1668,1385,1284,9405,4
leone,1046,2863,1426,1391,2679,9405,4
ragan,948,4103,616,2214,1522,9403,4
roral,948,3069,2201,2214,971,9403,4
panax,1184,4103,1757,2214,144,9402,4
circe,1512,2239,2201,770,2679,9401,4
baloo,1555,4103,1603,1282,857,9400,4
bekaa,1555,2863,406,2214,2362,9400,4
korry,789,3069,2201,1225,2116,9400,4
labra,1046,4103,664,1225,2362,9400,4
antas,1698,671,1048,2214,3767,9398,4
mahan,1225,4103,334,2214,1522,9398,4
bahar,1555,4103,334,2214,1190,9396,4
slays,2206,1193,1959,271,3767,9396,4
nancy,647,4103,1757,770,2116,9393,4
ashes,1698,341,334,3252,3767,9392,4
milia,1225,2239,1603,1963,2362,9392,4
naima,647,4103,1668,612,2362,9392,4
arabs,1698,1543,1959,423,3767,9390,4
campa,1512,4103,885,526,2362,9388,4
sided,2206,2239,774,3252,917,9388,4
dosed,1128,3069,1021,3252,917,9387,4
tella,1264,2863,1603,1295,2362,9387,4
eagle,693,4103,616,1295,2679,9386,4
riner,948,2239,1757,3252,1190,9386,4
shaps,2206,927,1959,526,3767,9385,4
tenty,1264,2863,1757,1385,2116,9385,4
trots,1264,1543,1426,1385,3767,9385,4
eurus,693,1824,2201,899,3767,9384,4
gaffs,965,4103,271,278,3767,9384,4
hoofs,844,3069,1426,278,3767,9384,4
slavs,2206,1193,1959,259,3767,9384,4
woops,596,3069,1426,526,3767,9384,4
kalpa,789,4103,1603,526,2362,9383,4
eaved,693,4103,417,3252,917,9382,4
loasa,1046,3069,1959,945,2362,9381,4
slurs,2206,1193,990,1225,3767,9381,4
trets,1264,1543,1421,1385,3767,9380,4
lonny,1046,3069,1757,1391,2116,9379,4
baddy,1555,4103,774,829,2116,9377,4
beige,1555,2863,1668,612,2679,9377,4
gists,965,2239,1021,1385,3767,9377,4
moola,1225,3069,1426,1295,2362,9377,4
teage,1264,2863,1959,612,2679,9377,4
class,1512,1193,1959,945,3767,9376,4
cotta,1512,3069,1048,1385,2362,9376,4
nomen,647,3069,885,3252,1522,9375,4
ganza,965,4103,1757,186,2362,9373,4
dense,1128,2863,1757,945,2679,9372,4
aglee,1698,139,1603,3252,2679,9371,4
bakke,1555,4103,406,628,2679,9371,4
bille,1555,2239,1603,1295,2679,9371,4
fokos,847,3069,406,1282,3767,9371,4
callo,1512,4103,1603,1295,857,9370,4
gerry,965,2863,2201,1225,2116,9370,4
passy,1184,4103,1021,945,2116,9369,4
reset,948,2863,1021,3252,1284,9368,4
spins,2206,336,1668,1391,3767,9368,4
raffs,948,4103,271,278,3767,9367,4
hemen,844,2863,885,3252,1522,9366,4
keeps,789,2863,1421,526,3767,9366,4
matka,1225,4103,1048,628,2362,9366,4
tanto,1264,4103,1757,1385,857,9366,4
dayna,1128,4103,381,1391,2362,9365,4
teths,1264,2863,1048,423,3767,9365,4
aetna,1698,2863,1048,1391,2362,9362,4
spits,2206,336,1668,1385,3767,9362,4
lupee,1046,1824,560,3252,2679,9361,4
pavla,1184,4103,417,1295,2362,9361,4
slips,2206,1193,1668,526,3767,9360,4
celeb,1512,2863,1603,3252,129,9359,4
losel,1046,3069,1021,3252,971,9359,4
metel,1225,2863,1048,3252,971,9359,4
sleet,2206,1193,1421,3252,1284,9356,4
mende,1225,2863,1757,829,2679,9353,4
beode,1555,2863,1426,829,2679,9352,4
boeke,1555,3069,1421,628,2679,9352,4
palau,1184,4103,1603,2214,247,9351,4
pipey,1184,2239,560,3252,2116,9351,4
jills,446,2239,1603,1295,3767,9350,4
gauge,965,4103,990,612,2679,9349,4
corot,1512,3069,2201,1282,1284,9348,4
dayan,1128,4103,381,2214,1522,9348,4
mella,1225,2863,1603,1295,2362,9348,4
zarah,176,4103,2201,2214,654,9348,4
haoma,844,4103,1426,612,2362,9347,4
leben,1046,2863,664,3252,1522,9347,4
tolly,1264,3069,1603,1295,2116,9347,4
stret,2206,403,2201,3252,1284,9346,4
katar,789,4103,1048,2214,1190,9344,4
moose,1225,3069,1426,945,2679,9344,4
beety,1555,2863,1421,1385,2116,9340,4
fanya,847,4103,1757,271,2362,9340,4
peise,1184,2863,1668,945,2679,9339,4
genna,965,2863,1757,1391,2362,9338,4
jeane,446,2863,1959,1391,2679,9338,4
giess,965,2239,1421,945,3767,9337,4
hanya,844,4103,1757,271,2362,9337,4
fulls,847,1824,1603,1295,3767,9336,4
tayra,1264,4103,381,1225,2362,9335,4
caddy,1512,4103,774,829,2116,9334,4
dawna,1128,4103,349,1391,2362,9333,4
hulls,844,1824,1603,1295,3767,9333,4
manno,1225,4103,1757,1391,857,9333,4
sonni,2206,3069,1757,1391,910,9333,4
mavra,1225,4103,417,1225,2362,9332,4
mesel,1225,2863,1021,3252,971,9332,4
lauda,1046,4103,990,829,2362,9330,4
tinne,1264,2239,1757,1391,2679,9330,4
sheen,2206,927,1421,3252,1522,9328,4
dojos,1128,3069,81,1282,3767,9327,4
fanam,847,4103,1757,2214,406,9327,4
ladar,1046,4103,774,2214,1190,9327,4
bajra,1555,4103,81,1225,2362,9326,4
feala,847,2863,1959,1295,2362,9326,4
sinai,2206,2239,1757,2214,910,9326,4
dured,1128,1824,2201,3252,917,9322,4
elves,693,1193,417,3252,3767,9322,4
padua,1184,4103,774,899,2362,9322,4
weare,596,2863,1959,1225,2679,9322,4
lewls,1046,2863,349,1295,3767,9320,4
riess,948,2239,1421,945,3767,9320,4
mahla,1225,4103,334,1295,2362,9319,4
dahna,1128,4103,334,1391,2362,9318,4
slaws,2206,1193,1959,192,3767,9317,4
eagre,693,4103,616,1225,2679,9316,4
tacit,1264,4103,701,1963,1284,9315,4
cooke,1512,3069,1426,628,2679,9314,4
coosa,1512,3069,1426,945,2362,9314,4
skuas,2206,137,990,2214,3767,9314,4
dassy,1128,4103,1021,945,2116,9313,4
peake,1184,2863,1959,628,2679,9313,4
penny,1184,2863,1757,1391,2116,9311,4
neems,647,2863,1421,612,3767,9310,4
ninus,647,2239,1757,899,3767,9309,4
ollas,532,1193,1603,2214,3767,9309,4
molly,1225,3069,1603,1295,2116,9308,4
vills,404,2239,1603,1295,3767,9308,4
pella,1184,2863,1603,1295,2362,9307,4
meted,1225,2863,1048,3252,917,9305,4
binna,1555,2239,1757,1391,2362,9304,4
renan,948,2863,1757,2214,1522,9304,4
aevia,1698,2863,417,1963,2362,9303,4
bewet,1555,2863,349,3252,1284,9303,4
teide,1264,2863,1668,829,2679,9303,4
fagan,847,4103,616,2214,1522,9302,4
thats,1264,927,1959,1385,3767,9302,4
damal,1128,4103,885,2214,971,9301,4
teena,1264,2863,1421,1391,2362,9301,4
valda,404,4103,1603,829,2362,9301,4
hagan,844,4103,616,2214,1522,9299,4
moron,1225,3069,2201,1282,1522,9299,4
natty,647,4103,1048,1385,2116,9299,4
peage,1184,2863,1959,612,2679,9297,4
janka,446,4103,1757,628,2362,9296,4
sycee,2206,458,701,3252,2679,9296,4
sunny,2206,1824,1757,1391,2116,9294,4
breen,1555,1543,1421,3252,1522,9293,4
dined,1128,2239,1757,3252,917,9293,4
fease,847,2863,1959,945,2679,9293,4
nolle,647,3069,1603,1295,2679,9293,4
galva,965,4103,1603,259,2362,9292,4
minne,1225,2239,1757,1391,2679,9291,4
lense,1046,2863,1757,945,2679,9290,4
sulla,2206,1824,1603,1295,2362,9290,4
danni,1128,4103,1757,1391,910,9289,4
malax,1225,4103,1603,2214,144,9289,4
yetts,225,2863,1048,1385,3767,9288,4
fitts,847,2239,1048,1385,3767,9286,4
ivies,473,126,1668,3252,3767,9286,4
tovet,1264,3069,417,3252,1284,9286,4
sebec,2206,2863,664,3252,300,9285,4
ratal,948,4103,1048,2214,971,9284,4
harri,844,4103,2201,1225,910,9283,4
kanya,789,4103,1757,271,2362,9282,4
ronny,948,3069,1757,1391,2116,9281,4
shuns,2206,927,990,1391,3767,9281,4
aldea,1698,1193,774,3252,2362,9279,4
bazar,1555,4103,217,2214,1190,9279,4
reade,948,2863,1959,829,2679,9278,4
bever,1555,2863,417,3252,1190,9277,4
reefs,948,2863,1421,278,3767,9277,4
rolla,948,3069,1603,1295,2362,9277,4
waura,596,4103,990,1225,2362,9276,4
kamat,789,4103,885,2214,1284,9275,4
shuts,2206,927,990,1385,3767,9275,4
vasta,404,4103,1021,1385,2362,9275,4
weeks,596,2863,1421,628,3767,9275,4
daeva,1128,4103,1421,259,2362,9273,4
heloe,844,2863,1603,1282,2679,9271,4
seqed,2206,2863,32,3252,917,9270,4
zazen,176,4103,217,3252,1522,9270,4
nasat,647,4103,1021,2214,1284,9269,4
stirs,2206,403,1668,1225,3767,9269,4
aargh,1698,4103,2201,612,654,9268,4
allen,1698,1193,1603,3252,1522,9268,4
polly,1184,3069,1603,1295,2116,9267,4
beker,1555,2863,406,3252,1190,9266,4
pahoa,1184,4103,334,1282,2362,9265,4
peder,1184,2863,774,3252,1190,9263,4
rupee,948,1824,560,3252,2679,9263,4
segue,2206,2863,616,899,2679,9263,4
sirih,2206,2239,2201,1963,654,9263,4
smils,2206,327,1668,1295,3767,9263,4
utees,420,403,1421,3252,3767,9263,4
maill,1225,4103,1668,1295,971,9262,4
sleer,2206,1193,1421,3252,1190,9262,4
cinna,1512,2239,1757,1391,2362,9261,4
batwa,1555,4103,1048,192,2362,9260,4
wooed,596,3069,1426,3252,917,9260,4
fists,847,2239,1021,1385,3767,9259,4
ronin,948,3069,1757,1963,1522,9259,4
weems,596,2863,1421,612,3767,9259,4
norry,647,3069,2201,1225,2116,9258,4
tenez,1264,2863,1757,3252,122,9258,4
cocle,1512,3069,701,1295,2679,9256,4
hists,844,2239,1021,1385,3767,9256,4
dafna,1128,4103,271,1391,2362,9255,4
denny,1128,2863,1757,1391,2116,9255,4
haifa,844,4103,1668,278,2362,9255,4
pence,1184,2863,1757,770,2679,9253,4
ferry,847,2863,2201,1225,2116,9252,4
della,1128,2863,1603,1295,2362,9251,4
domed,1128,3069,885,3252,917,9251,4
sighs,2206,2239,616,423,3767,9251,4
creen,1512,1543,1421,3252,1522,9250,4
bakal,1555,4103,406,2214,971,9249,4
herry,844,2863,2201,1225,2116,9249,4
mahra,1225,4103,334,1225,2362,9249,4
mutts,1225,1824,1048,1385,3767,9249,4
ganja,965,4103,1757,61,2362,9248,4
sowse,2206,3069,349,945,2679,9248,4
werra,596,2863,2201,1225,2362,9247,4
baccy,1555,4103,701,770,2116,9245,4
yarak,225,4103,2201,2214,502,9245,4
hausa,844,4103,990,945,2362,9244,4
tagua,1264,4103,616,899,2362,9244,4
teleg,1264,2863,1603,3252,261,9243,4
lanaz,1046,4103,1757,2214,122,9242,4
beyer,1555,2863,381,3252,1190,9241,4
sitta,2206,2239,1048,1385,2362,9240,4
vakia,404,4103,406,1963,2362,9238,4
leila,1046,2863,1668,1295,2362,9234,4
farro,847,4103,2201,1225,857,9233,4
karoo,789,4103,2201,1282,857,9232,4
remet,948,2863,885,3252,1284,9232,4
bress,1555,1543,1421,945,3767,9231,4
bayda,1555,4103,381,829,2362,9230,4
cammy,1512,4103,885,612,2116,9228,4
geole,965,2863,1426,1295,2679,9228,4
jenei,446,2863,1757,3252,910,9228,4
karri,789,4103,2201,1225,910,9228,4
joana,446,3069,1959,1391,2362,9227,4
lotte,1046,3069,1048,1385,2679,9227,4
moony,1225,3069,1426,1391,2116,9227,4
cosse,1512,3069,1021,945,2679,9226,4
madai,1225,4103,774,2214,910,9226,4
wadna,596,4103,774,1391,2362,9226,4
lamda,1046,4103,885,829,2362,9225,4
bayal,1555,4103,381,2214,971,9224,4
neeps,647,2863,1421,526,3767,9224,4
musts,1225,1824,1021,1385,3767,9222,4
verek,404,2863,2201,3252,502,9222,4
gavan,965,4103,417,2214,1522,9221,4
ellis,693,1193,1603,1963,3767,9219,4
reace,948,2863,1959,770,2679,9219,4
wasat,596,4103,1021,2214,1284,9218,4
caval,1512,4103,417,2214,971,9217,4
henna,844,2863,1757,1391,2362,9217,4
titus,1264,2239,1048,899,3767,9217,4
camak,1512,4103,885,2214,502,9216,4
snags,2206,671,1959,612,3767,9215,4
tiana,1264,2239,1959,1391,2362,9215,4
betta,1555,2863,1048,1385,2362,9213,4
rabat,948,4103,664,2214,1284,9213,4
neuss,647,2863,990,945,3767,9212,4
zests,176,2863,1021,1385,3767,9212,4
dolly,1128,3069,1603,1295,2116,9211,4
bisks,1555,2239,1021,628,3767,9210,4
gorga,965,3069,2201,612,2362,9209,4
brier,1555,1543,1668,3252,1190,9208,4
putts,1184,1824,1048,1385,3767,9208,4
sumps,2206,1824,885,526,3767,9208,4
traer,1264,1543,1959,3252,1190,9208,4
lanni,1046,4103,1757,1391,910,9207,4
worry,596,3069,2201,1225,2116,9207,4
slogs,2206,1193,1426,612,3767,9204,4
hanap,844,4103,1757,2214,285,9203,4
ferme,847,2863,2201,612,2679,9202,4
kists,789,2239,1021,1385,3767,9201,4
regen,948,2863,616,3252,1522,9201,4
tartu,1264,4103,2201,1385,247,9200,4
gedds,965,2863,774,829,3767,9198,4
nerin,647,2863,2201,1963,1522,9196,4
kerry,789,2863,2201,1225,2116,9194,4
cross,1512,1543,1426,945,3767,9193,4
rakan,948,4103,406,2214,1522,9193,4
vened,404,2863,1757,3252,917,9193,4
zitis,176,2239,1048,1963,3767,9193,4
barbi,1555,4103,2201,423,910,9192,4
didos,1128,2239,774,1282,3767,9190,4
halfa,844,4103,1603,278,2362,9190,4
cress,1512,1543,1421,945,3767,9188,4
pilei,1184,2239,1603,3252,910,9188,4
sivia,2206,2239,417,1963,2362,9187,4
rayna,948,4103,381,1391,2362,9185,4
ruers,948,1824,1421,1225,3767,9185,4
shuls,2206,927,990,1295,3767,9185,4
fatal,847,4103,1048,2214,971,9183,4
redds,948,2863,774,829,3767,9181,4
beery,1555,2863,1421,1225,2116,9180,4
kinks,789,2239,1757,628,3767,9180,4
pooty,1184,3069,1426,1385,2116,9180,4
shims,2206,927,1668,612,3767,9180,4
grass,965,1543,1959,945,3767,9179,4
mesne,1225,2863,1021,1391,2679,9179,4
takar,1264,4103,406,2214,1190,9177,4
lagly,1046,4103,616,1295,2116,9176,4
leake,1046,2863,1959,628,2679,9175,4
talli,1264,4103,1603,1295,910,9175,4
wonna,596,3069,1757,1391,2362,9175,4
tapit,1264,4103,560,1963,1284,9174,4
holla,844,3069,1603,1295,2362,9173,4
lenny,1046,2863,1757,1391,2116,9173,4
tasha,1264,4103,1021,423,2362,9173,4
weeps,596,2863,1421,526,3767,9173,4
bulbs,1555,1824,1603,423,3767,9172,4
halva,844,4103,1603,259,2362,9171,4
jaman,446,4103,885,2214,1522,9170,4
skins,2206,137,1668,1391,3767,9169,4
rayan,948,4103,381,2214,1522,9168,4
tagal,1264,4103,616,2214,971,9168,4
burra,1555,1824,2201,1225,2362,9167,4
lafta,1046,4103,271,1385,2362,9167,4
crier,1512,1543,1668,3252,1190,9165,4
deena,1128,2863,1421,1391,2362,9165,4
hanau,844,4103,1757,2214,247,9165,4
loose,1046,3069,1426,945,2679,9165,4
nairn,647,4103,1668,1225,1522,9165,4
skits,2206,137,1668,1385,3767,9163,4
kenna,789,2863,1757,1391,2362,9162,4
sordo,2206,3069,2201,829,857,9162,4
keleh,789,2863,1603,3252,654,9161,4
matha,1225,4103,1048,423,2362,9161,4
mahat,1225,4103,334,2214,1284,9160,4
dafla,1128,4103,271,1295,2362,9159,4
randn,948,4103,1757,829,1522,9159,4
siege,2206,2239,1421,612,2679,9157,4
cosec,1512,3069,1021,3252,300,9154,4
murre,1225,1824,2201,1225,2679,9154,4
papke,1184,4103,560,628,2679,9154,4
neile,647,2863,1668,1295,2679,9152,4
aegle,1698,2863,616,1295,2679,9151,4
lenin,1046,2863,1757,1963,1522,9151,4
gassy,965,4103,1021,945,2116,9150,4
naoma,647,4103,1426,612,2362,9150,4
sheds,2206,927,1421,829,3767,9150,4
oboes,532,172,1426,3252,3767,9149,4
eagan,693,4103,616,2214,1522,9148,4
kanap,789,4103,1757,2214,285,9148,4
heben,844,2863,664,3252,1522,9145,4
repen,948,2863,560,3252,1522,9145,4
kerge,789,2863,2201,612,2679,9144,4
alfas,1698,1193,271,2214,3767,9143,4
meute,1225,2863,990,1385,2679,9142,4
moapa,1225,3069,1959,526,2362,9141,4
telly,1264,2863,1603,1295,2116,9141,4
tampa,1264,4103,885,526,2362,9140,4
hamsa,844,4103,885,945,2362,9139,4
gahan,965,4103,334,2214,1522,9138,4
gamal,965,4103,885,2214,971,9138,4
makar,1225,4103,406,2214,1190,9138,4
allie,1698,1193,1603,1963,2679,9136,4
gabar,965,4103,664,2214,1190,9136,4
nulls,647,1824,1603,1295,3767,9136,4
woofs,596,3069,1426,278,3767,9136,4
magda,1225,4103,616,829,2362,9135,4
masha,1225,4103,1021,423,2362,9134,4
sedge,2206,2863,774,612,2679,9134,4
somma,2206,3069,885,612,2362,9134,4
gadge,965,4103,774,612,2679,9133,4
gilia,965,2239,1603,1963,2362,9132,4
peste,1184,2863,1021,1385,2679,9132,4
seepy,2206,2863,1421,526,2116,9132,4
gerbe,965,2863,2201,423,2679,9131,4
cotty,1512,3069,1048,1385,2116,9130,4
derve,1128,2863,2201,259,2679,9130,4
shays,2206,927,1959,271,3767,9130,4
deneb,1128,2863,1757,3252,129,9129,4
yills,225,2239,1603,1295,3767,9129,4
rotte,948,3069,1048,1385,2679,9129,4
snaps,2206,671,1959,526,3767,9129,4
bliss,1555,1193,1668,945,3767,9128,4
hemet,844,2863,885,3252,1284,9128,4
vaman,404,4103,885,2214,1522,9128,4
neala,647,2863,1959,1295,2362,9126,4
sucks,2206,1824,701,628,3767,9126,4
telex,1264,2863,1603,3252,144,9126,4
dusts,1128,1824,1021,1385,3767,9125,4
hadar,844,4103,774,2214,1190,9125,4
hedie,844,2863,774,1963,2679,9123,4
rober,948,3069,664,3252,1190,9123,4
genep,965,2863,1757,3252,285,9122,4
scots,2206,338,1426,1385,3767,9122,4
yonne,225,3069,1757,1391,2679,9121,4
ramal,948,4103,885,2214,971,9121,4
spots,2206,336,1426,1385,3767,9120,4
tamah,1264,4103,885,2214,654,9120,4
keefs,789,2863,1421,278,3767,9118,4
slops,2206,1193,1426,526,3767,9118,4
bahai,1555,4103,334,2214,910,9116,4
kalam,789,4103,1603,2214,406,9115,4
lulie,1046,1824,1603,1963,2679,9115,4
purre,1184,1824,2201,1225,2679,9113,4
smrgs,2206,327,2201,612,3767,9113,4
linne,1046,2239,1757,1391,2679,9112,4
boosy,1555,3069,1426,945,2116,9111,4
ogees,532,139,1421,3252,3767,9111,4
chass,1512,927,1959,945,3767,9110,4
deice,1128,2863,1668,770,2679,9108,4
kiwis,789,2239,349,1963,3767,9107,4
priss,1184,1543,1668,945,3767,9107,4
gayla,965,4103,381,1295,2362,9106,4
koloa,789,3069,1603,1282,2362,9105,4
tahar,1264,4103,334,2214,1190,9105,4
yasna,225,4103,1021,1391,2362,9102,4
melly,1225,2863,1603,1295,2116,9102,4
savvy,2206,4103,417,259,2116,9101,4
leven,1046,2863,417,3252,1522,9100,4
macao,1225,4103,701,2214,857,9100,4
lesed,1046,2863,1021,3252,917,9099,4
scads,2206,338,1959,829,3767,9099,4
waban,596,4103,664,2214,1522,9099,4
rorid,948,3069,2201,1963,917,9098,4
palli,1184,4103,1603,1295,910,9095,4
ships,2206,927,1668,526,3767,9094,4
pasha,1184,4103,1021,423,2362,9093,4
bubos,1555,1824,664,1282,3767,9092,4
genny,965,2863,1757,1391,2116,9092,4
verse,404,2863,2201,945,2679,9092,4
pooly,1184,3069,1426,1295,2116,9090,4
sheet,2206,927,1421,3252,1284,9090,4
hakan,844,4103,406,2214,1522,9089,4
aleen,1698,1193,1421,3252,1522,9086,4
circa,1512,2239,2201,770,2362,9084,4
goose,965,3069,1426,945,2679,9084,4
kamsa,789,4103,885,945,2362,9084,4
valma,404,4103,1603,612,2362,9084,4
leena,1046,2863,1421,1391,2362,9083,4
meggs,1225,2863,616,612,3767,9083,4
bamby,1555,4103,885,423,2116,9082,4
molal,1225,3069,1603,2214,971,9082,4
temne,1264,2863,885,1391,2679,9082,4
reneg,948,2863,1757,3252,261,9081,4
wilie,596,2239,1603,1963,2679,9080,4
zills,176,2239,1603,1295,3767,9080,4
diana,1128,2239,1959,1391,2362,9079,4
solod,2206,3069,1603,1282,917,9077,4
deste,1128,2863,1021,1385,2679,9076,4
renny,948,2863,1757,1391,2116,9075,4
roger,948,3069,616,3252,1190,9075,4
andee,1698,671,774,3252,2679,9074,4
gavra,965,4103,417,1225,2362,9072,4
garmr,965,4103,2201,612,1190,9071,4
nabla,647,4103,664,1295,2362,9071,4
rella,948,2863,1603,1295,2362,9071,4
genin,965,2863,1757,1963,1522,9070,4
kadar,789,4103,774,2214,1190,9070,4
lutts,1046,1824,1048,1385,3767,9070,4
regie,948,2863,616,1963,2679,9069,4
roose,948,3069,1426,945,2679,9067,4
mahar,1225,4103,334,2214,1190,9066,4
tooke,1264,3069,1426,628,2679,9066,4
zooks,176,3069,1426,628,3767,9066,4
latah,1046,4103,1048,2214,654,9065,4
datha,1128,4103,1048,423,2362,9064,4
sesma,2206,2863,1021,612,2362,9064,4
frass,847,1543,1959,945,3767,9061,4
moory,1225,3069,1426,1225,2116,9061,4
bevel,1555,2863,417,3252,971,9058,4
binny,1555,2239,1757,1391,2116,9058,4
gyges,965,458,616,3252,3767,9058,4
jorry,446,3069,2201,1225,2116,9057,4
nolan,647,3069,1603,2214,1522,9055,4
teeny,1264,2863,1421,1391,2116,9055,4
billa,1555,2239,1603,1295,2362,9054,4
cedre,1512,2863,774,1225,2679,9053,4
renin,948,2863,1757,1963,1522,9053,4
fawna,847,4103,349,1391,2362,9052,4
dobbs,1128,3069,664,423,3767,9051,4
shaws,2206,927,1959,192,3767,9051,4
laoag,1046,4103,1426,2214,261,9050,4
orren,532,1543,2201,3252,1522,9050,4
zooms,176,3069,1426,612,3767,9050,4
tiara,1264,2239,1959,1225,2362,9049,4
golly,965,3069,1603,1295,2116,9048,4
loony,1046,3069,1426,1391,2116,9048,4
plass,1184,1193,1959,945,3767,9048,4
valve,404,4103,1603,259,2679,9048,4
maddy,1225,4103,774,829,2116,9047,4
hiips,844,2239,1668,526,3767,9044,4
sully,2206,1824,1603,1295,2116,9044,4
lusts,1046,1824,1021,1385,3767,9043,4
peggs,1184,2863,616,612,3767,9042,4
vinie,404,2239,1757,1963,2679,9042,4
dakar,1128,4103,406,2214,1190,9041,4
mille,1225,2239,1603,1295,2679,9041,4
sikhs,2206,2239,406,423,3767,9041,4
vivas,404,2239,417,2214,3767,9041,4
metre,1225,2863,1048,1225,2679,9040,4
dalli,1128,4103,1603,1295,910,9039,4
piala,1184,2239,1959,1295,2362,9039,4
totem,1264,3069,1048,3252,406,9039,4
dasha,1128,4103,1021,423,2362,9037,4
kasai,789,4103,1021,2214,910,9037,4
corol,1512,3069,2201,1282,971,9035,4
warri,596,4103,2201,1225,910,9035,4
dairi,1128,4103,1668,1225,910,9034,4
dooly,1128,3069,1426,1295,2116,9034,4
sedda,2206,2863,774,829,2362,9034,4
nasua,647,4103,1021,899,2362,9032,4
taunt,1264,4103,990,1391,1284,9032,4
corno,1512,3069,2201,1391,857,9030,4
galax,965,4103,1603,2214,144,9029,4
moosa,1225,3069,1426,945,2362,9027,4
beqaa,1555,2863,32,2214,2362,9026,4
ailin,1698,2239,1603,1963,1522,9025,4
jonna,446,3069,1757,1391,2362,9025,4
booma,1555,3069,1426,612,2362,9024,4
pelew,1184,2863,1603,3252,122,9024,4
reuel,948,2863,990,3252,971,9024,4
teave,1264,2863,1959,259,2679,9024,4
jeeps,446,2863,1421,526,3767,9023,4
jeana,446,2863,1959,1391,2362,9021,4
roper,948,3069,560,3252,1190,9019,4
crocs,1512,1543,1426,770,3767,9018,4
hamal,844,4103,885,2214,971,9017,4
mimus,1225,2239,885,899,3767,9015,4
slobs,2206,1193,1426,423,3767,9015,4
waffs,596,4103,271,278,3767,9015,4
filia,847,2239,1603,1963,2362,9014,4
nenta,647,2863,1757,1385,2362,9014,4
speos,2206,336,1421,1282,3767,9012,4
cilla,1512,2239,1603,1295,2362,9011,4
romeo,948,3069,885,3252,857,9011,4
swots,2206,226,1426,1385,3767,9010,4
kayan,789,4103,381,2214,1522,9009,4
fanni,847,4103,1757,1391,910,9008,4
wists,596,2239,1021,1385,3767,9008,4
tinta,1264,2239,1757,1385,2362,9007,4
kauai,789,4103,990,2214,910,9006,4
paddy,1184,4103,774,829,2116,9006,4
sinon,2206,2239,1757,1282,1522,9006,4
delly,1128,2863,1603,1295,2116,9005,4
hanni,844,4103,1757,1391,910,9005,4
gawra,965,4103,349,1225,2362,9004,4
baggy,1555,4103,616,612,2116,9002,4
lobel,1046,3069,664,3252,971,9002,4
treen,1264,1543,1421,3252,1522,9002,4
puiia,1184,1824,1668,1963,2362,9001,4
joete,446,3069,1421,1385,2679,9000,4
mayme,1225,4103,381,612,2679,9000,4
neter,647,2863,1048,3252,1190,9000,4
heise,844,2863,1668,945,2679,8999,4
petre,1184,2863,1048,1225,2679,8999,4
liana,1046,2239,1959,1391,2362,8997,4
jesus,446,2863,1021,899,3767,8996,4
sheer,2206,927,1421,3252,1190,8996,4
wausa,596,4103,990,945,2362,8996,4
boody,1555,3069,1426,829,2116,8995,4
makua,1225,4103,406,899,2362,8995,4
leste,1046,2863,1021,1385,2679,8994,4
soddy,2206,3069,774,829,2116,8994,4
titer,1264,2239,1048,3252,1190,8993,4
kanab,789,4103,1757,2214,129,8992,4
leola,1046,2863,1426,1295,2362,8992,4
colon,1512,3069,1603,1282,1522,8988,4
meave,1225,2863,1959,259,2679,8985,4
reena,948,2863,1421,1391,2362,8985,4
groos,965,1543,1426,1282,3767,8983,4
natal,647,4103,1048,2214,971,8983,4
dewie,1128,2863,349,1963,2679,8982,4
horah,844,3069,2201,2214,654,8982,4
madid,1225,4103,774,1963,917,8982,4
abats,1698,172,1959,1385,3767,8981,4
veeps,404,2863,1421,526,3767,8981,4
tammy,1264,4103,885,612,2116,8980,4
reeta,948,2863,1421,1385,2362,8979,4
verde,404,2863,2201,829,2679,8976,4
camag,1512,4103,885,2214,261,8975,4
fenny,847,2863,1757,1391,2116,8974,4
minna,1225,2239,1757,1391,2362,8974,4
fatma,847,4103,1048,612,2362,8972,4
henny,844,2863,1757,1391,2116,8971,4
yancy,225,4103,1757,770,2116,8971,4
runer,948,1824,1757,3252,1190,8971,4
fella,847,2863,1603,1295,2362,8970,4
goode,965,3069,1426,829,2679,8968,4
atmas,1698,403,885,2214,3767,8967,4
betty,1555,2863,1048,1385,2116,8967,4
goony,965,3069,1426,1391,2116,8967,4
hagar,844,4103,616,2214,1190,8967,4
leger,1046,2863,616,3252,1190,8967,4
angas,1698,671,616,2214,3767,8966,4
kavla,789,4103,417,1295,2362,8966,4
ursas,420,1543,1021,2214,3767,8965,4
hoose,844,3069,1426,945,2679,8963,4
reget,948,2863,616,3252,1284,8963,4
gusts,965,1824,1021,1385,3767,8962,4
kamal,789,4103,885,2214,971,8962,4
nasda,647,4103,1021,829,2362,8962,4
tahua,1264,4103,334,899,2362,8962,4
kabar,789,4103,664,2214,1190,8960,4
belve,1555,2863,1603,259,2679,8959,4
caggy,1512,4103,616,612,2116,8959,4
suede,2206,1824,1421,829,2679,8959,4
catti,1512,4103,1048,1385,910,8958,4
syncs,2206,458,1757,770,3767,8958,4
nasal,647,4103,1021,2214,971,8956,4
reaal,948,2863,1959,2214,971,8955,4
bossa,1555,3069,1021,945,2362,8952,4
hanno,844,4103,1757,1391,857,8952,4
teaze,1264,2863,1959,186,2679,8951,4
jaban,446,4103,664,2214,1522,8949,4
stags,2206,403,1959,612,3767,8947,4
roede,948,3069,1421,829,2679,8946,4
heths,844,2863,1048,423,3767,8945,4
rusts,948,1824,1021,1385,3767,8945,4
sorgo,2206,3069,2201,612,857,8945,4
dille,1128,2239,1603,1295,2679,8944,4
rooty,948,3069,1426,1385,2116,8944,4
renew,948,2863,1757,3252,122,8942,4
boffs,1555,3069,271,278,3767,8940,4
tress,1264,1543,1421,945,3767,8940,4
denda,1128,2863,1757,829,2362,8939,4
shogs,2206,927,1426,612,3767,8938,4
aller,1698,1193,1603,3252,1190,8936,4
gemel,965,2863,885,3252,971,8936,4
geber,965,2863,664,3252,1190,8934,4
helse,844,2863,1603,945,2679,8934,4
velte,404,2863,1603,1385,2679,8934,4
pinna,1184,2239,1757,1391,2362,8933,4
psoas,1184,341,1426,2214,3767,8932,4
folly,847,3069,1603,1295,2116,8930,4
kayla,789,4103,381,1295,2362,8930,4
rayat,948,4103,381,2214,1284,8930,4
reice,948,2863,1668,770,2679,8928,4
feted,847,2863,1048,3252,917,8927,4
holly,844,3069,1603,1295,2116,8927,4
doped,1128,3069,560,3252,917,8926,4
discs,1128,2239,1021,770,3767,8925,4
matza,1225,4103,1048,186,2362,8924,4
snigs,2206,671,1668,612,3767,8924,4
timet,1264,2239,885,3252,1284,8924,4
heder,844,2863,774,3252,1190,8923,4
mahua,1225,4103,334,899,2362,8923,4
guess,965,1824,1421,945,3767,8922,4
nonce,647,3069,1757,770,2679,8922,4
preen,1184,1543,1421,3252,1522,8922,4
weser,596,2863,1021,3252,1190,8922,4
burry,1555,1824,2201,1225,2116,8921,4
alane,1698,1193,1959,1391,2679,8920,4
deeny,1128,2863,1421,1391,2116,8919,4
sayst,2206,4103,381,945,1284,8919,4
crare,1512,1543,1959,1225,2679,8918,4
tewer,1264,2863,349,3252,1190,8918,4
corri,1512,3069,2201,1225,910,8917,4
trier,1264,1543,1668,3252,1190,8917,4
fence,847,2863,1757,770,2679,8916,4
giana,965,2239,1959,1391,2362,8916,4
kenny,789,2863,1757,1391,2116,8916,4
booze,1555,3069,1426,186,2679,8915,4
alate,1698,1193,1959,1385,2679,8914,4
geste,965,2863,1021,1385,2679,8913,4
hence,844,2863,1757,770,2679,8913,4
kella,789,2863,1603,1295,2362,8912,4
leper,1046,2863,560,3252,1190,8911,4
meyer,1225,2863,381,3252,1190,8911,4
haiti,844,4103,1668,1385,910,8910,4
kafta,789,4103,271,1385,2362,8910,4
lotta,1046,3069,1048,1385,2362,8910,4
halaf,844,4103,1603,2214,145,8909,4
hilel,844,2239,1603,3252,971,8909,4
yente,225,2863,1757,1385,2679,8909,4
aural,1698,1824,2201,2214,971,8908,4
hoggs,844,3069,616,612,3767,8908,4
piete,1184,2239,1421,1385,2679,8908,4
codec,1512,3069,774,3252,300,8907,4
bitte,1555,2239,1048,1385,2679,8906,4
hadal,844,4103,774,2214,971,8906,4
catto,1512,4103,1048,1385,857,8905,4
pulps,1184,1824,1603,526,3767,8904,4
nasca,647,4103,1021,770,2362,8903,4
bamaf,1555,4103,885,2214,145,8902,4
gatha,965,4103,1048,423,2362,8901,4
zanze,176,4103,1757,186,2679,8901,4
hazan,844,4103,217,2214,1522,8900,4
lewie,1046,2863,349,1963,2679,8900,4
mayda,1225,4103,381,829,2362,8900,4
pammy,1184,4103,885,612,2116,8900,4
rabal,948,4103,664,2214,971,8900,4
rodeo,948,3069,774,3252,857,8900,4
zaman,176,4103,885,2214,1522,8900,4
riana,948,2239,1959,1391,2362,8899,4
calci,1512,4103,1603,770,910,8898,4
posse,1184,3069,1021,945,2679,8898,4
blabs,1555,1193,1959,423,3767,8897,4
coffs,1512,3069,271,278,3767,8897,4
vanya,404,4103,1757,271,2362,8897,4
reste,948,2863,1021,1385,2679,8896,4
deady,1128,2863,1959,829,2116,8895,4
testa,1264,2863,1021,1385,2362,8895,4
cicer,1512,2239,701,3252,1190,8894,4
sneds,2206,671,1421,829,3767,8894,4
riata,948,2239,1959,1385,2362,8893,4
staia,2206,403,1959,1963,2362,8893,4
roann,948,3069,1959,1391,1522,8889,4
aouad,1698,3069,990,2214,917,8888,4
deave,1128,2863,1959,259,2679,8888,4
lahar,1046,4103,334,2214,1190,8887,4
areel,1698,1543,1421,3252,971,8885,4
dasya,1128,4103,1021,271,2362,8885,4
jerez,446,2863,2201,3252,122,8884,4
nonly,647,3069,1757,1295,2116,8884,4
ratha,948,4103,1048,423,2362,8884,4
slete,2206,1193,1421,1385,2679,8884,4
bilin,1555,2239,1603,1963,1522,8882,4
loory,1046,3069,1426,1225,2116,8882,4
scags,2206,338,1959,612,3767,8882,4
scams,2206,338,1959,612,3767,8882,4
bless,1555,1193,1421,945,3767,8881,4
aided,1698,2239,774,3252,917,8880,4
attis,1698,403,1048,1963,3767,8879,4
mewer,1225,2863,349,3252,1190,8879,4
curry,1512,1824,2201,1225,2116,8878,4
debel,1128,2863,664,3252,971,8878,4
selli,2206,2863,1603,1295,910,8877,4
aurir,1698,1824,2201,1963,1190,8876,4
galli,965,4103,1603,1295,910,8876,4
rover,948,3069,417,3252,1190,8876,4
azans,1698,59,1959,1391,3767,8874,4
risus,948,2239,1021,899,3767,8874,4
gefen,965,2863,271,3252,1522,8873,4
reune,948,2863,990,1391,2679,8871,4
revie,948,2863,417,1963,2679,8870,4
feued,847,2863,990,3252,917,8869,4
sodio,2206,3069,774,1963,857,8869,4
laddy,1046,4103,774,829,2116,8868,4
fatah,847,4103,1048,2214,654,8866,4
peeoy,1184,2863,1421,1282,2116,8866,4
paolo,1184,4103,1426,1295,857,8865,4
pross,1184,1543,1426,945,3767,8865,4
roker,948,3069,406,3252,1190,8865,4
vacla,404,4103,701,1295,2362,8865,4
lakke,1046,4103,406,628,2679,8862,4
laksa,1046,4103,406,945,2362,8862,4
levet,1046,2863,417,3252,1284,8862,4
dinan,1128,2239,1757,2214,1522,8860,4
gayly,965,4103,381,1295,2116,8860,4
press,1184,1543,1421,945,3767,8860,4
ralli,948,4103,1603,1295,910,8859,4
bezel,1555,2863,217,3252,971,8858,4
diene,1128,2239,1421,1391,2679,8858,4
sleys,2206,1193,1421,271,3767,8858,4
faxan,847,4103,170,2214,1522,8856,4
hajjs,844,4103,81,61,3767,8856,4
zalma,176,4103,1603,612,2362,8856,4
shops,2206,927,1426,526,3767,8852,4
vacoa,404,4103,701,1282,2362,8852,4
ennis,693,671,1757,1963,3767,8851,4
jerry,446,2863,2201,1225,2116,8851,4
dever,1128,2863,417,3252,1190,8850,4
lunel,1046,1824,1757,3252,971,8850,4
nelan,647,2863,1603,2214,1522,8849,4
socii,2206,3069,701,1963,910,8849,4
kamao,789,4103,885,2214,857,8848,4
ailsa,1698,2239,1603,945,2362,8847,4
mahal,1225,4103,334,2214,971,8847,4
herve,844,2863,2201,259,2679,8846,4
japan,446,4103,560,2214,1522,8845,4
kazan,789,4103,217,2214,1522,8845,4
shana,2206,927,1959,1391,2362,8845,4
takao,1264,4103,406,2214,857,8844,4
footy,847,3069,1426,1385,2116,8843,4
keven,789,2863,417,3252,1522,8843,4
motty,1225,3069,1048,1385,2116,8843,4
soord,2206,3069,1426,1225,917,8843,4
bikie,1555,2239,406,1963,2679,8842,4
gelly,965,2863,1603,1295,2116,8842,4
petta,1184,2863,1048,1385,2362,8842,4
oasal,532,4103,1021,2214,971,8841,4
wakan,596,4103,406,2214,1522,8841,4
hooty,844,3069,1426,1385,2116,8840,4
ceric,1512,2863,2201,1963,300,8839,4
snips,2206,671,1668,526,3767,8838,4
murra,1225,1824,2201,1225,2362,8837,4
prier,1184,1543,1668,3252,1190,8837,4
jemie,446,2863,885,1963,2679,8836,4
medle,1225,2863,774,1295,2679,8836,4
sughs,2206,1824,616,423,3767,8836,4
arcae,1698,1543,701,2214,2679,8835,4
cunan,1512,1824,1757,2214,1522,8829,4
glass,965,1193,1959,945,3767,8829,4
gotta,965,3069,1048,1385,2362,8829,4
yanky,225,4103,1757,628,2116,8829,4
shivs,2206,927,1668,259,3767,8827,4
keena,789,2863,1421,1391,2362,8826,4
namda,647,4103,885,829,2362,8826,4
relly,948,2863,1603,1295,2116,8825,4
sutta,2206,1824,1048,1385,2362,8825,4
arase,1698,1543,1959,945,2679,8824,4
sello,2206,2863,1603,1295,857,8824,4
absee,1698,172,1021,3252,2679,8822,4
jagla,446,4103,616,1295,2362,8822,4
pesek,1184,2863,1021,3252,502,8822,4
zolle,176,3069,1603,1295,2679,8822,4
bacau,1555,4103,701,2214,247,8820,4
rafat,948,4103,271,2214,1284,8820,4
fuzee,847,1824,217,3252,2679,8819,4
jenna,446,2863,1757,1391,2362,8819,4
lamba,1046,4103,885,423,2362,8819,4
cabby,1512,4103,664,423,2116,8818,4
cappy,1512,4103,560,526,2116,8817,4
ruler,948,1824,1603,3252,1190,8817,4
xoana,36,3069,1959,1391,2362,8817,4
eagar,693,4103,616,2214,1190,8816,4
rappe,948,4103,560,526,2679,8816,4
wayan,596,4103,381,2214,1522,8816,4
macha,1225,4103,701,423,2362,8814,4
besew,1555,2863,1021,3252,122,8813,4
heber,844,2863,664,3252,1190,8813,4
rotta,948,3069,1048,1385,2362,8812,4
brana,1555,1543,1959,1391,2362,8810,4
civie,1512,2239,417,1963,2679,8810,4
conor,1512,3069,1757,1282,1190,8810,4
eunet,693,1824,1757,3252,1284,8810,4
dross,1128,1543,1426,945,3767,8809,4
peery,1184,2863,1421,1225,2116,8809,4
verry,404,2863,2201,1225,2116,8809,4
billy,1555,2239,1603,1295,2116,8808,4
rower,948,3069,349,3252,1190,8808,4
didus,1128,2239,774,899,3767,8807,4
leave,1046,2863,1959,259,2679,8806,4
surtr,2206,1824,2201,1385,1190,8806,4
dress,1128,1543,1421,945,3767,8804,4
ramah,948,4103,885,2214,654,8804,4
sieve,2206,2239,1421,259,2679,8804,4
steen,2206,403,1421,3252,1522,8804,4
dexie,1128,2863,170,1963,2679,8803,4
potty,1184,3069,1048,1385,2116,8802,4
binit,1555,2239,1757,1963,1284,8798,4
curua,1512,1824,2201,899,2362,8798,4
defet,1128,2863,271,3252,1284,8798,4
dayal,1128,4103,381,2214,971,8797,4
canch,1512,4103,1757,770,654,8796,4
busks,1555,1824,1021,628,3767,8795,4
feste,847,2863,1021,1385,2679,8795,4
snaws,2206,671,1959,192,3767,8795,4
booky,1555,3069,1426,628,2116,8794,4
annus,1698,671,1757,899,3767,8792,4
cooba,1512,3069,1426,423,2362,8792,4
kelep,789,2863,1603,3252,285,8792,4
kerve,789,2863,2201,259,2679,8791,4
mimer,1225,2239,885,3252,1190,8791,4
zoara,176,3069,1959,1225,2362,8791,4
kadai,789,4103,774,2214,910,8790,4
varro,404,4103,2201,1225,857,8790,4
biggs,1555,2239,616,612,3767,8789,4
agars,1698,139,1959,1225,3767,8788,4
natka,647,4103,1048,628,2362,8788,4
susan,2206,1824,1021,2214,1522,8787,4
detta,1128,2863,1048,1385,2362,8786,4
apsis,1698,336,1021,1963,3767,8785,4
slows,2206,1193,1426,192,3767,8784,4
disks,1128,2239,1021,628,3767,8783,4
haerr,844,4103,1421,1225,1190,8783,4
dewer,1128,2863,349,3252,1190,8782,4
drier,1128,1543,1668,3252,1190,8781,4
leann,1046,2863,1959,1391,1522,8781,4
dunne,1128,1824,1757,1391,2679,8779,4
jonny,446,3069,1757,1391,2116,8779,4
lehet,1046,2863,334,3252,1284,8779,4
slews,2206,1193,1421,192,3767,8779,4
boogy,1555,3069,1426,612,2116,8778,4
boomy,1555,3069,1426,612,2116,8778,4
sheel,2206,927,1421,3252,971,8777,4
avars,1698,126,1959,1225,3767,8775,4
jolla,446,3069,1603,1295,2362,8775,4
bocce,1555,3069,701,770,2679,8774,4
depel,1128,2863,560,3252,971,8774,4
beyle,1555,2863,381,1295,2679,8773,4
pacha,1184,4103,701,423,2362,8773,4
henke,844,2863,1757,628,2679,8771,4
waadt,596,4103,1959,829,1284,8771,4
feune,847,2863,990,1391,2679,8770,4
friss,847,1543,1668,945,3767,8770,4
lazar,1046,4103,217,2214,1190,8770,4
nella,647,2863,1603,1295,2362,8770,4
raddy,948,4103,774,829,2116,8770,4
swags,2206,226,1959,612,3767,8770,4
annie,1698,671,1757,1963,2679,8768,4
lever,1046,2863,417,3252,1190,8768,4
slugs,2206,1193,990,612,3767,8768,4
slums,2206,1193,990,612,3767,8768,4
cocin,1512,3069,701,1963,1522,8767,4
hobbs,844,3069,664,423,3767,8767,4
timms,1264,2239,885,612,3767,8767,4
tinny,1264,2239,1757,1391,2116,8767,4
eneas,693,671,1421,2214,3767,8766,4
noose,647,3069,1426,945,2679,8766,4
heger,844,2863,616,3252,1190,8765,4
feute,847,2863,990,1385,2679,8764,4
revet,948,2863,417,3252,1284,8764,4
rille,948,2239,1603,1295,2679,8764,4
mutus,1225,1824,1048,899,3767,8763,4
tilla,1264,2239,1603,1295,2362,8763,4
geode,965,2863,1426,829,2679,8762,4
lammy,1046,4103,885,612,2116,8762,4
tetra,1264,2863,1048,1225,2362,8762,4
tinty,1264,2239,1757,1385,2116,8761,4
laang,1046,4103,1959,1391,261,8760,4
losse,1046,3069,1021,945,2679,8760,4
verge,404,2863,2201,612,2679,8759,4
stabs,2206,403,1959,423,3767,8758,4
comme,1512,3069,885,612,2679,8757,4
pliss,1184,1193,1668,945,3767,8757,4
stuns,2206,403,990,1391,3767,8757,4
veter,404,2863,1048,3252,1190,8757,4
skers,2206,137,1421,1225,3767,8756,4
halli,844,4103,1603,1295,910,8755,4
henge,844,2863,1757,612,2679,8755,4
lovel,1046,3069,417,3252,971,8755,4
rexen,948,2863,170,3252,1522,8755,4
berri,1555,2863,2201,1225,910,8754,4
daisi,1128,4103,1668,945,910,8754,4
eiten,693,2239,1048,3252,1522,8754,4
deery,1128,2863,1421,1225,2116,8753,4
edrea,693,245,2201,3252,2362,8753,4
cusks,1512,1824,1021,628,3767,8752,4
jagra,446,4103,616,1225,2362,8752,4
cooky,1512,3069,1426,628,2116,8751,4
hache,844,4103,701,423,2679,8750,4
hooly,844,3069,1426,1295,2116,8750,4
rooke,948,3069,1426,628,2679,8750,4
roosa,948,3069,1426,945,2362,8750,4
shala,2206,927,1959,1295,2362,8749,4
kecks,789,2863,701,628,3767,8748,4
harsh,844,4103,2201,945,654,8747,4
yemen,225,2863,885,3252,1522,8747,4
spics,2206,336,1668,770,3767,8747,4
dotty,1128,3069,1048,1385,2116,8746,4
loope,1046,3069,1426,526,2679,8746,4
durra,1128,1824,2201,1225,2362,8740,4
sneer,2206,671,1421,3252,1190,8740,4
sooth,2206,3069,1426,1385,654,8740,4
gamba,965,4103,885,423,2362,8738,4
bided,1555,2239,774,3252,917,8737,4
nelse,647,2863,1603,945,2679,8737,4
speen,2206,336,1421,3252,1522,8737,4
vonny,404,3069,1757,1391,2116,8737,4
mazda,1225,4103,217,829,2362,8736,4
coomy,1512,3069,1426,612,2116,8735,4
snibs,2206,671,1668,423,3767,8735,4
matax,1225,4103,1048,2214,144,8734,4
arene,1698,1543,1421,1391,2679,8732,4
seeto,2206,2863,1421,1385,857,8732,4
arter,1698,1543,1048,3252,1190,8731,4
laxly,1046,4103,170,1295,2116,8730,4
nolly,647,3069,1603,1295,2116,8730,4
minny,1225,2239,1757,1391,2116,8728,4
eisen,693,2239,1021,3252,1522,8727,4
eques,693,25,990,3252,3767,8727,4
orlos,532,1543,1603,1282,3767,8727,4
arete,1698,1543,1421,1385,2679,8726,4
modem,1225,3069,774,3252,406,8726,4
katha,789,4103,1048,423,2362,8725,4
vinia,404,2239,1757,1963,2362,8725,4
felly,847,2863,1603,1295,2116,8724,4
milla,1225,2239,1603,1295,2362,8724,4
wende,596,2863,1757,829,2679,8724,4
bocoy,1555,3069,701,1282,2116,8723,4
wenny,596,2863,1757,1391,2116,8723,4
afars,1698,73,1959,1225,3767,8722,4
bejel,1555,2863,81,3252,971,8722,4
gadid,965,4103,774,1963,917,8722,4
helly,844,2863,1603,1295,2116,8721,4
lexie,1046,2863,170,1963,2679,8721,4
davao,1128,4103,417,2214,857,8719,4
uaupe,420,4103,990,526,2679,8718,4
dacha,1128,4103,701,423,2362,8717,4
dowed,1128,3069,349,3252,917,8715,4
kirin,789,2239,2201,1963,1522,8714,4
habbe,844,4103,664,423,2679,8713,4
vasal,404,4103,1021,2214,971,8713,4
kriss,789,1543,1668,945,3767,8712,4
noggs,647,3069,616,612,3767,8711,4
taggy,1264,4103,616,612,2116,8711,4
hotta,844,3069,1048,1385,2362,8708,4
reave,948,2863,1959,259,2679,8708,4
arany,1698,1543,1959,1391,2116,8707,4
shieh,2206,927,1668,3252,654,8707,4
ankee,1698,671,406,3252,2679,8706,4
bossy,1555,3069,1021,945,2116,8706,4
defer,1128,2863,271,3252,1190,8704,4
letta,1046,2863,1048,1385,2362,8704,4
agmas,1698,139,885,2214,3767,8703,4
green,965,1543,1421,3252,1522,8703,4
tibet,1264,2239,664,3252,1284,8703,4
hallo,844,4103,1603,1295,857,8702,4
javan,446,4103,417,2214,1522,8702,4
meuse,1225,2863,990,945,2679,8702,4
porno,1184,3069,2201,1391,857,8702,4
lidie,1046,2239,774,1963,2679,8701,4
kalli,789,4103,1603,1295,910,8700,4
creel,1512,1543,1421,3252,971,8699,4
tewel,1264,2863,349,3252,971,8699,4
hewie,844,2863,349,1963,2679,8698,4
kasha,789,4103,1021,423,2362,8698,4
radii,948,4103,774,1963,910,8698,4
rebel,948,2863,664,3252,971,8698,4
rinna,948,2239,1757,1391,2362,8697,4
porto,1184,3069,2201,1385,857,8696,4
rewet,948,2863,349,3252,1284,8696,4
aquas,1698,25,990,2214,3767,8694,4
scabs,2206,338,1959,423,3767,8693,4
begem,1555,2863,616,3252,406,8692,4
sacci,2206,4103,701,770,910,8690,4
neona,647,2863,1426,1391,2362,8689,4
piasa,1184,2239,1959,945,2362,8689,4
breed,1555,1543,1421,3252,917,8688,4
tenon,1264,2863,1757,1282,1522,8688,4
hagai,844,4103,616,2214,910,8687,4
pinny,1184,2239,1757,1391,2116,8687,4
scuts,2206,338,990,1385,3767,8686,4
arain,1698,1543,1959,1963,1522,8685,4
mamor,1225,4103,885,1282,1190,8685,4
swaps,2206,226,1959,526,3767,8684,4
bonni,1555,3069,1757,1391,910,8682,4
heike,844,2863,1668,628,2679,8682,4
snogs,2206,671,1426,612,3767,8682,4
gammy,965,4103,885,612,2116,8681,4
nisen,647,2239,1021,3252,1522,8681,4
skags,2206,137,1959,612,3767,8681,4
gosse,965,3069,1021,945,2679,8679,4
shara,2206,927,1959,1225,2362,8679,4
wolly,596,3069,1603,1295,2116,8679,4
ifree,473,73,2201,3252,2679,8678,4
polio,1184,3069,1603,1963,857,8676,4
smuts,2206,327,990,1385,3767,8675,4
teiid,1264,2863,1668,1963,917,8675,4
maggy,1225,4103,616,612,2116,8672,4
leery,1046,2863,1421,1225,2116,8671,4
matti,1225,4103,1048,1385,910,8671,4
ambas,1698,327,664,2214,3767,8670,4
faddy,847,4103,774,829,2116,8669,4
pooka,1184,3069,1426,628,2362,8669,4
tofte,1264,3069,271,1385,2679,8668,4
urdee,420,1543,774,3252,2679,8668,4
papio,1184,4103,560,1963,857,8667,4
kelly,789,2863,1603,1295,2116,8666,4
moody,1225,3069,1426,829,2116,8665,4
tulle,1264,1824,1603,1295,2679,8665,4
lotty,1046,3069,1048,1385,2116,8664,4
nonda,647,3069,1757,829,2362,8664,4
rammy,948,4103,885,612,2116,8664,4
repps,948,2863,560,526,3767,8664,4
fille,847,2239,1603,1295,2679,8663,4
jagat,446,4103,616,2214,1284,8663,4
annet,1698,671,1757,3252,1284,8662,4
rosse,948,3069,1021,945,2679,8662,4
winne,596,2239,1757,1391,2679,8662,4
noxen,647,3069,170,3252,1522,8660,4
taqua,1264,4103,32,899,2362,8660,4
bayam,1555,4103,381,2214,406,8659,4
noded,647,3069,774,3252,917,8659,4
cerro,1512,2863,2201,1225,857,8658,4
kappe,789,4103,560,526,2679,8657,4
arita,1698,1543,1668,1385,2362,8656,4
behre,1555,2863,334,1225,2679,8656,4
color,1512,3069,1603,1282,1190,8656,4
kotta,789,3069,1048,1385,2362,8653,4
ratwa,948,4103,1048,192,2362,8653,4
cycas,1512,458,701,2214,3767,8652,4
jalap,446,4103,1603,2214,285,8651,4
sisal,2206,2239,1021,2214,971,8651,4
cusps,1512,1824,1021,526,3767,8650,4
regel,948,2863,616,3252,971,8650,4
riser,948,2239,1021,3252,1190,8650,4
arace,1698,1543,1959,770,2679,8649,4
idris,473,245,2201,1963,3767,8649,4
menon,1225,2863,1757,1282,1522,8649,4
nerve,647,2863,2201,259,2679,8649,4
testy,1264,2863,1021,1385,2116,8649,4
toffs,1264,3069,271,278,3767,8649,4
qatar,93,4103,1048,2214,1190,8648,4
cenac,1512,2863,1757,2214,300,8646,4
gafsa,965,4103,271,945,2362,8646,4
gross,965,1543,1426,945,3767,8646,4
hooke,844,3069,1426,628,2679,8646,4
arian,1698,1543,1668,2214,1522,8645,4
creed,1512,1543,1421,3252,917,8645,4
pepys,1184,2863,560,271,3767,8645,4
tewed,1264,2863,349,3252,917,8645,4
chics,1512,927,1668,770,3767,8644,4
fiscs,847,2239,1021,770,3767,8644,4
yaffs,225,4103,271,278,3767,8644,4
rebed,948,2863,664,3252,917,8644,4
beall,1555,2863,1959,1295,971,8643,4
bunny,1555,1824,1757,1391,2116,8643,4
bulla,1555,1824,1603,1295,2362,8639,4
conni,1512,3069,1757,1391,910,8639,4
mocoa,1225,3069,701,1282,2362,8639,4
oesel,532,2863,1021,3252,971,8639,4
leesa,1046,2863,1421,945,2362,8637,4
metty,1225,2863,1048,1385,2116,8637,4
oenin,532,2863,1757,1963,1522,8637,4
sacco,2206,4103,701,770,857,8637,4
temse,1264,2863,885,945,2679,8636,4
ernie,693,1543,1757,1963,2679,8635,4
weide,596,2863,1668,829,2679,8635,4
gayal,965,4103,381,2214,971,8634,4
yeara,225,2863,1959,1225,2362,8634,4
jawan,446,4103,349,2214,1522,8634,4
state,2206,403,1959,1385,2679,8632,4
devel,1128,2863,417,3252,971,8631,4
dinny,1128,2239,1757,1391,2116,8631,4
jassy,446,4103,1021,945,2116,8631,4
hooge,844,3069,1426,612,2679,8630,4
kahar,789,4103,334,2214,1190,8630,4
patti,1184,4103,1048,1385,910,8630,4
firry,847,2239,2201,1225,2116,8628,4
senso,2206,2863,1757,945,857,8628,4
atria,1698,403,2201,1963,2362,8627,4
smous,2206,327,1426,899,3767,8625,4
nunks,647,1824,1757,628,3767,8623,4
terti,1264,2863,2201,1385,910,8623,4
wirra,596,2239,2201,1225,2362,8623,4
lawai,1046,4103,349,2214,910,8622,4
absis,1698,172,1021,1963,3767,8621,4
bunin,1555,1824,1757,1963,1522,8621,4
jamal,446,4103,885,2214,971,8619,4
soggy,2206,3069,616,612,2116,8619,4
grier,965,1543,1668,3252,1190,8618,4
poove,1184,3069,1426,259,2679,8617,4
gunne,965,1824,1757,1391,2679,8616,4
baham,1555,4103,334,2214,406,8612,4
bombe,1555,3069,885,423,2679,8611,4
cacti,1512,4103,701,1385,910,8611,4
radha,948,4103,774,423,2362,8610,4
raash,948,4103,1959,945,654,8609,4
skids,2206,137,1668,829,3767,8607,4
tilty,1264,2239,1603,1385,2116,8607,4
mewed,1225,2863,349,3252,917,8606,4
stays,2206,403,1959,271,3767,8606,4
spiks,2206,336,1668,628,3767,8605,4
dolon,1128,3069,1603,1282,1522,8604,4
heave,844,2863,1959,259,2679,8604,4
risks,948,2239,1021,628,3767,8603,4
makah,1225,4103,406,2214,654,8602,4
venue,404,2863,1757,899,2679,8602,4
conic,1512,3069,1757,1963,300,8601,4
helge,844,2863,1603,612,2679,8601,4
pimps,1184,2239,885,526,3767,8601,4
twats,1264,226,1959,1385,3767,8601,4
cunny,1512,1824,1757,1391,2116,8600,4
lisps,1046,2239,1021,526,3767,8599,4
nabal,647,4103,664,2214,971,8599,4
joola,446,3069,1426,1295,2362,8598,4
tunna,1264,1824,1757,1391,2362,8598,4
wadai,596,4103,774,2214,910,8597,4
culla,1512,1824,1603,1295,2362,8596,4
petty,1184,2863,1048,1385,2116,8596,4
teart,1264,2863,1959,1225,1284,8595,4
coact,1512,3069,1959,770,1284,8594,4
hebel,844,2863,664,3252,971,8594,4
oadal,532,4103,774,2214,971,8594,4
repel,948,2863,560,3252,971,8594,4
hewet,844,2863,349,3252,1284,8592,4
niata,647,2239,1959,1385,2362,8592,4
murry,1225,1824,2201,1225,2116,8591,4
cocke,1512,3069,701,628,2679,8589,4
kokia,789,3069,406,1963,2362,8589,4
neela,647,2863,1421,1295,2362,8588,4
quass,93,1824,1959,945,3767,8588,4
freen,847,1543,1421,3252,1522,8585,4
corso,1512,3069,2201,945,857,8584,4
dozed,1128,3069,217,3252,917,8583,4
rabah,948,4103,664,2214,654,8583,4
luana,1046,1824,1959,1391,2362,8582,4
yenan,225,2863,1757,2214,1522,8581,4
swabs,2206,226,1959,423,3767,8581,4
arlan,1698,1543,1603,2214,1522,8580,4
bebat,1555,2863,664,2214,1284,8580,4
conto,1512,3069,1757,1385,857,8580,4
peize,1184,2863,1668,186,2679,8580,4
slubs,2206,1193,990,423,3767,8579,4
madag,1225,4103,774,2214,261,8577,4
vedet,404,2863,774,3252,1284,8577,4
kapai,789,4103,560,2214,910,8576,4
sotol,2206,3069,1048,1282,971,8576,4
babol,1555,4103,664,1282,971,8575,4
daggy,1128,4103,616,612,2116,8575,4
nason,647,4103,1021,1282,1522,8575,4
tecta,1264,2863,701,1385,2362,8575,4
sleek,2206,1193,1421,3252,502,8574,4
edges,693,245,616,3252,3767,8573,4
jenny,446,2863,1757,1391,2116,8573,4
katya,789,4103,1048,271,2362,8573,4
nisus,647,2239,1021,899,3767,8573,4
chess,1512,927,1421,945,3767,8572,4
navar,647,4103,417,2214,1190,8571,4
rahal,948,4103,334,2214,971,8570,4
tabby,1264,4103,664,423,2116,8570,4
fever,847,2863,417,3252,1190,8569,4
kerak,789,2863,2201,2214,502,8569,4
armer,1698,1543,885,3252,1190,8568,4
bethe,1555,2863,1048,423,2679,8568,4
duala,1128,1824,1959,1295,2362,8568,4
neger,647,2863,616,3252,1190,8568,4
tezel,1264,2863,217,3252,971,8567,4
ampas,1698,327,560,2214,3767,8566,4
bedew,1555,2863,774,3252,122,8566,4
iulus,473,1824,1603,899,3767,8566,4
total,1264,3069,1048,2214,971,8566,4
vanni,404,4103,1757,1391,910,8565,4
weber,596,2863,664,3252,1190,8565,4
soldo,2206,3069,1603,829,857,8564,4
euler,693,1824,1603,3252,1190,8562,4
kamba,789,4103,885,423,2362,8562,4
fosse,847,3069,1021,945,2679,8561,4
hammy,844,4103,885,612,2116,8560,4
boort,1555,3069,1426,1225,1284,8559,4
taimi,1264,4103,1668,612,910,8557,4
tsars,1264,341,1959,1225,3767,8556,4
grigs,965,1543,1668,612,3767,8555,4
latax,1046,4103,1048,2214,144,8555,4
fatwa,847,4103,1048,192,2362,8552,4
fiefs,847,2239,1421,278,3767,8552,4
jenin,446,2863,1757,1963,1522,8551,4
purry,1184,1824,2201,1225,2116,8550,4
hegel,844,2863,616,3252,971,8546,4
mirid,1225,2239,2201,1963,917,8545,4
tabac,1264,4103,664,2214,300,8545,4
weste,596,2863,1021,1385,2679,8544,4
paull,1184,4103,990,1295,971,8543,4
uella,420,2863,1603,1295,2362,8543,4
feely,847,2863,1421,1295,2116,8542,4
aamsi,1698,4103,885,945,910,8541,4
balbo,1555,4103,1603,423,857,8541,4
crete,1512,1543,1421,1385,2679,8540,4
toano,1264,3069,1959,1391,857,8540,4
julus,446,1824,1603,899,3767,8539,4
spays,2206,336,1959,271,3767,8539,4
trite,1264,1543,1668,1385,2679,8539,4
gliss,965,1193,1668,945,3767,8538,4
hoboe,844,3069,664,1282,2679,8538,4
kinna,789,2239,1757,1391,2362,8538,4
skeen,2206,137,1421,3252,1522,8538,4
detat,1128,2863,1048,2214,1284,8537,4
nayar,647,4103,381,2214,1190,8535,4
bassi,1555,4103,1021,945,910,8534,4
boito,1555,3069,1668,1385,857,8534,4
feaze,847,2863,1959,186,2679,8534,4
capax,1512,4103,560,2214,144,8533,4
dorri,1128,3069,2201,1225,910,8533,4
feyer,847,2863,381,3252,1190,8533,4
allys,1698,1193,1603,271,3767,8532,4
delve,1128,2863,1603,259,2679,8532,4
watha,596,4103,1048,423,2362,8532,4
heyer,844,2863,381,3252,1190,8530,4
mappy,1225,4103,560,526,2116,8530,4
zabra,176,4103,664,1225,2362,8530,4
barbu,1555,4103,2201,423,247,8529,4
jolly,446,3069,1603,1295,2116,8529,4
ousts,532,1824,1021,1385,3767,8529,4
david,1128,4103,417,1963,917,8528,4
macap,1225,4103,701,2214,285,8528,4
vella,404,2863,1603,1295,2362,8527,4
dawdy,1128,4103,349,829,2116,8525,4
title,1264,2239,1048,1295,2679,8525,4
vegie,404,2863,616,1963,2679,8525,4
nelly,647,2863,1603,1295,2116,8524,4
spurs,2206,336,990,1225,3767,8524,4
fress,847,1543,1421,945,3767,8523,4
nampa,647,4103,885,526,2362,8523,4
amacs,1698,327,1959,770,3767,8521,4
datto,1128,4103,1048,1385,857,8521,4
goosy,965,3069,1426,945,2116,8521,4
toast,1264,3069,1959,945,1284,8521,4
pipet,1184,2239,560,3252,1284,8519,4
benab,1555,2863,1757,2214,129,8518,4
mimed,1225,2239,885,3252,917,8518,4
shows,2206,927,1426,192,3767,8518,4
retem,948,2863,1048,3252,406,8517,4
seppa,2206,2863,560,526,2362,8517,4
tilly,1264,2239,1603,1295,2116,8517,4
fayal,847,4103,381,2214,971,8516,4
nappe,647,4103,560,526,2679,8515,4
neron,647,2863,2201,1282,1522,8515,4
ploss,1184,1193,1426,945,3767,8515,4
beent,1555,2863,1421,1391,1284,8514,4
rimer,948,2239,885,3252,1190,8514,4
doffs,1128,3069,271,278,3767,8513,4
shews,2206,927,1421,192,3767,8513,4
waasi,596,4103,1959,945,910,8513,4
mikie,1225,2239,406,1963,2679,8512,4
neper,647,2863,560,3252,1190,8512,4
tallu,1264,4103,1603,1295,247,8512,4
kever,789,2863,417,3252,1190,8511,4
pilin,1184,2239,1603,1963,1522,8511,4
tufts,1264,1824,271,1385,3767,8511,4
tomme,1264,3069,885,612,2679,8509,4
truss,1264,1543,990,945,3767,8509,4
venin,404,2863,1757,1963,1522,8509,4
dried,1128,1543,1668,3252,917,8508,4
arake,1698,1543,1959,628,2679,8507,4
hashy,844,4103,1021,423,2116,8507,4
walli,596,4103,1603,1295,910,8507,4
tusks,1264,1824,1021,628,3767,8504,4
kosse,789,3069,1021,945,2679,8503,4
wooly,596,3069,1426,1295,2116,8502,4
dedan,1128,2863,774,2214,1522,8501,4
fewer,847,2863,349,3252,1190,8501,4
guana,965,1824,1959,1391,2362,8501,4
newie,647,2863,349,1963,2679,8501,4
punan,1184,1824,1757,2214,1522,8501,4
songo,2206,3069,1757,612,857,8501,4
bessy,1555,2863,1021,945,2116,8500,4
frier,847,1543,1668,3252,1190,8500,4
notan,647,3069,1048,2214,1522,8500,4
specs,2206,336,1421,770,3767,8500,4
bilbe,1555,2239,1603,423,2679,8499,4
hidie,844,2239,774,1963,2679,8499,4
usnas,420,341,1757,2214,3767,8499,4
hewer,844,2863,349,3252,1190,8498,4
napal,647,4103,560,2214,971,8495,4
durry,1128,1824,2201,1225,2116,8494,4
civia,1512,2239,417,1963,2362,8493,4
snobs,2206,671,1426,423,3767,8493,4
tibia,1264,2239,664,1963,2362,8492,4
arage,1698,1543,1959,612,2679,8491,4
butte,1555,1824,1048,1385,2679,8491,4
cassi,1512,4103,1021,945,910,8491,4
macau,1225,4103,701,2214,247,8490,4
ermey,693,1543,885,3252,2116,8489,4
gezer,965,2863,217,3252,1190,8487,4
bebar,1555,2863,664,2214,1190,8486,4
alcae,1698,1193,701,2214,2679,8485,4
buber,1555,1824,664,3252,1190,8485,4
kiaat,789,2239,1959,2214,1284,8485,4
keely,789,2863,1421,1295,2116,8484,4
ruana,948,1824,1959,1391,2362,8484,4
keawe,789,2863,1959,192,2679,8482,4
basso,1555,4103,1021,945,857,8481,4
roric,948,3069,2201,1963,300,8481,4
swigs,2206,226,1668,612,3767,8479,4
swims,2206,226,1668,612,3767,8479,4
milly,1225,2239,1603,1295,2116,8478,4
slily,2206,1193,1668,1295,2116,8478,4
sobby,2206,3069,664,423,2116,8478,4
hakai,844,4103,406,2214,910,8477,4
soppy,2206,3069,560,526,2116,8477,4
benni,1555,2863,1757,1391,910,8476,4
kirit,789,2239,2201,1963,1284,8476,4
keyer,789,2863,381,3252,1190,8475,4
welly,596,2863,1603,1295,2116,8473,4
hecte,844,2863,701,1385,2679,8472,4
steer,2206,403,1421,3252,1190,8472,4
taipi,1264,4103,1668,526,910,8471,4
yakan,225,4103,406,2214,1522,8470,4
loeil,1046,3069,1421,1963,971,8470,4
adria,1698,245,2201,1963,2362,8469,4
vacua,404,4103,701,899,2362,8469,4
ginny,965,2239,1757,1391,2116,8468,4
moorn,1225,3069,1426,1225,1522,8467,4
sneed,2206,671,1421,3252,917,8467,4
greet,965,1543,1421,3252,1284,8465,4
kress,789,1543,1421,945,3767,8465,4
menam,1225,2863,1757,2214,406,8465,4
musks,1225,1824,1021,628,3767,8465,4
sinic,2206,2239,1757,1963,300,8465,4
doand,1128,3069,1959,1391,917,8464,4
terri,1264,2863,2201,1225,910,8463,4
pupae,1184,1824,560,2214,2679,8461,4
miggs,1225,2239,616,612,3767,8459,4
genii,965,2863,1757,1963,910,8458,4
letty,1046,2863,1048,1385,2116,8458,4
mimeo,1225,2239,885,3252,857,8458,4
shere,2206,927,1421,1225,2679,8458,4
arder,1698,1543,774,3252,1190,8457,4
bocca,1555,3069,701,770,2362,8457,4
zadar,176,4103,774,2214,1190,8457,4
wedel,596,2863,774,3252,971,8456,4
tessa,1264,2863,1021,945,2362,8455,4
titre,1264,2239,1048,1225,2679,8455,4
wesle,596,2863,1021,1295,2679,8454,4
lorri,1046,3069,2201,1225,910,8451,4
revel,948,2863,417,3252,971,8451,4
wezen,596,2863,217,3252,1522,8450,4
boson,1555,3069,1021,1282,1522,8449,4
tazze,1264,4103,217,186,2679,8449,4
addis,1698,245,774,1963,3767,8447,4
aidan,1698,2239,774,2214,1522,8447,4
colic,1512,3069,1603,1963,300,8447,4
props,1184,1543,1426,526,3767,8446,4
tided,1264,2239,774,3252,917,8446,4
yelek,225,2863,1603,3252,502,8445,4
justs,446,1824,1021,1385,3767,8443,4
lossa,1046,3069,1021,945,2362,8443,4
teffs,1264,2863,271,278,3767,8443,4
olios,532,1193,1668,1282,3767,8442,4
preps,1184,1543,1421,526,3767,8441,4
veena,404,2863,1421,1391,2362,8441,4
comma,1512,3069,885,612,2362,8440,4
prana,1184,1543,1959,1391,2362,8439,4
rrhea,948,1543,334,3252,2362,8439,4
jacal,446,4103,701,2214,971,8435,4
dabby,1128,4103,664,423,2116,8434,4
gooma,965,3069,1426,612,2362,8434,4
mysis,1225,458,1021,1963,3767,8434,4
rerun,948,2863,2201,899,1522,8433,4
bible,1555,2239,664,1295,2679,8432,4
pallu,1184,4103,1603,1295,247,8432,4
cooja,1512,3069,1426,61,2362,8430,4
deuce,1128,2863,990,770,2679,8430,4
sqlds,2206,25,1603,829,3767,8430,4
pomme,1184,3069,885,612,2679,8429,4
pruss,1184,1543,990,945,3767,8429,4
sohio,2206,3069,334,1963,857,8429,4
sways,2206,226,1959,271,3767,8429,4
donor,1128,3069,1757,1282,1190,8426,4
jagua,446,4103,616,899,2362,8426,4
piper,1184,2239,560,3252,1190,8425,4
reuse,948,2863,990,945,2679,8425,4
merri,1225,2863,2201,1225,910,8424,4
zoona,176,3069,1426,1391,2362,8424,4
kiele,789,2239,1421,1295,2679,8423,4
reeda,948,2863,1421,829,2362,8423,4
tdrss,1264,245,2201,945,3767,8422,4
avgas,1698,126,616,2214,3767,8421,4
arona,1698,1543,1426,1391,2362,8420,4
awacs,1698,226,1959,770,3767,8420,4
naoto,647,4103,1426,1385,857,8418,4
waddy,596,4103,774,829,2116,8418,4
fhrer,847,927,2201,3252,1190,8417,4
reive,948,2863,1668,259,2679,8417,4
areek,1698,1543,1421,3252,502,8416,4
mucus,1225,1824,701,899,3767,8416,4
arena,1698,1543,1421,1391,2362,8415,4
naunt,647,4103,990,1391,1284,8415,4
tossy,1264,3069,1021,945,2116,8415,4
pekoe,1184,2863,406,1282,2679,8414,4
bevue,1555,2863,417,899,2679,8413,4
seggy,2206,2863,616,612,2116,8413,4
lurry,1046,1824,2201,1225,2116,8412,4
wevet,596,2863,417,3252,1284,8412,4
babur,1555,4103,664,899,1190,8411,4
sobor,2206,3069,664,1282,1190,8411,4
irbis,473,1543,664,1963,3767,8410,4
resue,948,2863,1021,899,2679,8410,4
areta,1698,1543,1421,1385,2362,8409,4
stems,2206,403,1421,612,3767,8409,4
desex,1128,2863,1021,3252,144,8408,4
hirai,844,2239,2201,2214,910,8408,4
loewe,1046,3069,1421,192,2679,8407,4
skeie,2206,137,1421,1963,2679,8406,4
amiss,1698,327,1668,945,3767,8405,4
cacur,1512,4103,701,899,1190,8405,4
goody,965,3069,1426,829,2116,8405,4
katik,789,4103,1048,1963,502,8405,4
speer,2206,336,1421,3252,1190,8405,4
nasya,647,4103,1021,271,2362,8404,4
rider,948,2239,774,3252,1190,8403,4
abray,1698,172,2201,2214,2116,8401,4
regle,948,2863,616,1295,2679,8401,4
algae,1698,1193,616,2214,2679,8400,4
malmo,1225,4103,1603,612,857,8400,4
saiff,2206,4103,1668,278,145,8400,4
majka,1225,4103,81,628,2362,8399,4
arean,1698,1543,1421,2214,1522,8398,4
yahan,225,4103,334,2214,1522,8398,4
jabal,446,4103,664,2214,971,8398,4
venez,404,2863,1757,3252,122,8398,4
nebel,647,2863,664,3252,971,8397,4
treed,1264,1543,1421,3252,917,8397,4
cheet,1512,927,1421,3252,1284,8396,4
smeer,2206,327,1421,3252,1190,8396,4
eiser,693,2239,1021,3252,1190,8395,4
raggy,948,4103,616,612,2116,8395,4
ratti,948,4103,1048,1385,910,8394,4
bully,1555,1824,1603,1295,2116,8393,4
skims,2206,137,1668,612,3767,8390,4
lilty,1046,2239,1603,1385,2116,8389,4
sueve,2206,1824,1421,259,2679,8389,4
sweet,2206,226,1421,3252,1284,8389,4
amyas,1698,327,381,2214,3767,8387,4
joann,446,3069,1959,1391,1522,8387,4
khass,789,927,1959,945,3767,8387,4
weeny,596,2863,1421,1391,2116,8387,4
irred,473,1543,2201,3252,917,8386,4
crore,1512,1543,1426,1225,2679,8385,4
sesti,2206,2863,1021,1385,910,8385,4
eches,693,338,334,3252,3767,8384,4
lidia,1046,2239,774,1963,2362,8384,4
perri,1184,2863,2201,1225,910,8383,4
alene,1698,1193,1421,1391,2679,8382,4
ephes,693,336,334,3252,3767,8382,4
jatha,446,4103,1048,423,2362,8382,4
dilly,1128,2239,1603,1295,2116,8381,4
roove,948,3069,1426,259,2679,8381,4
weety,596,2863,1421,1385,2116,8381,4
hamza,844,4103,885,186,2362,8380,4
lelah,1046,2863,1603,2214,654,8380,4
lunna,1046,1824,1757,1391,2362,8380,4
hopeh,844,3069,560,3252,654,8379,4
kacha,789,4103,701,423,2362,8378,4
getty,965,2863,1048,1385,2116,8377,4
kajar,789,4103,81,2214,1190,8377,4
ryley,948,458,1603,3252,2116,8377,4
mossy,1225,3069,1021,945,2116,8376,4
pessa,1184,2863,1021,945,2362,8375,4
ackee,1698,338,406,3252,2679,8373,4
asius,1698,341,1668,899,3767,8373,4
coyly,1512,3069,381,1295,2116,8373,4
lepre,1046,2863,560,1225,2679,8373,4
dekle,1128,2863,406,1295,2679,8371,4
nazar,647,4103,217,2214,1190,8371,4
doorn,1128,3069,1426,1225,1522,8370,4
never,647,2863,417,3252,1190,8369,4
dusks,1128,1824,1021,628,3767,8368,4
horol,844,3069,2201,1282,971,8367,4
dearr,1128,2863,1959,1225,1190,8365,4
kawai,789,4103,349,2214,910,8365,4
macaw,1225,4103,701,2214,122,8365,4
blobs,1555,1193,1426,423,3767,8364,4
agria,1698,139,2201,1963,2362,8363,4
diggs,1128,2239,616,612,3767,8362,4
blebs,1555,1193,1421,423,3767,8359,4
sleep,2206,1193,1421,3252,285,8357,4
tibbs,1264,2239,664,423,3767,8357,4
weave,596,2863,1959,259,2679,8356,4
crary,1512,1543,1959,1225,2116,8355,4
leyte,1046,2863,381,1385,2679,8354,4
ataps,1698,403,1959,526,3767,8353,4
gleen,965,1193,1421,3252,1522,8353,4
soong,2206,3069,1426,1391,261,8353,4
boozy,1555,3069,1426,186,2116,8352,4
dedra,1128,2863,774,1225,2362,8352,4
labby,1046,4103,664,423,2116,8352,4
naval,647,4103,417,2214,971,8352,4
tunny,1264,1824,1757,1391,2116,8352,4
cully,1512,1824,1603,1295,2116,8350,4
decem,1128,2863,701,3252,406,8350,4
finny,847,2239,1757,1391,2116,8350,4
mapau,1225,4103,560,2214,247,8349,4
leuce,1046,2863,990,770,2679,8348,4
arber,1698,1543,664,3252,1190,8347,4
freet,847,1543,1421,3252,1284,8347,4
hinny,844,2239,1757,1391,2116,8347,4
filla,847,2239,1603,1295,2362,8346,4
nahua,647,4103,334,899,2362,8345,4
winna,596,2239,1757,1391,2362,8345,4
bitty,1555,2239,1048,1385,2116,8343,4
hilla,844,2239,1603,1295,2362,8343,4
neely,647,2863,1421,1295,2116,8342,4
petit,1184,2863,1048,1963,1284,8342,4
lesly,1046,2863,1021,1295,2116,8341,4
nonah,647,3069,1757,2214,654,8341,4
stite,2206,403,1668,1385,2679,8341,4
gajda,965,4103,81,829,2362,8340,4
folio,847,3069,1603,1963,857,8339,4
battu,1555,4103,1048,1385,247,8338,4
bleed,1555,1193,1421,3252,917,8338,4
ieper,473,2863,560,3252,1190,8338,4
smogs,2206,327,1426,612,3767,8338,4
gemse,965,2863,885,945,2679,8337,4
noman,647,3069,885,2214,1522,8337,4
torso,1264,3069,2201,945,857,8336,4
alain,1698,1193,1959,1963,1522,8335,4
guara,965,1824,1959,1225,2362,8335,4
possy,1184,3069,1021,945,2116,8335,4
deroo,1128,2863,2201,1282,857,8331,4
gurry,965,1824,2201,1225,2116,8331,4
konak,789,3069,1757,2214,502,8331,4
ricer,948,2239,701,3252,1190,8330,4
aspis,1698,341,560,1963,3767,8329,4
henze,844,2863,1757,186,2679,8329,4
hooka,844,3069,1426,628,2362,8329,4
rewed,948,2863,349,3252,917,8329,4
dayak,1128,4103,381,2214,502,8328,4
stops,2206,403,1426,526,3767,8328,4
derri,1128,2863,2201,1225,910,8327,4
afads,1698,73,1959,829,3767,8326,4
palpi,1184,4103,1603,526,910,8326,4
arola,1698,1543,1426,1295,2362,8324,4
thess,1264,927,1421,945,3767,8324,4
baffy,1555,4103,271,278,2116,8323,4
bedad,1555,2863,774,2214,917,8323,4
jelly,446,2863,1603,1295,2116,8323,4
steps,2206,403,1421,526,3767,8323,4
arela,1698,1543,1421,1295,2362,8319,4
dessa,1128,2863,1021,945,2362,8319,4
hexer,844,2863,170,3252,1190,8319,4
wever,596,2863,417,3252,1190,8318,4
preed,1184,1543,1421,3252,917,8317,4
aello,1698,2863,1603,1295,857,8316,4
diaka,1128,2239,1959,628,2362,8316,4
gouge,965,3069,990,612,2679,8315,4
valli,404,4103,1603,1295,910,8315,4
venge,404,2863,1757,612,2679,8315,4
milit,1225,2239,1603,1963,1284,8314,4
grogs,965,1543,1426,612,3767,8313,4
sitio,2206,2239,1048,1963,857,8313,4
alina,1698,1193,1668,1391,2362,8312,4
somlo,2206,3069,885,1295,857,8312,4
kezer,789,2863,217,3252,1190,8311,4
licia,1046,2239,701,1963,2362,8311,4
melam,1225,2863,1603,2214,406,8311,4
antae,1698,671,1048,2214,2679,8310,4
twits,1264,226,1668,1385,3767,8310,4
mulla,1225,1824,1603,1295,2362,8309,4
vagal,404,4103,616,2214,971,8308,4
sopor,2206,3069,560,1282,1190,8307,4
alita,1698,1193,1668,1385,2362,8306,4
visie,404,2239,1021,1963,2679,8306,4
ayahs,1698,458,1959,423,3767,8305,4
ceert,1512,2863,1421,1225,1284,8305,4
netta,647,2863,1048,1385,2362,8305,4
refel,948,2863,271,3252,971,8305,4
skips,2206,137,1668,526,3767,8304,4
afray,1698,73,2201,2214,2116,8302,4
cheer,1512,927,1421,3252,1190,8302,4
diode,1128,2239,1426,829,2679,8301,4
newer,647,2863,349,3252,1190,8301,4
coddy,1512,3069,774,829,2116,8300,4
rayah,948,4103,381,2214,654,8300,4
skeet,2206,137,1421,3252,1284,8300,4
yaply,225,4103,560,1295,2116,8299,4
tushs,1264,1824,1021,423,3767,8299,4
zella,176,2863,1603,1295,2362,8299,4
anlia,1698,671,1603,1963,2362,8297,4
gaffe,965,4103,271,278,2679,8296,4
gloss,965,1193,1426,945,3767,8296,4
sweer,2206,226,1421,3252,1190,8295,4
faggy,847,4103,616,612,2116,8294,4
heved,844,2863,417,3252,917,8293,4
monto,1225,3069,1757,1385,857,8293,4
piece,1184,2239,1421,770,2679,8293,4
kevel,789,2863,417,3252,971,8292,4
kinny,789,2239,1757,1391,2116,8292,4
haggy,844,4103,616,612,2116,8291,4
idaea,473,245,1959,3252,2362,8291,4
munin,1225,1824,1757,1963,1522,8291,4
hatti,844,4103,1048,1385,910,8290,4
keble,789,2863,664,1295,2679,8290,4
hooye,844,3069,1426,271,2679,8289,4
foody,847,3069,1426,829,2116,8287,4
kannu,789,4103,1757,1391,247,8287,4
titan,1264,2239,1048,2214,1522,8287,4
looky,1046,3069,1426,628,2116,8285,4
hoody,844,3069,1426,829,2116,8284,4
lieue,1046,2239,1421,899,2679,8284,4
ansae,1698,671,1021,2214,2679,8283,4
barff,1555,4103,2201,278,145,8282,4
adams,1698,245,1959,612,3767,8281,4
gurge,965,1824,2201,612,2679,8281,4
irids,473,1543,1668,829,3767,8280,4
lisle,1046,2239,1021,1295,2679,8280,4
boost,1555,3069,1426,945,1284,8279,4
dossy,1128,3069,1021,945,2116,8279,4
hewel,844,2863,349,3252,971,8279,4
yeven,225,2863,417,3252,1522,8279,4
raffe,948,4103,271,278,2679,8279,4
sicca,2206,2239,701,770,2362,8278,4
hoove,844,3069,1426,259,2679,8277,4
mixie,1225,2239,170,1963,2679,8276,4
elsey,693,1193,1021,3252,2116,8275,4
libia,1046,2239,664,1963,2362,8274,4
remue,948,2863,885,899,2679,8274,4
breek,1555,1543,1421,3252,502,8273,4
dolor,1128,3069,1603,1282,1190,8272,4
hoeve,844,3069,1421,259,2679,8272,4
punny,1184,1824,1757,1391,2116,8272,4
gabby,965,4103,664,423,2116,8271,4
gappy,965,4103,560,526,2116,8270,4
altay,1698,1193,1048,2214,2116,8269,4
zulus,176,1824,1603,899,3767,8269,4
paauw,1184,4103,1959,899,122,8267,4
pepla,1184,2863,560,1295,2362,8264,4
casco,1512,4103,1021,770,857,8263,4
retar,948,2863,1048,2214,1190,8263,4
scops,2206,338,1426,526,3767,8263,4
arrio,1698,1543,2201,1963,857,8262,4
dodge,1128,3069,774,612,2679,8262,4
snows,2206,671,1426,192,3767,8262,4
vallo,404,4103,1603,1295,857,8262,4
cecal,1512,2863,701,2214,971,8261,4
thsos,1264,927,1021,1282,3767,8261,4
eimer,693,2239,885,3252,1190,8259,4
zolly,176,3069,1603,1295,2116,8259,4
cerci,1512,2863,2201,770,910,8256,4
hetty,844,2863,1048,1385,2116,8256,4
lural,1046,1824,2201,2214,971,8256,4
donni,1128,3069,1757,1391,910,8255,4
lysis,1046,458,1021,1963,3767,8255,4
steel,2206,403,1421,3252,971,8253,4
ponto,1184,3069,1757,1385,857,8252,4
becca,1555,2863,701,770,2362,8251,4
clara,1512,1193,1959,1225,2362,8251,4
refed,948,2863,271,3252,917,8251,4
coeno,1512,3069,1421,1391,857,8250,4
burtt,1555,1824,2201,1385,1284,8249,4
phoss,1184,927,1426,945,3767,8249,4
wrier,596,1543,1668,3252,1190,8249,4
helve,844,2863,1603,259,2679,8248,4
arron,1698,1543,2201,1282,1522,8246,4
nandi,647,4103,1757,829,910,8246,4
snugs,2206,671,990,612,3767,8246,4
watap,596,4103,1048,2214,285,8246,4
fossa,847,3069,1021,945,2362,8244,4
tobit,1264,3069,664,1963,1284,8244,4
kamik,789,4103,885,1963,502,8242,4
heize,844,2863,1668,186,2679,8240,4
diann,1128,2239,1959,1391,1522,8239,4
truer,1264,1543,990,3252,1190,8239,4
diced,1128,2239,701,3252,917,8237,4
gogra,965,3069,616,1225,2362,8237,4
coost,1512,3069,1426,945,1284,8236,4
malum,1225,4103,1603,899,406,8236,4
rerig,948,2863,2201,1963,261,8236,4
spivs,2206,336,1668,259,3767,8236,4
katti,789,4103,1048,1385,910,8235,4
pixie,1184,2239,170,1963,2679,8235,4
beefy,1555,2863,1421,278,2116,8233,4
creek,1512,1543,1421,3252,502,8230,4
toist,1264,3069,1668,945,1284,8230,4
resex,948,2863,1021,3252,144,8228,4
hoopa,844,3069,1426,526,2362,8227,4
mumps,1225,1824,885,526,3767,8227,4
belli,1555,2863,1603,1295,910,8226,4
hewed,844,2863,349,3252,917,8225,4
stobs,2206,403,1426,423,3767,8225,4
geigy,965,2863,1668,612,2116,8224,4
defoe,1128,2863,271,1282,2679,8223,4
soyot,2206,3069,381,1282,1284,8222,4
asael,1698,341,1959,3252,971,8221,4
beche,1555,2863,701,423,2679,8221,4
ameen,1698,327,1421,3252,1522,8220,4
grana,965,1543,1959,1391,2362,8220,4
ville,404,2239,1603,1295,2679,8220,4
aidde,1698,2239,774,829,2679,8219,4
humus,844,1824,885,899,3767,8219,4
gilly,965,2239,1603,1295,2116,8218,4
pitta,1184,2239,1048,1385,2362,8218,4
bilio,1555,2239,1603,1963,857,8217,4
tempe,1264,2863,885,526,2679,8217,4
dunny,1128,1824,1757,1391,2116,8216,4
mahwa,1225,4103,334,192,2362,8216,4
buxus,1555,1824,170,899,3767,8215,4
grata,965,1543,1959,1385,2362,8214,4
yacal,225,4103,701,2214,971,8214,4
tabut,1264,4103,664,899,1284,8214,4
furry,847,1824,2201,1225,2116,8213,4
kenon,789,2863,1757,1282,1522,8213,4
zeena,176,2863,1421,1391,2362,8213,4
dulla,1128,1824,1603,1295,2362,8212,4
gruss,965,1543,990,945,3767,8210,4
hurry,844,1824,2201,1225,2116,8210,4
tessy,1264,2863,1021,945,2116,8209,4
resew,948,2863,1021,3252,122,8206,4
skeer,2206,137,1421,3252,1190,8206,4
yagua,225,4103,616,899,2362,8205,4
ixias,473,83,1668,2214,3767,8205,4
gooky,965,3069,1426,628,2116,8204,4
remde,948,2863,885,829,2679,8204,4
oklee,532,137,1603,3252,2679,8203,4
keyed,789,2863,381,3252,917,8202,4
ketty,789,2863,1048,1385,2116,8201,4
rilly,948,2239,1603,1295,2116,8201,4
bajau,1555,4103,81,2214,247,8200,4
fasst,847,4103,1021,945,1284,8200,4
retry,948,2863,1048,1225,2116,8200,4
craal,1512,1543,1959,2214,971,8199,4
steed,2206,403,1421,3252,917,8199,4
lossy,1046,3069,1021,945,2116,8197,4
aidin,1698,2239,774,1963,1522,8196,4
jebel,446,2863,664,3252,971,8196,4
oleos,532,1193,1421,1282,3767,8195,4
studs,2206,403,990,829,3767,8195,4
commy,1512,3069,885,612,2116,8194,4
babul,1555,4103,664,899,971,8192,4
tedge,1264,2863,774,612,2679,8192,4
alary,1698,1193,1959,1225,2116,8191,4
clete,1512,1193,1421,1385,2679,8190,4
tasso,1264,4103,1021,945,857,8190,4
braca,1555,1543,1959,770,2362,8189,4
rheae,948,927,1421,2214,2679,8189,4
riper,948,2239,560,3252,1190,8189,4
poort,1184,3069,1426,1225,1284,8188,4
rusks,948,1824,1021,628,3767,8188,4
nanci,647,4103,1757,770,910,8187,4
rooky,948,3069,1426,628,2116,8187,4
pumps,1184,1824,885,526,3767,8186,4
speel,2206,336,1421,3252,971,8186,4
fidia,847,2239,774,1963,2362,8185,4
yawny,225,4103,349,1391,2116,8184,4
mayag,1225,4103,381,2214,261,8184,4
sirki,2206,2239,2201,628,910,8184,4
celli,1512,2863,1603,1295,910,8183,4
loopy,1046,3069,1426,526,2116,8183,4
wowed,596,3069,349,3252,917,8183,4
zakat,176,4103,406,2214,1284,8183,4
argia,1698,1543,616,1963,2362,8182,4
riggs,948,2239,616,612,3767,8182,4
sisak,2206,2239,1021,2214,502,8182,4
loofa,1046,3069,1426,278,2362,8181,4
dixie,1128,2239,170,1963,2679,8179,4
floss,847,1193,1426,945,3767,8178,4
jinan,446,2239,1757,2214,1522,8178,4
reedy,948,2863,1421,829,2116,8177,4
vajra,404,4103,81,1225,2362,8175,4
amahs,1698,327,1959,423,3767,8174,4
butta,1555,1824,1048,1385,2362,8174,4
bello,1555,2863,1603,1295,857,8173,4
lonni,1046,3069,1757,1391,910,8173,4
kopek,789,3069,560,3252,502,8172,4
libel,1046,2239,664,3252,971,8172,4
zooty,176,3069,1426,1385,2116,8172,4
roomy,948,3069,1426,612,2116,8171,4
briar,1555,1543,1668,2214,1190,8170,4
messy,1225,2863,1021,945,2116,8170,4
taboo,1264,4103,664,1282,857,8170,4
piaba,1184,2239,1959,423,2362,8167,4
gerri,965,2863,2201,1225,910,8164,4
redue,948,2863,774,899,2679,8163,4
yajna,225,4103,81,1391,2362,8162,4
jammy,446,4103,885,612,2116,8162,4
hunan,844,1824,1757,2214,1522,8161,4
vasya,404,4103,1021,271,2362,8161,4
pogge,1184,3069,616,612,2679,8160,4
scala,2206,338,1959,1295,2362,8160,4
scobs,2206,338,1426,423,3767,8160,4
codon,1512,3069,774,1282,1522,8159,4
amess,1698,327,1421,945,3767,8158,4
mcbee,1225,338,664,3252,2679,8158,4
rural,948,1824,2201,2214,971,8158,4
zayat,176,4103,381,2214,1284,8158,4
alake,1698,1193,1959,628,2679,8157,4
nadya,647,4103,774,271,2362,8157,4
gagor,965,4103,616,1282,1190,8156,4
pendn,1184,2863,1757,829,1522,8155,4
syene,2206,458,1421,1391,2679,8155,4
vinna,404,2239,1757,1391,2362,8153,4
aghas,1698,139,334,2214,3767,8152,4
piped,1184,2239,560,3252,917,8152,4
chana,1512,927,1959,1391,2362,8151,4
ninde,647,2239,1757,829,2679,8151,4
swops,2206,226,1426,526,3767,8151,4
tapaj,1264,4103,560,2214,10,8151,4
wayao,596,4103,381,2214,857,8151,4
nevel,647,2863,417,3252,971,8150,4
zelde,176,2863,1603,829,2679,8150,4
happy,844,4103,560,526,2116,8149,4
yavar,225,4103,417,2214,1190,8149,4
labaw,1046,4103,664,2214,122,8149,4
wisps,596,2239,1021,526,3767,8149,4
eider,693,2239,774,3252,1190,8148,4
moton,1225,3069,1048,1282,1522,8146,4
nilla,647,2239,1603,1295,2362,8146,4
cysts,1512,458,1021,1385,3767,8143,4
skegs,2206,137,1421,612,3767,8143,4
bedye,1555,2863,774,271,2679,8142,4
bsrfs,1555,341,2201,278,3767,8142,4
honor,844,3069,1757,1282,1190,8142,4
rudds,948,1824,774,829,3767,8142,4
alage,1698,1193,1959,612,2679,8141,4
dyads,1128,458,1959,829,3767,8141,4
molto,1225,3069,1603,1385,857,8139,4
lipps,1046,2239,560,526,3767,8138,4
lycee,1046,458,701,3252,2679,8136,4
creem,1512,1543,1421,3252,406,8134,4
fikie,847,2239,406,1963,2679,8134,4
monro,1225,3069,1757,1225,857,8133,4
speed,2206,336,1421,3252,917,8132,4
tenno,1264,2863,1757,1391,857,8132,4
bahoo,1555,4103,334,1282,857,8131,4
ietta,473,2863,1048,1385,2362,8131,4
neman,647,2863,885,2214,1522,8131,4
cello,1512,2863,1603,1295,857,8130,4
nabak,647,4103,664,2214,502,8130,4
numen,647,1824,885,3252,1522,8130,4
scuds,2206,338,990,829,3767,8130,4
depue,1128,2863,560,899,2679,8129,4
hanch,844,4103,1757,770,654,8128,4
seenu,2206,2863,1421,1391,247,8128,4
spuds,2206,336,990,829,3767,8128,4
scase,2206,338,1959,945,2679,8127,4
behew,1555,2863,334,3252,122,8126,4
eyren,693,458,2201,3252,1522,8126,4
lebec,1046,2863,664,3252,300,8125,4
kicks,789,2239,701,628,3767,8124,4
mahau,1225,4103,334,2214,247,8123,4
tabib,1264,4103,664,1963,129,8123,4
anoia,1698,671,1426,1963,2362,8120,4
bauru,1555,4103,990,1225,247,8120,4
aillt,1698,2239,1603,1295,1284,8119,4
gossy,965,3069,1021,945,2116,8116,4
didle,1128,2239,774,1295,2679,8115,4
gleet,965,1193,1421,3252,1284,8115,4
nasab,647,4103,1021,2214,129,8114,4
tembe,1264,2863,885,423,2679,8114,4
queen,93,1824,1421,3252,1522,8112,4
biffs,1555,2239,271,278,3767,8110,4
mcgee,1225,338,616,3252,2679,8110,4
passo,1184,4103,1021,945,857,8110,4
divia,1128,2239,417,1963,2362,8109,4
vivos,404,2239,417,1282,3767,8109,4
amnia,1698,327,1757,1963,2362,8107,4
nonya,647,3069,1757,271,2362,8106,4
rehoe,948,2863,334,1282,2679,8106,4
penni,1184,2863,1757,1391,910,8105,4
oohed,532,3069,334,3252,917,8104,4
goopy,965,3069,1426,526,2116,8102,4
molli,1225,3069,1603,1295,910,8102,4
ollen,532,1193,1603,3252,1522,8102,4
rubus,948,1824,664,899,3767,8102,4
tully,1264,1824,1603,1295,2116,8102,4
yampa,225,4103,885,526,2362,8101,4
filly,847,2239,1603,1295,2116,8100,4
ignis,473,139,1757,1963,3767,8099,4
rossy,948,3069,1021,945,2116,8099,4
winny,596,2239,1757,1391,2116,8099,4
greed,965,1543,1421,3252,917,8098,4
hilly,844,2239,1603,1295,2116,8097,4
keyte,789,2863,381,1385,2679,8097,4
insee,473,671,1021,3252,2679,8096,4
lupus,1046,1824,560,899,3767,8096,4
mecke,1225,2863,701,628,2679,8096,4
plops,1184,1193,1426,526,3767,8096,4
siest,2206,2239,1421,945,1284,8095,4
willa,596,2239,1603,1295,2362,8095,4
naggy,647,4103,616,612,2116,8094,4
menno,1225,2863,1757,1391,857,8093,4
pepin,1184,2863,560,1963,1522,8092,4
remex,948,2863,885,3252,144,8092,4
skyey,2206,137,381,3252,2116,8092,4
tedda,1264,2863,774,829,2362,8092,4
sheep,2206,927,1421,3252,285,8091,4
booth,1555,3069,1426,1385,654,8089,4
homme,844,3069,885,612,2679,8089,4
plana,1184,1193,1959,1391,2362,8089,4
bemba,1555,2863,885,423,2362,8088,4
seism,2206,2863,1668,945,406,8088,4
sunni,2206,1824,1757,1391,910,8088,4
catch,1512,4103,1048,770,654,8087,4
gheen,965,927,1421,3252,1522,8087,4
couac,1512,3069,990,2214,300,8085,4
jisms,446,2239,1021,612,3767,8085,4
husks,844,1824,1021,628,3767,8084,4
hooky,844,3069,1426,628,2116,8083,4
yeggs,225,2863,616,612,3767,8083,4
plata,1184,1193,1959,1385,2362,8083,4
newel,647,2863,349,3252,971,8082,4
shaka,2206,927,1959,628,2362,8082,4
litta,1046,2239,1048,1385,2362,8080,4
looby,1046,3069,1426,423,2116,8080,4
higgs,844,2239,616,612,3767,8078,4
moroc,1225,3069,2201,1282,300,8077,4
niven,647,2239,417,3252,1522,8077,4
feedy,847,2863,1421,829,2116,8076,4
papst,1184,4103,560,945,1284,8076,4
caddo,1512,4103,774,829,857,8075,4
ronni,948,3069,1757,1391,910,8075,4
leeky,1046,2863,1421,628,2116,8074,4
blere,1555,1193,1421,1225,2679,8073,4
heedy,844,2863,1421,829,2116,8073,4
poofy,1184,3069,1426,278,2116,8073,4
keaau,789,2863,1959,2214,247,8072,4
jeery,446,2863,1421,1225,2116,8071,4
weeda,596,2863,1421,829,2362,8071,4
rheen,948,927,1421,3252,1522,8070,4
nisei,647,2239,1021,3252,910,8069,4
beest,1555,2863,1421,945,1284,8068,4
shama,2206,927,1959,612,2362,8066,4
alena,1698,1193,1421,1391,2362,8065,4
jotty,446,3069,1048,1385,2116,8064,4
estas,693,341,1048,2214,3767,8063,4
acate,1698,338,1959,1385,2679,8059,4
aleta,1698,1193,1421,1385,2362,8059,4
lethe,1046,2863,1048,423,2679,8059,4
netty,647,2863,1048,1385,2116,8059,4
noint,647,3069,1668,1391,1284,8059,4
gibbs,965,2239,664,423,3767,8058,4
nahma,647,4103,334,612,2362,8058,4
gipps,965,2239,560,526,3767,8057,4
prore,1184,1543,1426,1225,2679,8057,4
skeps,2206,137,1421,526,3767,8057,4
snubs,2206,671,990,423,3767,8057,4
strit,2206,403,2201,1963,1284,8057,4
guasa,965,1824,1959,945,2362,8055,4
urous,420,1543,1426,899,3767,8055,4
velal,404,2863,1603,2214,971,8055,4
theer,1264,927,1421,3252,1190,8054,4
gunny,965,1824,1757,1391,2116,8053,4
kudus,789,1824,774,899,3767,8053,4
norri,647,3069,2201,1225,910,8052,4
toddy,1264,3069,774,829,2116,8052,4
denni,1128,2863,1757,1391,910,8049,4
amate,1698,327,1959,1385,2679,8048,4
poloi,1184,3069,1603,1282,910,8048,4
swobs,2206,226,1426,423,3767,8048,4
cooth,1512,3069,1426,1385,654,8046,4
dooja,1128,3069,1426,61,2362,8046,4
ferri,847,2863,2201,1225,910,8046,4
hexed,844,2863,170,3252,917,8046,4
river,948,2239,417,3252,1190,8046,4
lapaz,1046,4103,560,2214,122,8045,4
muggs,1225,1824,616,612,3767,8044,4
qiana,93,2239,1959,1391,2362,8044,4
unsee,420,671,1021,3252,2679,8043,4
waggy,596,4103,616,612,2116,8043,4
killy,789,2239,1603,1295,2116,8042,4
arica,1698,1543,1668,770,2362,8041,4
guage,965,1824,1959,612,2679,8039,4
fucus,847,1824,701,899,3767,8038,4
runny,948,1824,1757,1391,2116,8036,4
woody,596,3069,1426,829,2116,8036,4
lynen,1046,458,1757,3252,1522,8035,4
riker,948,2239,406,3252,1190,8035,4
scene,2206,338,1421,1391,2679,8035,4
kalki,789,4103,1603,628,910,8033,4
taffy,1264,4103,271,278,2116,8032,4
braga,1555,1543,1959,612,2362,8031,4
fevre,847,2863,417,1225,2679,8031,4
oilla,532,2239,1603,1295,2362,8031,4
berob,1555,2863,2201,1282,129,8030,4
clere,1512,1193,1421,1225,2679,8030,4
bourr,1555,3069,990,1225,1190,8029,4
cauch,1512,4103,990,770,654,8029,4
coppa,1512,3069,560,526,2362,8029,4
veery,404,2863,1421,1225,2116,8029,4
bhara,1555,927,1959,1225,2362,8028,4
brede,1555,1543,1421,829,2679,8027,4
livia,1046,2239,417,1963,2362,8027,4
rebec,948,2863,664,3252,300,8027,4
spete,2206,336,1421,1385,2679,8027,4
cocky,1512,3069,701,628,2116,8026,4
entea,693,671,1048,3252,2362,8026,4
hided,844,2239,774,3252,917,8026,4
pompa,1184,3069,885,526,2362,8026,4
ghess,965,927,1421,945,3767,8025,4
condo,1512,3069,1757,829,857,8024,4
aiwan,1698,2239,349,2214,1522,8022,4
cammi,1512,4103,885,612,910,8022,4
meill,1225,2863,1668,1295,971,8022,4
aavso,1698,4103,417,945,857,8020,4
sensu,2206,2863,1757,945,247,8018,4
reeba,948,2863,1421,423,2362,8017,4
teyde,1264,2863,381,829,2679,8016,4
vitia,404,2239,1048,1963,2362,8016,4
bazoo,1555,4103,217,1282,857,8014,4
nantz,647,4103,1757,1385,122,8014,4
vevay,404,2863,417,2214,2116,8014,4
creep,1512,1543,1421,3252,285,8013,4
mitty,1225,2239,1048,1385,2116,8013,4
nurry,647,1824,2201,1225,2116,8013,4
trait,1264,1543,1959,1963,1284,8013,4
dedit,1128,2863,774,1963,1284,8012,4
orran,532,1543,2201,2214,1522,8012,4
cecil,1512,2863,701,1963,971,8010,4
cidin,1512,2239,774,1963,1522,8010,4
coamo,1512,3069,1959,612,857,8009,4
begga,1555,2863,616,612,2362,8008,4
dolli,1128,3069,1603,1295,910,8005,4
stele,2206,403,1421,1295,2679,8004,4
alair,1698,1193,1959,1963,1190,8003,4
cogon,1512,3069,616,1282,1522,8001,4
local,1046,3069,701,2214,971,8001,4
metze,1225,2863,1048,186,2679,8001,4
kokan,789,3069,406,2214,1522,8000,4
rajah,948,4103,81,2214,654,8000,4
decke,1128,2863,701,628,2679,7999,4
grene,965,1543,1421,1391,2679,7999,4
popal,1184,3069,560,2214,971,7998,4
fleet,847,1193,1421,3252,1284,7997,4
liege,1046,2239,1421,612,2679,7997,4
alday,1698,1193,774,2214,2116,7995,4
sigil,2206,2239,616,1963,971,7995,4
eyrie,693,458,2201,1963,2679,7994,4
stows,2206,403,1426,192,3767,7994,4
ferro,847,2863,2201,1225,857,7993,4
geeky,965,2863,1421,628,2116,7993,4
grete,965,1543,1421,1385,2679,7993,4
eiger,693,2239,616,3252,1190,7990,4
doyly,1128,3069,381,1295,2116,7989,4
stews,2206,403,1421,192,3767,7989,4
kerri,789,2863,2201,1225,910,7988,4
rebeg,948,2863,664,3252,261,7988,4
ruder,948,1824,774,3252,1190,7988,4
oozed,532,3069,217,3252,917,7987,4
skeel,2206,137,1421,3252,971,7987,4
chara,1512,927,1959,1225,2362,7985,4
nidia,647,2239,774,1963,2362,7985,4
alyss,1698,1193,381,945,3767,7984,4
pinon,1184,2239,1757,1282,1522,7984,4
juana,446,1824,1959,1391,2362,7982,4
freed,847,1543,1421,3252,917,7980,4
allin,1698,1193,1603,1963,1522,7979,4
lemal,1046,2863,885,2214,971,7979,4
teton,1264,2863,1048,1282,1522,7979,4
iblis,473,172,1603,1963,3767,7978,4
stums,2206,403,990,612,3767,7978,4
iinde,473,2239,1757,829,2679,7977,4
merom,1225,2863,2201,1282,406,7977,4
peert,1184,2863,1421,1225,1284,7977,4
connu,1512,3069,1757,1391,247,7976,4
reeky,948,2863,1421,628,2116,7976,4
erine,693,1543,1668,1391,2679,7974,4
halch,844,4103,1603,770,654,7974,4
ledge,1046,2863,774,612,2679,7974,4
hakam,844,4103,406,2214,406,7973,4
asale,1698,341,1959,1295,2679,7972,4
lasso,1046,4103,1021,945,857,7972,4
poddy,1184,3069,774,829,2116,7972,4
namaz,647,4103,885,2214,122,7971,4
wajda,596,4103,81,829,2362,7971,4
ollie,532,1193,1603,1963,2679,7970,4
acale,1698,338,1959,1295,2679,7969,4
wynns,596,458,1757,1391,3767,7969,4
boggy,1555,3069,616,612,2116,7968,4
botti,1555,3069,1048,1385,910,7967,4
lenni,1046,2863,1757,1391,910,7967,4
pattu,1184,4103,1048,1385,247,7967,4
dully,1128,1824,1603,1295,2116,7966,4
coach,1512,3069,1959,770,654,7964,4
lobal,1046,3069,664,2214,971,7964,4
rethe,948,2863,1048,423,2679,7961,4
ziara,176,2239,1959,1225,2362,7961,4
ammos,1698,327,885,1282,3767,7959,4
aucan,1698,1824,701,2214,1522,7959,4
harpp,844,4103,2201,526,285,7959,4
aidit,1698,2239,774,1963,1284,7958,4
biali,1555,2239,1959,1295,910,7958,4
fiann,847,2239,1959,1391,1522,7958,4
uriia,420,1543,1668,1963,2362,7956,4
titar,1264,2239,1048,2214,1190,7955,4
acaws,1698,338,1959,192,3767,7954,4
awane,1698,226,1959,1391,2679,7953,4
dived,1128,2239,417,3252,917,7953,4
fugus,847,1824,616,899,3767,7953,4
nabby,647,4103,664,423,2116,7953,4
nappy,647,4103,560,526,2116,7952,4
tulua,1264,1824,1603,899,2362,7952,4
dedal,1128,2863,774,2214,971,7950,4
jinny,446,2239,1757,1391,2116,7949,4
moost,1225,3069,1426,945,1284,7949,4
kehoe,789,2863,334,1282,2679,7947,4
leyla,1046,2863,381,1295,2362,7947,4
nadja,647,4103,774,61,2362,7947,4
witte,596,2239,1048,1385,2679,7947,4
tommy,1264,3069,885,612,2116,7946,4
tatou,1264,4103,1048,1282,247,7944,4
boonk,1555,3069,1426,1391,502,7943,4
diked,1128,2239,406,3252,917,7942,4
adays,1698,245,1959,271,3767,7940,4
hibbs,844,2239,664,423,3767,7937,4
bilby,1555,2239,1603,423,2116,7936,4
funny,847,1824,1757,1391,2116,7935,4
illus,473,1193,1603,899,3767,7935,4
sheeb,2206,927,1421,3252,129,7935,4
sokol,2206,3069,406,1282,971,7934,4
stere,2206,403,1421,1225,2679,7934,4
skeed,2206,137,1421,3252,917,7933,4
heall,844,2863,1959,1295,971,7932,4
croce,1512,1543,1426,770,2679,7930,4
wunna,596,1824,1757,1391,2362,7930,4
scows,2206,338,1426,192,3767,7929,4
baubo,1555,4103,990,423,857,7928,4
butty,1555,1824,1048,1385,2116,7928,4
nabac,647,4103,664,2214,300,7928,4
suist,2206,1824,1668,945,1284,7927,4
redry,948,2863,774,1225,2116,7926,4
butat,1555,1824,1048,2214,1284,7925,4
depew,1128,2863,560,3252,122,7925,4
doozy,1128,3069,1426,186,2116,7925,4
shiai,2206,927,1668,2214,910,7925,4
brear,1555,1543,1421,2214,1190,7923,4
porgo,1184,3069,2201,612,857,7923,4
tenth,1264,2863,1757,1385,654,7923,4
intis,473,671,1048,1963,3767,7922,4
jolon,446,3069,1603,1282,1522,7922,4
spews,2206,336,1421,192,3767,7922,4
aways,1698,226,1959,271,3767,7921,4
gordo,965,3069,2201,829,857,7921,4
mecca,1225,2863,701,770,2362,7921,4
oolak,532,3069,1603,2214,502,7920,4
susah,2206,1824,1021,2214,654,7919,4
ditty,1128,2239,1048,1385,2116,7916,4
elane,693,1193,1959,1391,2679,7915,4
lenno,1046,2863,1757,1391,857,7914,4
seech,2206,2863,1421,770,654,7914,4
boldo,1555,3069,1603,829,857,7913,4
scums,2206,338,990,612,3767,7913,4
smews,2206,327,1421,192,3767,7913,4
cusec,1512,1824,1021,3252,300,7909,4
edley,693,245,1603,3252,2116,7909,4
elate,693,1193,1959,1385,2679,7909,4
dovev,1128,3069,417,3252,41,7907,4
eugen,693,1824,616,3252,1522,7907,4
vinny,404,2239,1757,1391,2116,7907,4
faham,847,4103,334,2214,406,7904,4
dehue,1128,2863,334,899,2679,7903,4
fleer,847,1193,1421,3252,1190,7903,4
reube,948,2863,990,423,2679,7903,4
thana,1264,927,1959,1391,2362,7903,4
villa,404,2239,1603,1295,2362,7903,4
whiss,596,927,1668,945,3767,7903,4
abbey,1698,172,664,3252,2116,7902,4
asare,1698,341,1959,1225,2679,7902,4
wabby,596,4103,664,423,2116,7902,4
gutte,965,1824,1048,1385,2679,7901,4
rempe,948,2863,885,526,2679,7901,4
cracy,1512,1543,1959,770,2116,7900,4
mckee,1225,338,406,3252,2679,7900,4
rifer,948,2239,271,3252,1190,7900,4
corvo,1512,3069,2201,259,857,7898,4
ordos,532,1543,774,1282,3767,7898,4
haikh,844,4103,1668,628,654,7897,4
naafi,647,4103,1959,278,910,7897,4
daffy,1128,4103,271,278,2116,7896,4
melli,1225,2863,1603,1295,910,7896,4
didna,1128,2239,774,1391,2362,7894,4
japha,446,4103,560,423,2362,7894,4
abate,1698,172,1959,1385,2679,7893,4
jaggy,446,4103,616,612,2116,7893,4
alloy,1698,1193,1603,1282,2116,7892,4
accts,1698,338,701,1385,3767,7889,4
cueca,1512,1824,1421,770,2362,7889,4
highs,844,2239,616,423,3767,7889,4
summa,2206,1824,885,612,2362,7889,4
ameer,1698,327,1421,3252,1190,7888,4
ainoi,1698,2239,1757,1282,910,7886,4
genni,965,2863,1757,1391,910,7886,4
nooky,647,3069,1426,628,2116,7886,4
albay,1698,1193,664,2214,2116,7885,4
cutty,1512,1824,1048,1385,2116,7885,4
sipid,2206,2239,560,1963,917,7885,4
pooli,1184,3069,1426,1295,910,7884,4
repeg,948,2863,560,3252,261,7884,4
audra,1698,1824,774,1225,2362,7883,4
yetta,225,2863,1048,1385,2362,7883,4
lewse,1046,2863,349,945,2679,7882,4
tello,1264,2863,1603,1295,857,7882,4
acroa,1698,338,2201,1282,2362,7881,4
fodda,847,3069,774,829,2362,7881,4
jewel,446,2863,349,3252,971,7881,4
lifia,1046,2239,271,1963,2362,7881,4
ahira,1698,927,1668,1225,2362,7880,4
albia,1698,1193,664,1963,2362,7880,4
cleek,1512,1193,1421,3252,502,7880,4
wiese,596,2239,1421,945,2679,7880,4
rebar,948,2863,664,2214,1190,7879,4
vexer,404,2863,170,3252,1190,7879,4
beeth,1555,2863,1421,1385,654,7878,4
shaba,2206,927,1959,423,2362,7877,4
adlay,1698,245,1603,2214,2116,7876,4
bambi,1555,4103,885,423,910,7876,4
kiker,789,2239,406,3252,1190,7876,4
needy,647,2863,1421,829,2116,7876,4
lowly,1046,3069,349,1295,2116,7875,4
ledda,1046,2863,774,829,2362,7874,4
popsy,1184,3069,560,945,2116,7874,4
queet,93,1824,1421,3252,1284,7874,4
kulla,789,1824,1603,1295,2362,7873,4
oidia,532,2239,774,1963,2362,7870,4
allez,1698,1193,1603,3252,122,7868,4
bribe,1555,1543,1668,423,2679,7868,4
maxim,1225,4103,170,1963,406,7867,4
nadab,647,4103,774,2214,129,7867,4
spere,2206,336,1421,1225,2679,7867,4
alisa,1698,1193,1668,945,2362,7866,4
pommy,1184,3069,885,612,2116,7866,4
hapax,844,4103,560,2214,144,7865,4
sudsy,2206,1824,774,945,2116,7865,4
arman,1698,1543,885,2214,1522,7862,4
agate,1698,139,1959,1385,2679,7860,4
aroda,1698,1543,1426,829,2362,7858,4
jetty,446,2863,1048,1385,2116,7858,4
rosio,948,3069,1021,1963,857,7858,4
bouto,1555,3069,990,1385,857,7856,4
kunin,789,1824,1757,1963,1522,7855,4
ccafs,1512,338,1959,278,3767,7854,4
goofy,965,3069,1426,278,2116,7854,4
kibei,789,2239,664,3252,910,7854,4
reeva,948,2863,1421,259,2362,7853,4
kokra,789,3069,406,1225,2362,7851,4
bongo,1555,3069,1757,612,857,7850,4
rocca,948,3069,701,770,2362,7850,4
willy,596,2239,1603,1295,2116,7849,4
areal,1698,1543,1421,2214,971,7847,4
chace,1512,927,1959,770,2679,7847,4
linon,1046,2239,1757,1282,1522,7846,4
teddy,1264,2863,774,829,2116,7846,4
lorou,1046,3069,2201,1282,247,7845,4
mello,1225,2863,1603,1295,857,7843,4
maddi,1225,4103,774,829,910,7841,4
banff,1555,4103,1757,278,145,7838,4
nessa,647,2863,1021,945,2362,7838,4
gunge,965,1824,1757,612,2679,7837,4
roofy,948,3069,1426,278,2116,7837,4
alded,1698,1193,774,3252,917,7834,4
assen,1698,341,1021,3252,1522,7834,4
skene,2206,137,1421,1391,2679,7834,4
spise,2206,336,1668,945,2679,7834,4
zetta,176,2863,1048,1385,2362,7834,4
cissy,1512,2239,1021,945,2116,7833,4
algia,1698,1193,616,1963,2362,7832,4
tourt,1264,3069,990,1225,1284,7832,4
nided,647,2239,774,3252,917,7829,4
dooli,1128,3069,1426,1295,910,7828,4
skete,2206,137,1421,1385,2679,7828,4
jewed,446,2863,349,3252,917,7827,4
scups,2206,338,990,526,3767,7827,4
neffs,647,2863,271,278,3767,7826,4
urare,420,1543,1959,1225,2679,7826,4
weedy,596,2863,1421,829,2116,7825,4
decca,1128,2863,701,770,2362,7824,4
decad,1128,2863,701,2214,917,7823,4
hassi,844,4103,1021,945,910,7823,4
eyass,693,458,1959,945,3767,7822,4
erase,693,1543,1959,945,2679,7819,4
tiffs,1264,2239,271,278,3767,7819,4
hodad,844,3069,774,2214,917,7818,4
coopt,1512,3069,1426,526,1284,7817,4
lccis,1046,338,701,1963,3767,7815,4
motor,1225,3069,1048,1282,1190,7814,4
poori,1184,3069,1426,1225,910,7814,4
bennu,1555,2863,1757,1391,247,7813,4
cenci,1512,2863,1757,770,910,7812,4
estis,693,341,1048,1963,3767,7812,4
breme,1555,1543,1421,612,2679,7810,4
abran,1698,172,2201,2214,1522,7807,4
congo,1512,3069,1757,612,857,7807,4
thala,1264,927,1959,1295,2362,7807,4
bogot,1555,3069,616,1282,1284,7806,4
revue,948,2863,417,899,2679,7806,4
devex,1128,2863,417,3252,144,7804,4
fordo,847,3069,2201,829,857,7803,4
gully,965,1824,1603,1295,2116,7803,4
rehem,948,2863,334,3252,406,7803,4
arnon,1698,1543,1757,1282,1522,7802,4
bobac,1555,3069,664,2214,300,7802,4
iodin,473,3069,774,1963,1522,7801,4
gobbe,965,3069,664,423,2679,7800,4
fifer,847,2239,271,3252,1190,7799,4
undee,420,671,774,3252,2679,7796,4
suppe,2206,1824,560,526,2679,7795,4
areca,1698,1543,1421,770,2362,7794,4
gigle,965,2239,616,1295,2679,7794,4
aread,1698,1543,1421,2214,917,7793,4
missa,1225,2239,1021,945,2362,7792,4
neume,647,2863,990,612,2679,7791,4
stubs,2206,403,990,423,3767,7789,4
aware,1698,226,1959,1225,2679,7787,4
anita,1698,671,1668,1385,2362,7784,4
cobby,1512,3069,664,423,2116,7784,4
steek,2206,403,1421,3252,502,7784,4
clela,1512,1193,1421,1295,2362,7783,4
coppy,1512,3069,560,526,2116,7783,4
junna,446,1824,1757,1391,2362,7780,4
miffs,1225,2239,271,278,3767,7780,4
queer,93,1824,1421,3252,1190,7780,4
boiko,1555,3069,1668,628,857,7777,4
jaffe,446,4103,271,278,2679,7777,4
oruss,532,1543,990,945,3767,7777,4
tondo,1264,3069,1757,829,857,7776,4
tammi,1264,4103,885,612,910,7774,4
laluz,1046,4103,1603,899,122,7773,4
hedge,844,2863,774,612,2679,7772,4
prese,1184,1543,1421,945,2679,7772,4
lautu,1046,4103,990,1385,247,7771,4
gygis,965,458,616,1963,3767,7769,4
kassi,789,4103,1021,945,910,7768,4
lemma,1046,2863,885,612,2362,7768,4
creme,1512,1543,1421,612,2679,7767,4
henni,844,2863,1757,1391,910,7765,4
mcfee,1225,338,271,3252,2679,7765,4
anele,1698,671,1421,1295,2679,7764,4
chere,1512,927,1421,1225,2679,7764,4
naacp,647,4103,1959,770,285,7764,4
burut,1555,1824,2201,899,1284,7763,4
bohon,1555,3069,334,1282,1522,7762,4
conch,1512,3069,1757,770,654,7762,4
betti,1555,2863,1048,1385,910,7761,4
orrin,532,1543,2201,1963,1522,7761,4
mimly,1225,2239,885,1295,2116,7760,4
huaca,844,1824,1959,770,2362,7759,4
mooth,1225,3069,1426,1385,654,7759,4
xever,36,2863,417,3252,1190,7758,4
avale,1698,126,1959,1295,2679,7757,4
capoc,1512,4103,560,1282,300,7757,4
aimil,1698,2239,885,1963,971,7756,4
lilah,1046,2239,1603,2214,654,7756,4
niece,647,2239,1421,770,2679,7756,4
staal,2206,403,1959,2214,971,7753,4
alida,1698,1193,1668,829,2362,7750,4
suddy,2206,1824,774,829,2116,7749,4
gleed,965,1193,1421,3252,917,7748,4
guige,965,1824,1668,612,2679,7748,4
wifie,596,2239,271,1963,2679,7748,4
repew,948,2863,560,3252,122,7745,4
aisha,1698,2239,1021,423,2362,7743,4
antia,1698,671,1048,1963,2362,7742,4
kempe,789,2863,885,526,2679,7742,4
luann,1046,1824,1959,1391,1522,7742,4
mamou,1225,4103,885,1282,247,7742,4
efren,693,73,2201,3252,1522,7741,4
nibbs,647,2239,664,423,3767,7740,4
razor,948,4103,217,1282,1190,7740,4
trama,1264,1543,1959,612,2362,7740,4
zirai,176,2239,2201,2214,910,7740,4
araby,1698,1543,1959,423,2116,7739,4
guaka,965,1824,1959,628,2362,7738,4
mafoo,1225,4103,271,1282,857,7738,4
rooti,948,3069,1426,1385,910,7738,4
dimin,1128,2239,885,1963,1522,7737,4
mondo,1225,3069,1757,829,857,7737,4
sodom,2206,3069,774,1282,406,7737,4
nonic,647,3069,1757,1963,300,7736,4
roddy,948,3069,774,829,2116,7736,4
medii,1225,2863,774,1963,910,7735,4
neall,647,2863,1959,1295,971,7735,4
deloo,1128,2863,1603,1282,857,7733,4
hoofy,844,3069,1426,278,2116,7733,4
jurua,446,1824,2201,899,2362,7732,4
troat,1264,1543,1426,2214,1284,7731,4
irreg,473,1543,2201,3252,261,7730,4
comic,1512,3069,885,1963,300,7729,4
rahab,948,4103,334,2214,129,7728,4
colog,1512,3069,1603,1282,261,7727,4
treat,1264,1543,1421,2214,1284,7726,4
shaya,2206,927,1959,271,2362,7725,4
virid,404,2239,2201,1963,917,7724,4
skews,2206,137,1421,192,3767,7723,4
tewit,1264,2863,349,1963,1284,7723,4
guama,965,1824,1959,612,2362,7722,4
tuant,1264,1824,1959,1391,1284,7722,4
holli,844,3069,1603,1295,910,7721,4
frore,847,1543,1426,1225,2679,7720,4
tatum,1264,4103,1048,899,406,7720,4
buroo,1555,1824,2201,1282,857,7719,4
dyess,1128,458,1421,945,3767,7719,4
srini,2206,1543,1668,1391,910,7718,4
wheen,596,927,1421,3252,1522,7718,4
kedge,789,2863,774,612,2679,7717,4
unaus,420,671,1959,899,3767,7716,4
fiatt,847,2239,1959,1385,1284,7714,4
dexec,1128,2863,170,3252,300,7713,4
bogor,1555,3069,616,1282,1190,7712,4
heyse,844,2863,381,945,2679,7712,4
leche,1046,2863,701,423,2679,7712,4
repry,948,2863,560,1225,2116,7712,4
hiatt,844,2239,1959,1385,1284,7711,4
iller,473,1193,1603,3252,1190,7711,4
iraan,473,1543,1959,2214,1522,7711,4
judus,446,1824,774,899,3767,7710,4
legal,1046,2863,616,2214,971,7710,4
rufus,948,1824,271,899,3767,7709,4
ahola,1698,927,1426,1295,2362,7708,4
sisto,2206,2239,1021,1385,857,7708,4
smeek,2206,327,1421,3252,502,7708,4
bleep,1555,1193,1421,3252,285,7706,4
bozze,1555,3069,217,186,2679,7706,4
luxus,1046,1824,170,899,3767,7706,4
heath,844,2863,1959,1385,654,7705,4
ulous,420,1193,1426,899,3767,7705,4
erade,693,1543,1959,829,2679,7703,4
habib,844,4103,664,1963,129,7703,4
roark,948,3069,1959,1225,502,7703,4
boong,1555,3069,1426,1391,261,7702,4
ecass,693,338,1959,945,3767,7702,4
dodgy,1128,3069,774,612,2116,7699,4
jilly,446,2239,1603,1295,2116,7699,4
nixie,647,2239,170,1963,2679,7698,4
volva,404,3069,1603,259,2362,7697,4
pondo,1184,3069,1757,829,857,7696,4
buffs,1555,1824,271,278,3767,7695,4
pammi,1184,4103,885,612,910,7694,4
scada,2206,338,1959,829,2362,7694,4
dondi,1128,3069,1757,829,910,7693,4
eddas,693,245,774,2214,3767,7693,4
spada,2206,336,1959,829,2362,7692,4
alica,1698,1193,1668,770,2362,7691,4
cabob,1512,4103,664,1282,129,7690,4
frary,847,1543,1959,1225,2116,7690,4
grieg,965,1543,1668,3252,261,7689,4
steem,2206,403,1421,3252,406,7688,4
gemma,965,2863,885,612,2362,7687,4
kahau,789,4103,334,2214,247,7687,4
milam,1225,2239,1603,2214,406,7687,4
cetic,1512,2863,1048,1963,300,7686,4
fully,847,1824,1603,1295,2116,7685,4
tween,1264,226,1421,3252,1522,7685,4
greek,965,1543,1421,3252,502,7683,4
loord,1046,3069,1426,1225,917,7683,4
crepe,1512,1543,1421,526,2679,7681,4
duped,1128,1824,560,3252,917,7681,4
loyal,1046,3069,381,2214,971,7681,4
nitta,647,2239,1048,1385,2362,7681,4
brinn,1555,1543,1668,1391,1522,7679,4
brava,1555,1543,1959,259,2362,7678,4
hoppe,844,3069,560,526,2679,7678,4
nunce,647,1824,1757,770,2679,7677,4
hasht,844,4103,1021,423,1284,7675,4
urana,420,1543,1959,1391,2362,7675,4
zilla,176,2239,1603,1295,2362,7675,4
hedda,844,2863,774,829,2362,7672,4
roost,948,3069,1426,945,1284,7672,4
inria,473,671,2201,1963,2362,7670,4
purau,1184,1824,2201,2214,247,7670,4
shiah,2206,927,1668,2214,654,7669,4
urata,420,1543,1959,1385,2362,7669,4
vicia,404,2239,701,1963,2362,7669,4
skere,2206,137,1421,1225,2679,7668,4
burro,1555,1824,2201,1225,857,7662,4
kaiwi,789,4103,1668,192,910,7662,4
veega,404,2863,1421,612,2362,7662,4
budde,1555,1824,774,829,2679,7661,4
bilic,1555,2239,1603,1963,300,7660,4
ortet,532,1543,1048,3252,1284,7659,4
uller,420,1193,1603,3252,1190,7658,4
kenno,789,2863,1757,1391,857,7657,4
macco,1225,4103,701,770,857,7656,4
lepal,1046,2863,560,2214,971,7654,4
trapa,1264,1543,1959,526,2362,7654,4
tithe,1264,2239,1048,423,2679,7653,4
arjay,1698,1543,81,2214,2116,7652,4
cuffs,1512,1824,271,278,3767,7652,4
graal,965,1543,1959,2214,971,7652,4
typey,1264,458,560,3252,2116,7650,4
glene,965,1193,1421,1391,2679,7649,4
sibby,2206,2239,664,423,2116,7648,4
sippy,2206,2239,560,526,2116,7647,4
jerri,446,2863,2201,1225,910,7645,4
lieve,1046,2239,1421,259,2679,7644,4
nisan,647,2239,1021,2214,1522,7643,4
aroma,1698,1543,1426,612,2362,7641,4
yolky,225,3069,1603,628,2116,7641,4
moggy,1225,3069,616,612,2116,7638,4
jessa,446,2863,1021,945,2362,7637,4
fitty,847,2239,1048,1385,2116,7635,4
lotor,1046,3069,1048,1282,1190,7635,4
alvia,1698,1193,417,1963,2362,7633,4
crura,1512,1543,990,1225,2362,7632,4
eleia,693,1193,1421,1963,2362,7632,4
hoddy,844,3069,774,829,2116,7632,4
spaad,2206,336,1959,2214,917,7632,4
dreep,1128,1543,1421,3252,285,7629,4
aluta,1698,1193,990,1385,2362,7628,4
leddy,1046,2863,774,829,2116,7628,4
nassi,647,4103,1021,945,910,7626,4
reefy,948,2863,1421,278,2116,7626,4
alosa,1698,1193,1426,945,2362,7624,4
quata,93,1824,1959,1385,2362,7623,4
ouzos,532,1824,217,1282,3767,7622,4
toldo,1264,3069,1603,829,857,7622,4
tutin,1264,1824,1048,1963,1522,7621,4
behah,1555,2863,334,2214,654,7620,4
opsis,532,336,1021,1963,3767,7619,4
eigne,693,2239,616,1391,2679,7618,4
elite,693,1193,1668,1385,2679,7618,4
ameed,1698,327,1421,3252,917,7615,4
cechy,1512,2863,701,423,2116,7615,4
cheek,1512,927,1421,3252,502,7614,4
lissa,1046,2239,1021,945,2362,7613,4
niuan,647,2239,990,2214,1522,7612,4
yesty,225,2863,1021,1385,2116,7610,4
amase,1698,327,1959,945,2679,7608,4
codol,1512,3069,774,1282,971,7608,4
aquae,1698,25,990,2214,2679,7606,4
vexed,404,2863,170,3252,917,7606,4
braza,1555,1543,1959,186,2362,7605,4
debye,1128,2863,664,271,2679,7605,4
demmy,1128,2863,885,612,2116,7604,4
drama,1128,1543,1959,612,2362,7604,4
ghana,965,927,1959,1391,2362,7604,4
nordo,647,3069,2201,829,857,7603,4
sotho,2206,3069,1048,423,857,7603,4
bakki,1555,4103,406,628,910,7602,4
nunez,647,1824,1757,3252,122,7602,4
phene,1184,927,1421,1391,2679,7602,4
kyaks,789,458,1959,628,3767,7601,4
jubus,446,1824,664,899,3767,7600,4
elana,693,1193,1959,1391,2362,7598,4
dioon,1128,2239,1426,1282,1522,7597,4
poggy,1184,3069,616,612,2116,7597,4
asset,1698,341,1021,3252,1284,7596,4
heyde,844,2863,381,829,2679,7596,4
potti,1184,3069,1048,1385,910,7596,4
colob,1512,3069,1603,1282,129,7595,4
kosak,789,3069,1021,2214,502,7595,4
argan,1698,1543,616,2214,1522,7593,4
elata,693,1193,1959,1385,2362,7592,4
lokao,1046,3069,406,2214,857,7592,4
nessy,647,2863,1021,945,2116,7592,4
atter,1698,403,1048,3252,1190,7591,4
forgo,847,3069,2201,612,857,7586,4
kvass,789,126,1959,945,3767,7586,4
gutta,965,1824,1048,1385,2362,7584,4
vigia,404,2239,616,1963,2362,7584,4
cicad,1512,2239,701,2214,917,7583,4
nandu,647,4103,1757,829,247,7583,4
gaddi,965,4103,774,829,910,7581,4
anmia,1698,671,885,1963,2362,7579,4
beedi,1555,2863,1421,829,910,7578,4
ayina,1698,458,1668,1391,2362,7577,4
kitty,789,2239,1048,1385,2116,7577,4
alway,1698,1193,349,2214,2116,7570,4
pipra,1184,2239,560,1225,2362,7570,4
egret,693,139,2201,3252,1284,7569,4
nunry,647,1824,1757,1225,2116,7569,4
aioli,1698,2239,1426,1295,910,7568,4
aweel,1698,226,1421,3252,971,7568,4
jemez,446,2863,885,3252,122,7568,4
steep,2206,403,1421,3252,285,7567,4
eyers,693,458,1421,1225,3767,7564,4
raddi,948,4103,774,829,910,7564,4
cinct,1512,2239,1757,770,1284,7562,4
ionic,473,3069,1757,1963,300,7562,4
tokio,1264,3069,406,1963,857,7559,4
putty,1184,1824,1048,1385,2116,7557,4
tuart,1264,1824,1959,1225,1284,7556,4
weent,596,2863,1421,1391,1284,7555,4
miett,1225,2239,1421,1385,1284,7554,4
weott,596,2863,1426,1385,1284,7554,4
zakah,176,4103,406,2214,654,7553,4
occas,532,338,701,2214,3767,7552,4
toust,1264,3069,990,945,1284,7552,4
zooid,176,3069,1426,1963,917,7551,4
pryer,1184,1543,381,3252,1190,7550,4
alika,1698,1193,1668,628,2362,7549,4
elsie,693,1193,1021,1963,2679,7549,4
meeth,1225,2863,1421,1385,654,7548,4
tutly,1264,1824,1048,1295,2116,7547,4
missy,1225,2239,1021,945,2116,7546,4
norco,647,3069,2201,770,857,7544,4
nukus,647,1824,406,899,3767,7543,4
navvy,647,4103,417,259,2116,7542,4
doggy,1128,3069,616,612,2116,7541,4
dotti,1128,3069,1048,1385,910,7540,4
jibbs,446,2239,664,423,3767,7539,4
aimak,1698,2239,885,2214,502,7538,4
arusa,1698,1543,990,945,2362,7538,4
aneta,1698,671,1421,1385,2362,7537,4
boffa,1555,3069,271,278,2362,7535,4
redye,948,2863,774,271,2679,7535,4
toppy,1264,3069,560,526,2116,7535,4
alima,1698,1193,1668,612,2362,7533,4
boodh,1555,3069,1426,829,654,7533,4
guaba,965,1824,1959,423,2362,7533,4
stoat,2206,403,1426,2214,1284,7533,4
nisse,647,2239,1021,945,2679,7531,4
vonni,404,3069,1757,1391,910,7531,4
drida,1128,1543,1668,829,2362,7530,4
reddy,948,2863,774,829,2116,7530,4
kinky,789,2239,1757,628,2116,7529,4
ootid,532,3069,1048,1963,917,7529,4
klara,789,1193,1959,1225,2362,7528,4
glugs,965,1193,990,612,3767,7527,4
fifed,847,2239,271,3252,917,7526,4
alant,1698,1193,1959,1391,1284,7525,4
annoy,1698,671,1757,1282,2116,7524,4
kihei,789,2239,334,3252,910,7524,4
wedge,596,2863,774,612,2679,7524,4
annex,1698,671,1757,3252,144,7522,4
lemmy,1046,2863,885,612,2116,7522,4
tennu,1264,2863,1757,1391,247,7522,4
weepy,596,2863,1421,526,2116,7522,4
bulby,1555,1824,1603,423,2116,7521,4
mongo,1225,3069,1757,612,857,7520,4
blibe,1555,1193,1668,423,2679,7518,4
gobio,965,3069,664,1963,857,7518,4
toyon,1264,3069,381,1282,1522,7518,4
amene,1698,327,1421,1391,2679,7516,4
readd,948,2863,1959,829,917,7516,4
there,1264,927,1421,1225,2679,7516,4
helli,844,2863,1603,1295,910,7515,4
rissa,948,2239,1021,945,2362,7515,4
biddy,1555,2239,774,829,2116,7513,4
alman,1698,1193,885,2214,1522,7512,4
oobit,532,3069,664,1963,1284,7512,4
arand,1698,1543,1959,1391,917,7508,4
ossea,532,341,1021,3252,2362,7508,4
hersh,844,2863,2201,945,654,7507,4
irene,473,1543,1421,1391,2679,7507,4
aleda,1698,1193,1421,829,2362,7503,4
riffs,948,2239,271,278,3767,7503,4
asser,1698,341,1021,3252,1190,7502,4
feyly,847,2863,381,1295,2116,7502,4
viver,404,2239,417,3252,1190,7502,4
passu,1184,4103,1021,945,247,7500,4
dimit,1128,2239,885,1963,1284,7499,4
cobol,1512,3069,664,1282,971,7498,4
ewens,693,226,1421,1391,3767,7498,4
jixie,446,2239,170,1963,2679,7497,4
mobby,1225,3069,664,423,2116,7497,4
drear,1128,1543,1421,2214,1190,7496,4
moppy,1225,3069,560,526,2116,7496,4
arati,1698,1543,1959,1385,910,7495,4
askos,1698,341,406,1282,3767,7494,4
cruce,1512,1543,990,770,2679,7494,4
dryer,1128,1543,381,3252,1190,7494,4
bwana,1555,226,1959,1391,2362,7493,4
coorg,1512,3069,1426,1225,261,7493,4
mambo,1225,4103,885,423,857,7493,4
dowdy,1128,3069,349,829,2116,7491,4
velva,404,2863,1603,259,2362,7491,4
magog,1225,4103,616,1282,261,7487,4
amaty,1698,327,1959,1385,2116,7485,4
woofy,596,3069,1426,278,2116,7485,4
chese,1512,927,1421,945,2679,7484,4
mekka,1225,2863,406,628,2362,7484,4
zappy,176,4103,560,526,2116,7481,4
wisse,596,2239,1021,945,2679,7480,4
pongo,1184,3069,1757,612,857,7479,4
geest,965,2863,1421,945,1284,7478,4
nanji,647,4103,1757,61,910,7478,4
erbaa,693,1543,664,2214,2362,7476,4
kraal,789,1543,1959,2214,971,7476,4
nedda,647,2863,774,829,2362,7475,4
rajab,948,4103,81,2214,129,7475,4
artal,1698,1543,1048,2214,971,7474,4
raviv,948,4103,417,1963,41,7472,4
aroon,1698,1543,1426,1282,1522,7471,4
praha,1184,1543,1959,423,2362,7471,4
amain,1698,327,1959,1963,1522,7469,4
andia,1698,671,774,1963,2362,7468,4
astms,1698,341,1048,612,3767,7466,4
maggi,1225,4103,616,612,910,7466,4
redid,948,2863,774,1963,917,7465,4
wiatt,596,2239,1959,1385,1284,7463,4
friar,847,1543,1668,2214,1190,7462,4
hello,844,2863,1603,1295,857,7462,4
bussy,1555,1824,1021,945,2116,7461,4
cilix,1512,2239,1603,1963,144,7461,4
reest,948,2863,1421,945,1284,7461,4
socko,2206,3069,701,628,857,7461,4
kelli,789,2863,1603,1295,910,7460,4
rondo,948,3069,1757,829,857,7460,4
xenon,36,2863,1757,1282,1522,7460,4
isbas,473,341,664,2214,3767,7459,4
loggy,1046,3069,616,612,2116,7459,4
lotti,1046,3069,1048,1385,910,7458,4
rammi,948,4103,885,612,910,7458,4
breve,1555,1543,1421,259,2679,7457,4
litai,1046,2239,1048,2214,910,7457,4
pobby,1184,3069,664,423,2116,7456,4
apina,1698,336,1668,1391,2362,7455,4
abase,1698,172,1959,945,2679,7453,4
deeth,1128,2863,1421,1385,654,7451,4
vepse,404,2863,560,945,2679,7451,4
estey,693,341,1048,3252,2116,7450,4
bixin,1555,2239,170,1963,1522,7449,4
napoo,647,4103,560,1282,857,7449,4
ennia,693,671,1757,1963,2362,7446,4
neill,647,2863,1668,1295,971,7444,4
asian,1698,341,1668,2214,1522,7443,4
elset,693,1193,1021,3252,1284,7443,4
pinic,1184,2239,1757,1963,300,7443,4
apace,1698,336,1959,770,2679,7442,4
nawab,647,4103,349,2214,129,7442,4
gemmy,965,2863,885,612,2116,7441,4
grama,965,1543,1959,612,2362,7441,4
trant,1264,1543,1959,1391,1284,7441,4
amita,1698,327,1668,1385,2362,7440,4
apian,1698,336,1668,2214,1522,7438,4
rurik,948,1824,2201,1963,502,7438,4
vitta,404,2239,1048,1385,2362,7438,4
bunni,1555,1824,1757,1391,910,7437,4
edmea,693,245,885,3252,2362,7437,4
innet,473,671,1757,3252,1284,7437,4
irina,473,1543,1668,1391,2362,7437,4
britt,1555,1543,1668,1385,1284,7435,4
nitty,647,2239,1048,1385,2116,7435,4
noddy,647,3069,774,829,2116,7435,4
elden,693,1193,774,3252,1522,7434,4
murut,1225,1824,2201,899,1284,7433,4
brenn,1555,1543,1421,1391,1522,7432,4
elara,693,1193,1959,1225,2362,7432,4
meggy,1225,2863,616,612,2116,7432,4
irita,473,1543,1668,1385,2362,7431,4
bohor,1555,3069,334,1282,1190,7430,4
heezy,844,2863,1421,186,2116,7430,4
atila,1698,403,1668,1295,2362,7426,4
eifel,693,2239,271,3252,971,7426,4
heddy,844,2863,774,829,2116,7426,4
koord,789,3069,1426,1225,917,7426,4
fionn,847,2239,1426,1391,1522,7425,4
ivins,473,126,1668,1391,3767,7425,4
unius,420,671,1668,899,3767,7425,4
refry,948,2863,271,1225,2116,7423,4
rerob,948,2863,2201,1282,129,7423,4
irian,473,1543,1668,2214,1522,7420,4
hatch,844,4103,1048,770,654,7419,4
hedve,844,2863,774,259,2679,7419,4
negev,647,2863,616,3252,41,7419,4
nunda,647,1824,1757,829,2362,7419,4
homam,844,3069,885,2214,406,7418,4
astay,1698,341,1048,2214,2116,7417,4
limit,1046,2239,885,1963,1284,7417,4
russe,948,1824,1021,945,2679,7417,4
rerow,948,2863,2201,1282,122,7416,4
bhaga,1555,927,1959,612,2362,7415,4
draba,1128,1543,1959,423,2362,7415,4
spann,2206,336,1959,1391,1522,7414,4
nevin,647,2863,417,1963,1522,7412,4
spece,2206,336,1421,770,2679,7412,4
aynat,1698,458,1757,2214,1284,7411,4
erena,693,1543,1421,1391,2362,7410,4
mimsy,1225,2239,885,945,2116,7410,4
rhoeo,948,927,1426,3252,857,7410,4
konyn,789,3069,1757,271,1522,7408,4
kutta,789,1824,1048,1385,2362,7408,4
abaue,1698,172,1959,899,2679,7407,4
haddo,844,4103,774,829,857,7407,4
lencl,1046,2863,1757,770,971,7407,4
razoo,948,4103,217,1282,857,7407,4
restr,948,2863,1021,1385,1190,7407,4
ascus,1698,341,701,899,3767,7406,4
ctene,1512,403,1421,1391,2679,7406,4
iline,473,1193,1668,1391,2679,7404,4
tuffs,1264,1824,271,278,3767,7404,4
accus,1698,338,701,899,3767,7403,4
adaty,1698,245,1959,1385,2116,7403,4
noell,647,3069,1421,1295,971,7403,4
lilac,1046,2239,1603,2214,300,7402,4
ormer,532,1543,885,3252,1190,7402,4
aldan,1698,1193,774,2214,1522,7401,4
rearm,948,2863,1959,1225,406,7401,4
regga,948,2863,616,612,2362,7401,4
ronco,948,3069,1757,770,857,7401,4
dobby,1128,3069,664,423,2116,7400,4
kieye,789,2239,1421,271,2679,7399,4
evens,693,126,1421,1391,3767,7398,4
gigue,965,2239,616,899,2679,7398,4
reccy,948,2863,701,770,2116,7398,4
cheep,1512,927,1421,3252,285,7397,4
emlen,693,327,1603,3252,1522,7397,4
lessn,1046,2863,1021,945,1522,7397,4
secco,2206,2863,701,770,857,7397,4
cunni,1512,1824,1757,1391,910,7394,4
weill,596,2863,1668,1295,971,7393,4
woozy,596,3069,1426,186,2116,7393,4
jessy,446,2863,1021,945,2116,7391,4
kerki,789,2863,2201,628,910,7391,4
peggy,1184,2863,616,612,2116,7391,4
sloot,2206,1193,1426,1282,1284,7391,4
petti,1184,2863,1048,1385,910,7390,4
sweep,2206,226,1421,3252,285,7390,4
msdos,1225,341,774,1282,3767,7389,4
chaka,1512,927,1959,628,2362,7388,4
dinic,1128,2239,1757,1963,300,7387,4
enate,693,671,1959,1385,2679,7387,4
wheer,596,927,1421,3252,1190,7386,4
unnet,420,671,1757,3252,1284,7384,4
witty,596,2239,1048,1385,2116,7384,4
ahsan,1698,927,1021,2214,1522,7382,4
anora,1698,671,1426,1225,2362,7382,4
doyon,1128,3069,381,1282,1522,7382,4
cubeb,1512,1824,664,3252,129,7381,4
gimme,965,2239,885,612,2679,7380,4
grece,965,1543,1421,770,2679,7378,4
ilana,473,1193,1959,1391,2362,7378,4
blatt,1555,1193,1959,1385,1284,7376,4
bpete,1555,336,1421,1385,2679,7376,4
orary,532,1543,1959,1225,2116,7375,4
ricin,948,2239,701,1963,1522,7373,4
chaga,1512,927,1959,612,2362,7372,4
chama,1512,927,1959,612,2362,7372,4
moong,1225,3069,1426,1391,261,7372,4
turro,1264,1824,2201,1225,857,7371,4
guinn,965,1824,1668,1391,1522,7370,4
guava,965,1824,1959,259,2362,7369,4
leeth,1046,2863,1421,1385,654,7369,4
atake,1698,403,1959,628,2679,7367,4
bmete,1555,327,1421,1385,2679,7367,4
jenni,446,2863,1757,1391,910,7367,4
lissy,1046,2239,1021,945,2116,7367,4
nanmu,647,4103,1757,612,247,7366,4
rhene,948,927,1421,1391,2679,7366,4
theek,1264,927,1421,3252,502,7366,4
muffs,1225,1824,271,278,3767,7365,4
adina,1698,245,1668,1391,2362,7364,4
tabbi,1264,4103,664,423,910,7364,4
shoon,2206,927,1426,1282,1522,7363,4
crecy,1512,1543,1421,770,2116,7362,4
lassu,1046,4103,1021,945,247,7362,4
swede,2206,226,1421,829,2679,7361,4
dykey,1128,458,406,3252,2116,7360,4
feest,847,2863,1421,945,1284,7360,4
addie,1698,245,774,1963,2679,7359,4
theta,1264,927,1421,1385,2362,7359,4
aryan,1698,1543,381,2214,1522,7358,4
shall,2206,927,1959,1295,971,7358,4
toosh,1264,3069,1426,945,654,7358,4
hondo,844,3069,1757,829,857,7356,4
hacht,844,4103,701,423,1284,7355,4
pratt,1184,1543,1959,1385,1284,7355,4
going,965,3069,1668,1391,261,7354,4
ammer,1698,327,885,3252,1190,7352,4
valyl,404,4103,1603,271,971,7352,4
atame,1698,403,1959,612,2679,7351,4
mlaga,1225,1193,1959,612,2362,7351,4
kodak,789,3069,774,2214,502,7348,4
crewe,1512,1543,1421,192,2679,7347,4
cozza,1512,3069,217,186,2362,7346,4
eclss,693,338,1603,945,3767,7346,4
furor,847,1824,2201,1282,1190,7344,4
altar,1698,1193,1048,2214,1190,7343,4
inner,473,671,1757,3252,1190,7343,4
longo,1046,3069,1757,612,857,7341,4
orzos,532,1543,217,1282,3767,7341,4
adele,1698,245,1421,1295,2679,7338,4
arrgt,1698,1543,2201,612,1284,7338,4
gutty,965,1824,1048,1385,2116,7338,4
opeos,532,336,1421,1282,3767,7338,4
ednie,693,245,1757,1963,2679,7337,4
petto,1184,2863,1048,1385,857,7337,4
fogon,847,3069,616,1282,1522,7336,4
ticca,1264,2239,701,770,2362,7336,4
bosom,1555,3069,1021,1282,406,7333,4
elevs,693,1193,1421,259,3767,7333,4
gleek,965,1193,1421,3252,502,7333,4
ewers,693,226,1421,1225,3767,7332,4
clepe,1512,1193,1421,526,2679,7331,4
lynne,1046,458,1757,1391,2679,7331,4
mudde,1225,1824,774,829,2679,7331,4
lipin,1046,2239,560,1963,1522,7330,4
blinn,1555,1193,1668,1391,1522,7329,4
goico,965,3069,1668,770,857,7329,4
noibn,647,3069,1668,423,1522,7329,4
agene,1698,139,1421,1391,2679,7328,4
arhna,1698,1543,334,1391,2362,7328,4
broon,1555,1543,1426,1282,1522,7328,4
hathi,844,4103,1048,423,910,7328,4
akene,1698,137,1421,1391,2679,7326,4
didal,1128,2239,774,2214,971,7326,4
amary,1698,327,1959,1225,2116,7325,4
ulana,420,1193,1959,1391,2362,7325,4
puffs,1184,1824,271,278,3767,7324,4
agete,1698,139,1421,1385,2679,7322,4
rutty,948,1824,1048,1385,2116,7321,4
praya,1184,1543,1959,271,2362,7319,4
sibiu,2206,2239,664,1963,247,7319,4
lobby,1046,3069,664,423,2116,7318,4
nelli,647,2863,1603,1295,910,7318,4
volto,404,3069,1603,1385,857,7318,4
loppy,1046,3069,560,526,2116,7317,4
tsana,1264,341,1959,1391,2362,7317,4
tinct,1264,2239,1757,770,1284,7314,4
moism,1225,3069,1668,945,406,7313,4
neche,647,2863,701,423,2679,7313,4
anded,1698,671,774,3252,917,7312,4
angia,1698,671,616,1963,2362,7310,4
kidde,789,2239,774,829,2679,7310,4
plaga,1184,1193,1959,612,2362,7310,4
papyr,1184,4103,560,271,1190,7308,4
toxon,1264,3069,170,1282,1522,7307,4
koppa,789,3069,560,526,2362,7306,4
praam,1184,1543,1959,2214,406,7306,4
agade,1698,139,1959,829,2679,7304,4
bottu,1555,3069,1048,1385,247,7304,4
breba,1555,1543,1421,423,2362,7304,4
resor,948,2863,1021,1282,1190,7304,4
swann,2206,226,1959,1391,1522,7304,4
woold,596,3069,1426,1295,917,7303,4
keest,789,2863,1421,945,1284,7302,4
siepi,2206,2239,1421,526,910,7302,4
edrei,693,245,2201,3252,910,7301,4
kondo,789,3069,1757,829,857,7301,4
dyana,1128,458,1959,1391,2362,7298,4
agaty,1698,139,1959,1385,2116,7297,4
guaza,965,1824,1959,186,2362,7296,4
jembe,446,2863,885,423,2679,7296,4
nakoo,647,4103,406,1282,857,7295,4
bessi,1555,2863,1021,945,910,7294,4
alban,1698,1193,664,2214,1522,7291,4
aloma,1698,1193,1426,612,2362,7291,4
bsele,1555,341,1421,1295,2679,7291,4
order,532,1543,774,3252,1190,7291,4
rosol,948,3069,1021,1282,971,7291,4
bindi,1555,2239,1757,829,910,7290,4
kreep,789,1543,1421,3252,285,7290,4
silyl,2206,2239,1603,271,971,7290,4
chapa,1512,927,1959,526,2362,7286,4
erose,693,1543,1426,945,2679,7286,4
clava,1512,1193,1959,259,2362,7285,4
croon,1512,1543,1426,1282,1522,7285,4
dreda,1128,1543,1421,829,2362,7283,4
stoit,2206,403,1426,1963,1284,7282,4
again,1698,139,1959,1963,1522,7281,4
eslie,693,341,1603,1963,2679,7279,4
oisin,532,2239,1021,1963,1522,7277,4
skeeg,2206,137,1421,3252,261,7277,4
biagi,1555,2239,1959,612,910,7275,4
grory,965,1543,1426,1225,2116,7275,4
jedda,446,2863,774,829,2362,7274,4
fomor,847,3069,885,1282,1190,7273,4
ficin,847,2239,701,1963,1522,7272,4
douro,1128,3069,990,1225,857,7269,4
adila,1698,245,1668,1295,2362,7268,4
duffs,1128,1824,271,278,3767,7268,4
shisn,2206,927,1668,945,1522,7268,4
timid,1264,2239,885,1963,917,7268,4
abele,1698,172,1421,1295,2679,7265,4
krama,789,1543,1959,612,2362,7265,4
beech,1555,2863,1421,770,654,7263,4
foggy,847,3069,616,612,2116,7260,4
rebba,948,2863,664,423,2362,7260,4
tillo,1264,2239,1603,1295,857,7258,4
hoggy,844,3069,616,612,2116,7257,4
bynin,1555,458,1757,1963,1522,7255,4
zebec,176,2863,664,3252,300,7255,4
leggy,1046,2863,616,612,2116,7253,4
pulpy,1184,1824,1603,526,2116,7253,4
bihai,1555,2239,334,2214,910,7252,4
drinn,1128,1543,1668,1391,1522,7252,4
letti,1046,2863,1048,1385,910,7252,4
drava,1128,1543,1959,259,2362,7251,4
akita,1698,137,1668,1385,2362,7250,4
lidda,1046,2239,774,829,2362,7250,4
tobol,1264,3069,664,1282,971,7250,4
kazoo,789,4103,217,1282,857,7248,4
moham,1225,3069,334,2214,406,7248,4
cindi,1512,2239,1757,829,910,7247,4
robot,948,3069,664,1282,1284,7247,4
agace,1698,139,1959,770,2679,7245,4
egers,693,139,1421,1225,3767,7245,4
nieve,647,2239,1421,259,2679,7245,4
zeeba,176,2863,1421,423,2362,7245,4
idria,473,245,2201,1963,2362,7244,4
erron,693,1543,2201,1282,1522,7241,4
jawab,446,4103,349,2214,129,7241,4
chica,1512,927,1668,770,2362,7239,4
lhasa,1046,927,1959,945,2362,7239,4
gobby,965,3069,664,423,2116,7237,4
alcoa,1698,1193,701,1282,2362,7236,4
kapok,789,4103,560,1282,502,7236,4
these,1264,927,1421,945,2679,7236,4
hithe,844,2239,1048,423,2679,7233,4
licit,1046,2239,701,1963,1284,7233,4
evers,693,126,1421,1225,3767,7232,4
vedda,404,2863,774,829,2362,7232,4
digit,1128,2239,616,1963,1284,7230,4
neddy,647,2863,774,829,2116,7229,4
whata,596,927,1959,1385,2362,7229,4
avian,1698,126,1668,2214,1522,7228,4
bubal,1555,1824,664,2214,971,7228,4
epner,693,336,1757,3252,1190,7228,4
shott,2206,927,1426,1385,1284,7228,4
zupus,176,1824,560,899,3767,7226,4
ellan,693,1193,1603,2214,1522,7225,4
agral,1698,139,2201,2214,971,7223,4
dread,1128,1543,1421,2214,917,7223,4
vuggs,404,1824,616,612,3767,7223,4
tiddy,1264,2239,774,829,2116,7222,4
twite,1264,226,1668,1385,2679,7222,4
robby,948,3069,664,423,2116,7220,4
pylle,1184,458,1603,1295,2679,7219,4
bcere,1555,338,1421,1225,2679,7218,4
gonof,965,3069,1757,1282,145,7218,4
spaak,2206,336,1959,2214,502,7217,4
shirr,2206,927,1668,1225,1190,7216,4
coyol,1512,3069,381,1282,971,7215,4
frear,847,1543,1421,2214,1190,7215,4
tynan,1264,458,1757,2214,1522,7215,4
hotol,844,3069,1048,1282,971,7214,4
nissa,647,2239,1021,945,2362,7214,4
elmer,693,1193,885,3252,1190,7213,4
fryer,847,1543,381,3252,1190,7213,4
bucca,1555,1824,701,770,2362,7212,4
iorgo,473,3069,2201,612,857,7212,4
nauru,647,4103,990,1225,247,7212,4
bohol,1555,3069,334,1282,971,7211,4
bevvy,1555,2863,417,259,2116,7210,4
apeek,1698,336,1421,3252,502,7209,4
deeyn,1128,2863,1421,271,1522,7205,4
aceta,1698,338,1421,1385,2362,7204,4
jomon,446,3069,885,1282,1522,7204,4
haugh,844,4103,990,612,654,7203,4
ahura,1698,927,990,1225,2362,7202,4
joell,446,3069,1421,1295,971,7202,4
phaca,1184,927,1959,770,2362,7202,4
twana,1264,226,1959,1391,2362,7202,4
amena,1698,327,1421,1391,2362,7199,4
kokil,789,3069,406,1963,971,7198,4
asean,1698,341,1421,2214,1522,7196,4
odors,532,245,1426,1225,3767,7195,4
anear,1698,671,1421,2214,1190,7194,4
arzan,1698,1543,217,2214,1522,7194,4
debby,1128,2863,664,423,2116,7194,4
acean,1698,338,1421,2214,1522,7193,4
adage,1698,245,1959,612,2679,7193,4
brott,1555,1543,1426,1385,1284,7193,4
deppy,1128,2863,560,526,2116,7193,4
aliya,1698,1193,1668,271,2362,7192,4
elbie,693,1193,664,1963,2679,7192,4
ligge,1046,2239,616,612,2679,7192,4
obols,532,172,1426,1295,3767,7192,4
piaui,1184,2239,1959,899,910,7191,4
awake,1698,226,1959,628,2679,7190,4
brett,1555,1543,1421,1385,1284,7188,4
apiin,1698,336,1668,1963,1522,7187,4
gowon,965,3069,349,1282,1522,7187,4
hokah,844,3069,406,2214,654,7187,4
luffs,1046,1824,271,278,3767,7186,4
middy,1225,2239,774,829,2116,7183,4
norrv,647,3069,2201,1225,41,7183,4
aface,1698,73,1959,770,2679,7179,4
elise,693,1193,1668,945,2679,7178,4
tolyl,1264,3069,1603,271,971,7178,4
ahead,1698,927,1421,2214,917,7177,4
abbie,1698,172,664,1963,2679,7176,4
gilim,965,2239,1603,1963,406,7176,4
likin,1046,2239,406,1963,1522,7176,4
users,420,341,1421,1225,3767,7174,4
hiett,844,2239,1421,1385,1284,7173,4
inane,473,671,1959,1391,2679,7173,4
erdei,693,1543,774,3252,910,7172,4
scatt,2206,338,1959,1385,1284,7172,4
wahoo,596,4103,334,1282,857,7172,4
erode,693,1543,1426,829,2679,7170,4
joost,446,3069,1426,945,1284,7170,4
mossi,1225,3069,1021,945,910,7170,4
sysin,2206,458,1021,1963,1522,7170,4
tussy,1264,1824,1021,945,2116,7170,4
anica,1698,671,1668,770,2362,7169,4
cohol,1512,3069,334,1282,971,7168,4
ehden,693,927,774,3252,1522,7168,4
jemma,446,2863,885,612,2362,7168,4
pipal,1184,2239,560,2214,971,7168,4
cheke,1512,927,1421,628,2679,7167,4
wheel,596,927,1421,3252,971,7167,4
hissy,844,2239,1021,945,2116,7165,4
ulmus,420,1193,885,899,3767,7164,4
adder,1698,245,774,3252,1190,7159,4
golgi,965,3069,1603,612,910,7159,4
aland,1698,1193,1959,1391,917,7158,4
heuau,844,2863,990,2214,247,7158,4
orola,532,1543,1426,1295,2362,7158,4
scuse,2206,338,990,945,2679,7158,4
frory,847,1543,1426,1225,2116,7157,4
ilene,473,1193,1421,1391,2679,7157,4
odiss,532,245,1668,945,3767,7157,4
dibai,1128,2239,664,2214,910,7155,4
reggy,948,2863,616,612,2116,7155,4
alani,1698,1193,1959,1391,910,7151,4
cheme,1512,927,1421,612,2679,7151,4
avila,1698,126,1668,1295,2362,7149,4
smuse,2206,327,990,945,2679,7147,4
apair,1698,336,1959,1963,1190,7146,4
tilth,1264,2239,1603,1385,654,7145,4
limma,1046,2239,885,612,2362,7144,4
mooch,1225,3069,1426,770,654,7144,4
azral,1698,59,2201,2214,971,7143,4
neeld,647,2863,1421,1295,917,7143,4
biggy,1555,2239,616,612,2116,7138,4
imams,473,327,1959,612,3767,7138,4
gratt,965,1543,1959,1385,1284,7136,4
lesli,1046,2863,1021,1295,910,7135,4
makuk,1225,4103,406,899,502,7135,4
hupeh,844,1824,560,3252,654,7134,4
tweel,1264,226,1421,3252,971,7134,4
rudra,948,1824,774,1225,2362,7133,4
yaboo,225,4103,664,1282,857,7131,4
mussy,1225,1824,1021,945,2116,7131,4
appet,1698,336,560,3252,1284,7130,4
await,1698,226,1959,1963,1284,7130,4
wawro,596,4103,349,1225,857,7130,4
orose,532,1543,1426,945,2679,7125,4
shoot,2206,927,1426,1282,1284,7125,4
attle,1698,403,1048,1295,2679,7123,4
adona,1698,245,1426,1391,2362,7122,4
eucre,693,1824,701,1225,2679,7122,4
arupa,1698,1543,990,526,2362,7119,4
foppy,847,3069,560,526,2116,7118,4
licca,1046,2239,701,770,2362,7118,4
adena,1698,245,1421,1391,2362,7117,4
epeus,693,336,1421,899,3767,7116,4
hobby,844,3069,664,423,2116,7116,4
timmy,1264,2239,885,612,2116,7116,4
hoppy,844,3069,560,526,2116,7115,4
xebec,36,2863,664,3252,300,7115,4
heidi,844,2863,1668,829,910,7114,4
ociaa,532,338,1668,2214,2362,7114,4
beeck,1555,2863,1421,770,502,7111,4
leppy,1046,2863,560,526,2116,7111,4
niall,647,2239,1959,1295,971,7111,4
bhatt,1555,927,1959,1385,1284,7110,4
bisti,1555,2239,1021,1385,910,7110,4
kissy,789,2239,1021,945,2116,7110,4
theat,1264,927,1421,2214,1284,7110,4
weest,596,2863,1421,945,1284,7109,4
aliza,1698,1193,1668,186,2362,7107,4
emeus,693,327,1421,899,3767,7107,4
givin,965,2239,417,1963,1522,7106,4
guffs,965,1824,271,278,3767,7105,4
kassu,789,4103,1021,945,247,7105,4
kneel,789,671,1421,3252,971,7104,4
nammo,647,4103,885,612,857,7104,4
pooch,1184,3069,1426,770,654,7103,4
aloha,1698,1193,1426,423,2362,7102,4
civil,1512,2239,417,1963,971,7102,4
elder,693,1193,774,3252,1190,7102,4
frege,847,1543,1421,612,2679,7102,4
arioi,1698,1543,1668,1282,910,7101,4
aweek,1698,226,1421,3252,502,7099,4
alano,1698,1193,1959,1391,857,7098,4
buddy,1555,1824,774,829,2116,7098,4
puett,1184,1824,1421,1385,1284,7098,4
kecky,789,2863,701,628,2116,7097,4
aggie,1698,139,616,1963,2679,7095,4
arank,1698,1543,1959,1391,502,7093,4
sisco,2206,2239,1021,770,857,7093,4
agnat,1698,139,1757,2214,1284,7092,4
akira,1698,137,1668,1225,2362,7090,4
impis,473,327,560,1963,3767,7090,4
pussy,1184,1824,1021,945,2116,7090,4
firmr,847,2239,2201,612,1190,7089,4
dioti,1128,2239,1426,1385,910,7088,4
dtset,1128,403,1021,3252,1284,7088,4
faggi,847,4103,616,612,910,7088,4
ruffs,948,1824,271,278,3767,7088,4
glede,965,1193,1421,829,2679,7087,4
preve,1184,1543,1421,259,2679,7086,4
tuath,1264,1824,1959,1385,654,7086,4
blitt,1555,1193,1668,1385,1284,7085,4
haggi,844,4103,616,612,910,7085,4
topoi,1264,3069,560,1282,910,7085,4
bitto,1555,2239,1048,1385,857,7084,4
kongo,789,3069,1757,612,857,7084,4
tweed,1264,226,1421,3252,917,7080,4
start,2206,403,1959,1225,1284,7077,4
ushas,420,341,334,2214,3767,7076,4
artha,1698,1543,1048,423,2362,7074,4
arhat,1698,1543,334,2214,1284,7073,4
wemmy,596,2863,885,612,2116,7072,4
cosmo,1512,3069,1021,612,857,7071,4
ilian,473,1193,1668,2214,1522,7070,4
inned,473,671,1757,3252,917,7070,4
jazzy,446,4103,217,186,2116,7068,4
shill,2206,927,1668,1295,971,7067,4
buell,1555,1824,1421,1295,971,7066,4
ngwee,647,139,349,3252,2679,7066,4
ninja,647,2239,1757,61,2362,7066,4
gabbi,965,4103,664,423,910,7065,4
jutta,446,1824,1048,1385,2362,7065,4
snast,2206,671,1959,945,1284,7065,4
cleve,1512,1193,1421,259,2679,7064,4
ebner,693,172,1757,3252,1190,7064,4
gylys,965,458,1603,271,3767,7064,4
imids,473,327,1668,829,3767,7064,4
jello,446,2863,1603,1295,857,7064,4
altai,1698,1193,1048,2214,910,7063,4
bhava,1555,927,1959,259,2362,7062,4
elide,693,1193,1668,829,2679,7062,4
allot,1698,1193,1603,1282,1284,7060,4
elena,693,1193,1421,1391,2362,7060,4
yeply,225,2863,560,1295,2116,7059,4
mozza,1225,3069,217,186,2362,7059,4
arjan,1698,1543,81,2214,1522,7058,4
thatn,1264,927,1959,1385,1522,7057,4
adair,1698,245,1959,1963,1190,7055,4
cuddy,1512,1824,774,829,2116,7055,4
ludly,1046,1824,774,1295,2116,7055,4
cotch,1512,3069,1048,770,654,7053,4
ponzo,1184,3069,1757,186,857,7053,4
pupin,1184,1824,560,1963,1522,7053,4
hetti,844,2863,1048,1385,910,7050,4
kneed,789,671,1421,3252,917,7050,4
lippe,1046,2239,560,526,2679,7050,4
emane,693,327,1959,1391,2679,7049,4
kinic,789,2239,1757,1963,300,7048,4
rabbi,948,4103,664,423,910,7048,4
mdlle,1225,245,1603,1295,2679,7047,4
lumme,1046,1824,885,612,2679,7046,4
rimma,948,2239,885,612,2362,7046,4
alvan,1698,1193,417,2214,1522,7044,4
elean,693,1193,1421,2214,1522,7043,4
argal,1698,1543,616,2214,971,7042,4
rerub,948,2863,2201,899,129,7040,4
amora,1698,327,1426,1225,2362,7038,4
thapa,1264,927,1959,526,2362,7038,4
vivle,404,2239,417,1295,2679,7034,4
biabo,1555,2239,1959,423,857,7033,4
brill,1555,1543,1668,1295,971,7032,4
chaya,1512,927,1959,271,2362,7031,4
grebe,965,1543,1421,423,2679,7031,4
koslo,789,3069,1021,1295,857,7031,4
shoor,2206,927,1426,1282,1190,7031,4
sofko,2206,3069,271,628,857,7031,4
shist,2206,927,1668,945,1284,7030,4
aleak,1698,1193,1421,2214,502,7028,4
aurum,1698,1824,2201,899,406,7028,4
jeddy,446,2863,774,829,2116,7028,4
mikir,1225,2239,406,1963,1190,7023,4
uchee,420,338,334,3252,2679,7023,4
adeem,1698,245,1421,3252,406,7022,4
adela,1698,245,1421,1295,2362,7021,4
urger,420,1543,616,3252,1190,7021,4
nutty,647,1824,1048,1385,2116,7020,4
ricca,948,2239,701,770,2362,7020,4
ambay,1698,327,664,2214,2116,7019,4
jheel,446,927,1421,3252,971,7017,4
aruba,1698,1543,990,423,2362,7016,4
ambia,1698,327,664,1963,2362,7014,4
lynna,1046,458,1757,1391,2362,7014,4
agena,1698,139,1421,1391,2362,7011,4
anima,1698,671,1668,612,2362,7011,4
glial,965,1193,1668,2214,971,7011,4
jaddo,446,4103,774,829,857,7009,4
bocci,1555,3069,701,770,910,7005,4
ohara,532,927,1959,1225,2362,7005,4
platt,1184,1193,1959,1385,1284,7005,4
antra,1698,671,1048,1225,2362,7004,4
dhaka,1128,927,1959,628,2362,7004,4
hurri,844,1824,2201,1225,910,7004,4
liddy,1046,2239,774,829,2116,7004,4
tessi,1264,2863,1021,945,910,7003,4
drury,1128,1543,990,1225,2116,7002,4
agape,1698,139,1959,526,2679,7001,4
brunn,1555,1543,990,1391,1522,7001,4
jiffs,446,2239,271,278,3767,7001,4
kilim,789,2239,1603,1963,406,7000,4
avena,1698,126,1421,1391,2362,6998,4
toffy,1264,3069,271,278,2116,6998,4
choca,1512,927,1426,770,2362,6997,4
couch,1512,3069,990,770,654,6995,4
ketti,789,2863,1048,1385,910,6995,4
mumsy,1225,1824,885,945,2116,6995,4
figge,847,2239,616,612,2679,6993,4
strut,2206,403,2201,899,1284,6993,4
alard,1698,1193,1959,1225,917,6992,4
autun,1698,1824,1048,899,1522,6991,4
irisa,473,1543,1668,945,2362,6991,4
penup,1184,2863,1757,899,285,6988,4
huffs,844,1824,271,278,3767,6984,4
recor,948,2863,701,1282,1190,6984,4
starr,2206,403,1959,1225,1190,6983,4
fraya,847,1543,1959,271,2362,6982,4
khasa,789,927,1959,945,2362,6982,4
dimmy,1128,2239,885,612,2116,6980,4
ulcus,420,1193,701,899,3767,6980,4
echea,693,338,334,3252,2362,6979,4
peetz,1184,2863,1421,1385,122,6975,4
ellin,693,1193,1603,1963,1522,6974,4
pudda,1184,1824,774,829,2362,6973,4
nunky,647,1824,1757,628,2116,6972,4
odeen,532,245,1421,3252,1522,6972,4
sunup,2206,1824,1757,899,285,6971,4
urlar,420,1543,1603,2214,1190,6970,4
monjo,1225,3069,1757,61,857,6969,4
playa,1184,1193,1959,271,2362,6969,4
sherr,2206,927,1421,1225,1190,6969,4
nissy,647,2239,1021,945,2116,6968,4
steve,2206,403,1421,259,2679,6968,4
kabob,789,4103,664,1282,129,6967,4
looch,1046,3069,1426,770,654,6965,4
freir,847,1543,1421,1963,1190,6964,4
yorgo,225,3069,2201,612,857,6964,4
vivre,404,2239,417,1225,2679,6964,4
abyss,1698,172,381,945,3767,6963,4
joppa,446,3069,560,526,2362,6963,4
wryer,596,1543,381,3252,1190,6962,4
curch,1512,1824,2201,770,654,6961,4
accel,1698,338,701,3252,971,6960,4
mindi,1225,2239,1757,829,910,6960,4
ilise,473,1193,1668,945,2679,6958,4
otate,532,403,1959,1385,2679,6958,4
dunno,1128,1824,1757,1391,857,6957,4
leeco,1046,2863,1421,770,857,6957,4
skuse,2206,137,990,945,2679,6957,4
slash,2206,1193,1959,945,654,6957,4
adora,1698,245,1426,1225,2362,6956,4
etrem,693,403,2201,3252,406,6955,4
ohone,532,927,1426,1391,2679,6955,4
stint,2206,403,1668,1391,1284,6952,4
poock,1184,3069,1426,770,502,6951,4
adlar,1698,245,1603,2214,1190,6950,4
trior,1264,1543,1668,1282,1190,6947,4
anura,1698,671,990,1225,2362,6946,4
bifid,1555,2239,271,1963,917,6945,4
elvie,693,1193,417,1963,2679,6945,4
elger,693,1193,616,3252,1190,6944,4
dobro,1128,3069,664,1225,857,6943,4
juror,446,1824,2201,1282,1190,6943,4
retro,948,2863,1048,1225,857,6941,4
elute,693,1193,990,1385,2679,6940,4
busby,1555,1824,1021,423,2116,6939,4
filip,847,2239,1603,1963,285,6937,4
ledol,1046,2863,774,1282,971,6936,4
shiri,2206,927,1668,1225,910,6936,4
flail,847,1193,1959,1963,971,6933,4
meech,1225,2863,1421,770,654,6933,4
cinch,1512,2239,1757,770,654,6932,4
kulak,789,1824,1603,2214,502,6932,4
tsere,1264,341,1421,1225,2679,6930,4
enloe,693,671,1603,1282,2679,6928,4
shyly,2206,927,381,1295,2116,6925,4
aspia,1698,341,560,1963,2362,6924,4
kinoo,789,2239,1757,1282,857,6924,4
dieri,1128,2239,1421,1225,910,6923,4
giddy,965,2239,774,829,2116,6923,4
logoi,1046,3069,616,1282,910,6923,4
subst,2206,1824,664,945,1284,6923,4
gighe,965,2239,616,423,2679,6922,4
jemmy,446,2863,885,612,2116,6922,4
icier,473,338,1668,3252,1190,6921,4
nobby,647,3069,664,423,2116,6919,4
sparr,2206,336,1959,1225,1190,6916,4
hihat,844,2239,334,2214,1284,6915,4
lonzo,1046,3069,1757,186,857,6915,4
ahmar,1698,927,885,2214,1190,6914,4
arawn,1698,1543,1959,192,1522,6914,4
akela,1698,137,1421,1295,2362,6913,4
sjaak,2206,32,1959,2214,502,6913,4
flann,847,1193,1959,1391,1522,6912,4
algar,1698,1193,616,2214,1190,6911,4
staab,2206,403,1959,2214,129,6911,4
visit,404,2239,1021,1963,1284,6911,4
biisk,1555,2239,1668,945,502,6909,4
shuha,2206,927,990,423,2362,6908,4
almad,1698,1193,885,2214,917,6907,4
smarr,2206,327,1959,1225,1190,6907,4
agrah,1698,139,2201,2214,654,6906,4
olona,532,1193,1426,1391,2362,6904,4
grega,965,1543,1421,612,2362,6903,4
rieti,948,2239,1421,1385,910,6903,4
theme,1264,927,1421,612,2679,6903,4
trent,1264,1543,1421,1391,1284,6903,4
whews,596,927,1421,192,3767,6903,4
antin,1698,671,1048,1963,1522,6902,4
adeep,1698,245,1421,3252,285,6901,4
plebe,1184,1193,1421,423,2679,6900,4
tikka,1264,2239,406,628,2362,6899,4
msbus,1225,341,664,899,3767,6896,4
ryter,948,458,1048,3252,1190,6896,4
agger,1698,139,616,3252,1190,6895,4
rossi,948,3069,1021,945,910,6893,4
comox,1512,3069,885,1282,144,6892,4
vehme,404,2863,334,612,2679,6892,4
hench,844,2863,1757,770,654,6888,4
arado,1698,1543,1959,829,857,6886,4
grefe,965,1543,1421,278,2679,6886,4
amida,1698,327,1668,829,2362,6884,4
gooch,965,3069,1426,770,654,6884,4
kokam,789,3069,406,2214,406,6884,4
plaza,1184,1193,1959,186,2362,6884,4
scroo,2206,338,2201,1282,857,6884,4
hirsh,844,2239,2201,945,654,6883,4
mambu,1225,4103,885,423,247,6883,4
wynne,596,458,1757,1391,2679,6881,4
unrra,420,671,2201,1225,2362,6879,4
giono,965,2239,1426,1391,857,6878,4
girru,965,2239,2201,1225,247,6877,4
oopak,532,3069,560,2214,502,6877,4
apaid,1698,336,1959,1963,917,6873,4
iphis,473,336,334,1963,3767,6873,4
aflat,1698,73,1603,2214,1284,6872,4
gussy,965,1824,1021,945,2116,6871,4
smitt,2206,327,1668,1385,1284,6870,4
snoot,2206,671,1426,1282,1284,6869,4
hoxha,844,3069,170,423,2362,6868,4
gulag,965,1824,1603,2214,261,6867,4
prior,1184,1543,1668,1282,1190,6867,4
fugue,847,1824,616,899,2679,6865,4
jinja,446,2239,1757,61,2362,6865,4
tufty,1264,1824,271,1385,2116,6860,4
crche,1512,1543,701,423,2679,6858,4
fifty,847,2239,271,1385,2116,6858,4
esten,693,341,1048,3252,1522,6856,4
stilt,2206,403,1668,1295,1284,6856,4
kebby,789,2863,664,423,2116,6855,4
zizel,176,2239,217,3252,971,6855,4
enter,693,671,1048,3252,1190,6854,4
gudge,965,1824,774,612,2679,6854,4
netti,647,2863,1048,1385,910,6853,4
agora,1698,139,1426,1225,2362,6850,4
amaze,1698,327,1959,186,2679,6849,4
compo,1512,3069,885,526,857,6849,4
where,596,927,1421,1225,2679,6848,4
arrow,1698,1543,2201,1282,122,6846,4
arroz,1698,1543,2201,1282,122,6846,4
tildi,1264,2239,1603,829,910,6845,4
arval,1698,1543,417,2214,971,6843,4
anion,1698,671,1668,1282,1522,6841,4
fillo,847,2239,1603,1295,857,6841,4
elvet,693,1193,417,3252,1284,6839,4
stoon,2206,403,1426,1282,1522,6839,4
hillo,844,2239,1603,1295,857,6838,4
kikar,789,2239,406,2214,1190,6838,4
oraon,532,1543,1959,1282,1522,6838,4
ility,473,1193,1668,1385,2116,6835,4
gonzo,965,3069,1757,186,857,6834,4
stall,2206,403,1959,1295,971,6834,4
avera,1698,126,1421,1225,2362,6832,4
difda,1128,2239,271,829,2362,6829,4
crcao,1512,1543,701,2214,857,6827,4
graaf,965,1543,1959,2214,145,6826,4
ninut,647,2239,1757,899,1284,6826,4
nabob,647,4103,664,1282,129,6825,4
thant,1264,927,1959,1391,1284,6825,4
hoffa,844,3069,271,278,2362,6824,4
poulp,1184,3069,990,1295,285,6823,4
aniba,1698,671,1668,423,2362,6822,4
yeuky,225,2863,990,628,2116,6822,4
tempt,1264,2863,885,526,1284,6822,4
antar,1698,671,1048,2214,1190,6821,4
awave,1698,226,1959,259,2679,6821,4
chaja,1512,927,1959,61,2362,6821,4
shell,2206,927,1421,1295,971,6820,4
tract,1264,1543,1959,770,1284,6820,4
jutty,446,1824,1048,1385,2116,6819,4
rebab,948,2863,664,2214,129,6818,4
appel,1698,336,560,3252,971,6817,4
erinn,693,1543,1668,1391,1522,6817,4
didnt,1128,2239,774,1391,1284,6816,4
erava,693,1543,1959,259,2362,6816,4
lulab,1046,1824,1603,2214,129,6816,4
pulli,1184,1824,1603,1295,910,6816,4
twere,1264,226,1421,1225,2679,6815,4
nitid,647,2239,1048,1963,917,6814,4
vivek,404,2239,417,3252,502,6814,4
charr,1512,927,1959,1225,1190,6813,4
shool,2206,927,1426,1282,971,6812,4
etana,693,403,1959,1391,2362,6808,4
rizar,948,2239,217,2214,1190,6808,4
tyste,1264,458,1021,1385,2679,6807,4
keiko,789,2863,1668,628,857,6805,4
slask,2206,1193,1959,945,502,6805,4
gibil,965,2239,664,1963,971,6802,4
yahoo,225,4103,334,1282,857,6801,4
abede,1698,172,1421,829,2679,6799,4
elfie,693,1193,271,1963,2679,6799,4
hcsds,844,338,1021,829,3767,6799,4
cheve,1512,927,1421,259,2679,6798,4
filix,847,2239,1603,1963,144,6796,4
ansar,1698,671,1021,2214,1190,6794,4
iambi,473,4103,885,423,910,6794,4
kibbe,789,2239,664,423,2679,6794,4
nomoi,647,3069,885,1282,910,6793,4
broll,1555,1543,1426,1295,971,6790,4
arvad,1698,1543,417,2214,917,6789,4
tisic,1264,2239,1021,1963,300,6787,4
anoka,1698,671,1426,628,2362,6785,4
cuppa,1512,1824,560,526,2362,6784,4
dixit,1128,2239,170,1963,1284,6784,4
tingi,1264,2239,1757,612,910,6782,4
gweed,965,226,1421,3252,917,6781,4
lindi,1046,2239,1757,829,910,6781,4
misti,1225,2239,1021,1385,910,6780,4
brool,1555,1543,1426,1282,971,6777,4
trini,1264,1543,1668,1391,910,6776,4
miasm,1225,2239,1959,945,406,6774,4
scoon,2206,338,1426,1282,1522,6774,4
adawe,1698,245,1959,192,2679,6773,4
murmi,1225,1824,2201,612,910,6772,4
pozzy,1184,3069,217,186,2116,6772,4
spoon,2206,336,1426,1282,1522,6772,4
rafvr,948,4103,271,259,1190,6771,4
koorg,789,3069,1426,1225,261,6770,4
robur,948,3069,664,899,1190,6770,4
scall,2206,338,1959,1295,971,6769,4
muddy,1225,1824,774,829,2116,6768,4
abave,1698,172,1959,259,2679,6767,4
piggy,1184,2239,616,612,2116,6767,4
spall,2206,336,1959,1295,971,6767,4
nuaaw,647,1824,1959,2214,122,6766,4
acuan,1698,338,990,2214,1522,6762,4
shood,2206,927,1426,1282,917,6758,4
small,2206,327,1959,1295,971,6758,4
eyrar,693,458,2201,2214,1190,6756,4
mlitt,1225,1193,1668,1385,1284,6755,4
leech,1046,2863,1421,770,654,6754,4
aniak,1698,671,1668,2214,502,6753,4
fussy,847,1824,1021,945,2116,6753,4
pupal,1184,1824,560,2214,971,6753,4
fleme,847,1193,1421,612,2679,6752,4
shooi,2206,927,1426,1282,910,6751,4
hussy,844,1824,1021,945,2116,6750,4
shilh,2206,927,1668,1295,654,6750,4
coomb,1512,3069,1426,612,129,6748,4
estus,693,341,1048,899,3767,6748,4
kiddy,789,2239,774,829,2116,6747,4
vlada,404,1193,1959,829,2362,6747,4
becco,1555,2863,701,770,857,6746,4
combo,1512,3069,885,423,857,6746,4
aruac,1698,1543,990,2214,300,6745,4
elver,693,1193,417,3252,1190,6745,4
piing,1184,2239,1668,1391,261,6743,4
aralu,1698,1543,1959,1295,247,6742,4
fixin,847,2239,170,1963,1522,6741,4
trill,1264,1543,1668,1295,971,6741,4
georg,965,2863,1426,1225,261,6740,4
kynan,789,458,1757,2214,1522,6740,4
tommi,1264,3069,885,612,910,6740,4
niton,647,2239,1048,1282,1522,6738,4
agave,1698,139,1959,259,2679,6734,4
crool,1512,1543,1426,1282,971,6734,4
execs,693,83,1421,770,3767,6734,4
ziffs,176,2239,271,278,3767,6731,4
andra,1698,671,774,1225,2362,6730,4
lulav,1046,1824,1603,2214,41,6728,4
fritt,847,1543,1668,1385,1284,6727,4
meiji,1225,2863,1668,61,910,6727,4
puddy,1184,1824,774,829,2116,6727,4
atnah,1698,403,1757,2214,654,6726,4
lipid,1046,2239,560,1963,917,6725,4
altha,1698,1193,1048,423,2362,6724,4
brood,1555,1543,1426,1282,917,6723,4
buggy,1555,1824,616,612,2116,6723,4
atman,1698,403,885,2214,1522,6722,4
nyala,647,458,1959,1295,2362,6721,4
asway,1698,341,349,2214,2116,6718,4
bokom,1555,3069,406,1282,406,6718,4
audun,1698,1824,774,899,1522,6717,4
avail,1698,126,1959,1963,971,6717,4
blini,1555,1193,1668,1391,910,6717,4
nonyl,647,3069,1757,271,971,6715,4
kodro,789,3069,774,1225,857,6714,4
thebe,1264,927,1421,423,2679,6714,4
tocci,1264,3069,701,770,910,6714,4
honzo,844,3069,1757,186,857,6713,4
nebby,647,2863,664,423,2116,6713,4
alvar,1698,1193,417,2214,1190,6712,4
tibby,1264,2239,664,423,2116,6706,4
stent,2206,403,1421,1391,1284,6705,4
tippy,1264,2239,560,526,2116,6705,4
trist,1264,1543,1668,945,1284,6704,4
bidri,1555,2239,774,1225,910,6703,4
lucca,1046,1824,701,770,2362,6703,4
nymss,647,458,885,945,3767,6702,4
oyana,532,458,1959,1391,2362,6702,4
tummy,1264,1824,885,612,2116,6701,4
ullin,420,1193,1603,1963,1522,6701,4
alexa,1698,1193,1421,26,2362,6700,4
ashia,1698,341,334,1963,2362,6698,4
tuque,1264,1824,32,899,2679,6698,4
cloot,1512,1193,1426,1282,1284,6697,4
kioto,789,2239,1426,1385,857,6696,4
twait,1264,226,1959,1963,1284,6696,4
abear,1698,172,1421,2214,1190,6695,4
wolof,596,3069,1603,1282,145,6695,4
abaze,1698,172,1959,186,2679,6694,4
allod,1698,1193,1603,1282,917,6693,4
annot,1698,671,1757,1282,1284,6692,4
byway,1555,458,349,2214,2116,6692,4
abram,1698,172,2201,2214,406,6691,4
addle,1698,245,774,1295,2679,6691,4
graig,965,1543,1959,1963,261,6691,4
daffi,1128,4103,271,278,910,6690,4
errol,693,1543,2201,1282,971,6690,4
yolyn,225,3069,1603,271,1522,6690,4
woosh,596,3069,1426,945,654,6690,4
gazoz,965,4103,217,1282,122,6689,4
furud,847,1824,2201,899,917,6688,4
phaih,1184,927,1959,1963,654,6687,4
totum,1264,3069,1048,899,406,6686,4
vieva,404,2239,1421,259,2362,6685,4
yazoo,225,4103,217,1282,857,6684,4
rigid,948,2239,616,1963,917,6683,4
ninth,647,2239,1757,1385,654,6682,4
glebe,965,1193,1421,423,2679,6681,4
stadt,2206,403,1959,829,1284,6681,4
crood,1512,1543,1426,1282,917,6680,4
reesk,948,2863,1421,945,502,6679,4
acima,1698,338,1668,612,2362,6678,4
bilbo,1555,2239,1603,423,857,6677,4
astra,1698,341,1048,1225,2362,6674,4
amula,1698,327,990,1295,2362,6672,4
cyndy,1512,458,1757,829,2116,6672,4
adlai,1698,245,1603,2214,910,6670,4
arago,1698,1543,1959,612,857,6669,4
wicca,596,2239,701,770,2362,6668,4
amiga,1698,327,1668,612,2362,6667,4
xysts,36,458,1021,1385,3767,6667,4
krenn,789,1543,1421,1391,1522,6666,4
slish,2206,1193,1668,945,654,6666,4
rosco,948,3069,1021,770,857,6665,4
vinic,404,2239,1757,1963,300,6663,4
emile,693,327,1668,1295,2679,6662,4
swoon,2206,226,1426,1282,1522,6662,4
webby,596,2863,664,423,2116,6662,4
agaze,1698,139,1959,186,2679,6661,4
brerd,1555,1543,1421,1225,917,6661,4
ersar,693,1543,1021,2214,1190,6661,4
prill,1184,1543,1668,1295,971,6661,4
atrax,1698,403,2201,2214,144,6660,4
ebsen,693,172,1021,3252,1522,6660,4
amant,1698,327,1959,1391,1284,6659,4
kebab,789,2863,664,2214,129,6659,4
agram,1698,139,2201,2214,406,6658,4
dlitt,1128,1193,1668,1385,1284,6658,4
onkos,532,671,406,1282,3767,6658,4
ditto,1128,2239,1048,1385,857,6657,4
nucin,647,1824,701,1963,1522,6657,4
dildo,1128,2239,1603,829,857,6656,4
apoda,1698,336,1426,829,2362,6651,4
gesso,965,2863,1021,945,857,6651,4
mimzy,1225,2239,885,186,2116,6651,4
edana,693,245,1959,1391,2362,6650,4
jidda,446,2239,774,829,2362,6650,4
modoc,1225,3069,774,1282,300,6650,4
bebop,1555,2863,664,1282,285,6649,4
khama,789,927,1959,612,2362,6649,4
elery,693,1193,1421,1225,2116,6648,4
gumma,965,1824,885,612,2362,6648,4
avram,1698,126,2201,2214,406,6645,4
cycle,1512,458,701,1295,2679,6645,4
almah,1698,1193,885,2214,654,6644,4
fieri,847,2239,1421,1225,910,6642,4
wappo,596,4103,560,526,857,6642,4
ahmad,1698,927,885,2214,917,6641,4
heigh,844,2863,1668,612,654,6641,4
ilisa,473,1193,1668,945,2362,6641,4
kimmy,789,2239,885,612,2116,6641,4
inone,473,671,1426,1391,2679,6640,4
teddi,1264,2863,774,829,910,6640,4
habub,844,4103,664,899,129,6639,4
scott,2206,338,1426,1385,1284,6639,4
unden,420,671,774,3252,1522,6639,4
kulun,789,1824,1603,899,1522,6637,4
dhava,1128,927,1959,259,2362,6635,4
littd,1046,2239,1048,1385,917,6635,4
axial,1698,83,1668,2214,971,6634,4
phebe,1184,927,1421,423,2679,6634,4
dbrad,1128,172,2201,2214,917,6632,4
adagy,1698,245,1959,612,2116,6630,4
awarn,1698,226,1959,1225,1522,6630,4
queme,93,1824,1421,612,2679,6629,4
npeel,647,336,1421,3252,971,6627,4
bebog,1555,2863,664,1282,261,6625,4
efrem,693,73,2201,3252,406,6625,4
ottie,532,403,1048,1963,2679,6625,4
arach,1698,1543,1959,770,654,6624,4
kuska,789,1824,1021,628,2362,6624,4
ryder,948,458,774,3252,1190,6622,4
flinn,847,1193,1668,1391,1522,6621,4
gitim,965,2239,1048,1963,406,6621,4
bisso,1555,2239,1021,945,857,6617,4
asura,1698,341,990,1225,2362,6616,4
enage,693,671,1959,612,2679,6614,4
abuna,1698,172,990,1391,2362,6613,4
wraac,596,1543,1959,2214,300,6612,4
klatt,789,1193,1959,1385,1284,6610,4
tutor,1264,1824,1048,1282,1190,6608,4
vidda,404,2239,774,829,2362,6608,4
abuta,1698,172,990,1385,2362,6607,4
buffe,1555,1824,271,278,2679,6607,4
pitri,1184,2239,1048,1225,910,6606,4
drill,1128,1543,1668,1295,971,6605,4
ciclo,1512,2239,701,1295,857,6604,4
kilij,789,2239,1603,1963,10,6604,4
eloge,693,1193,1426,612,2679,6603,4
antal,1698,671,1048,2214,971,6602,4
wheem,596,927,1421,3252,406,6602,4
allix,1698,1193,1603,1963,144,6601,4
recur,948,2863,701,899,1190,6601,4
ilama,473,1193,1959,612,2362,6599,4
tetch,1264,2863,1048,770,654,6599,4
armor,1698,1543,885,1282,1190,6598,4
wootz,596,3069,1426,1385,122,6598,4
afear,1698,73,1421,2214,1190,6596,4
disli,1128,2239,1021,1295,910,6593,4
sheth,2206,927,1421,1385,654,6593,4
aniwa,1698,671,1668,192,2362,6591,4
zimme,176,2239,885,612,2679,6591,4
gugal,965,1824,616,2214,971,6590,4
luddy,1046,1824,774,829,2116,6589,4
ccuta,1512,338,990,1385,2362,6587,4
epscs,693,336,1021,770,3767,6587,4
rheme,948,927,1421,612,2679,6587,4
bivvy,1555,2239,417,259,2116,6586,4
osana,532,341,1959,1391,2362,6585,4
livid,1046,2239,417,1963,917,6582,4
ocana,532,338,1959,1391,2362,6582,4
eulau,693,1824,1603,2214,247,6581,4
acrab,1698,338,2201,2214,129,6580,4
edile,693,245,1668,1295,2679,6580,4
ender,693,671,774,3252,1190,6580,4
alysa,1698,1193,381,945,2362,6579,4
hindi,844,2239,1757,829,910,6579,4
iodic,473,3069,774,1963,300,6579,4
trapt,1264,1543,1959,526,1284,6576,4
typps,1264,458,560,526,3767,6575,4
opata,532,336,1959,1385,2362,6574,4
egrep,693,139,2201,3252,285,6570,4
dippy,1128,2239,560,526,2116,6569,4
iodol,473,3069,774,1282,971,6569,4
adnah,1698,245,1757,2214,654,6568,4
apple,1698,336,560,1295,2679,6568,4
emden,693,327,774,3252,1522,6568,4
eydie,693,458,774,1963,2679,6567,4
dummy,1128,1824,885,612,2116,6565,4
adman,1698,245,885,2214,1522,6564,4
snell,2206,671,1421,1295,971,6564,4
fnese,847,671,1421,945,2679,6563,4
kroon,789,1543,1426,1282,1522,6562,4
kwara,789,226,1959,1225,2362,6561,4
indie,473,671,774,1963,2679,6560,4
vivat,404,2239,417,2214,1284,6558,4
krall,789,1543,1959,1295,971,6557,4
snool,2206,671,1426,1282,971,6556,4
agoge,1698,139,1426,612,2679,6554,4
posho,1184,3069,1021,423,857,6554,4
widdy,596,2239,774,829,2116,6554,4
evite,693,126,1668,1385,2679,6551,4
suzzy,2206,1824,217,186,2116,6549,4
yomim,225,3069,885,1963,406,6548,4
piuri,1184,2239,990,1225,910,6548,4
orion,532,1543,1668,1282,1522,6547,4
ulama,420,1193,1959,612,2362,6546,4
aheap,1698,927,1421,2214,285,6545,4
amsat,1698,327,1021,2214,1284,6544,4
civvy,1512,2239,417,259,2116,6543,4
still,2206,403,1668,1295,971,6543,4
anorn,1698,671,1426,1225,1522,6542,4
druid,1128,1543,990,1963,917,6541,4
wwops,596,226,1426,526,3767,6541,4
cubby,1512,1824,664,423,2116,6539,4
stert,2206,403,1421,1225,1284,6539,4
cuppy,1512,1824,560,526,2116,6538,4
imine,473,327,1668,1391,2679,6538,4
tubba,1264,1824,664,423,2362,6537,4
ossie,532,341,1021,1963,2679,6536,4
scoot,2206,338,1426,1282,1284,6536,4
chott,1512,927,1426,1385,1284,6534,4
spoot,2206,336,1426,1282,1284,6534,4
arabi,1698,1543,1959,423,910,6533,4
hippa,844,2239,560,526,2362,6531,4
woolf,596,3069,1426,1295,145,6531,4
ehlke,693,927,1603,628,2679,6530,4
dupuy,1128,1824,560,899,2116,6527,4
lytle,1046,458,1048,1295,2679,6526,4
minum,1225,2239,1757,899,406,6526,4
xerox,36,2863,2201,1282,144,6526,4
smoot,2206,327,1426,1282,1284,6525,4
agamy,1698,139,1959,612,2116,6524,4
ester,693,341,1048,3252,1190,6524,4
kovno,789,3069,417,1391,857,6523,4
chirr,1512,927,1668,1225,1190,6522,4
ennoy,693,671,1757,1282,2116,6519,4
atoka,1698,403,1426,628,2362,6517,4
cruor,1512,1543,990,1282,1190,6517,4
elope,693,1193,1426,526,2679,6517,4
agway,1698,139,349,2214,2116,6516,4
regur,948,2863,616,899,1190,6516,4
exine,693,83,1668,1391,2679,6514,4
sloom,2206,1193,1426,1282,406,6513,4
emote,693,327,1426,1385,2679,6510,4
exite,693,83,1668,1385,2679,6508,4
eyrir,693,458,2201,1963,1190,6505,4
bixby,1555,2239,170,423,2116,6503,4
fixit,847,2239,170,1963,1284,6503,4
alang,1698,1193,1959,1391,261,6502,4
apart,1698,336,1959,1225,1284,6502,4
pupil,1184,1824,560,1963,971,6502,4
snood,2206,671,1426,1282,917,6502,4
kiwai,789,2239,349,2214,910,6501,4
groot,965,1543,1426,1282,1284,6500,4
troll,1264,1543,1426,1295,971,6499,4
quinn,93,1824,1668,1391,1522,6498,4
keech,789,2863,1421,770,654,6497,4
ipsus,473,336,1021,899,3767,6496,4
nammu,647,4103,885,612,247,6494,4
glenn,965,1193,1421,1391,1522,6492,4
itala,473,403,1959,1295,2362,6492,4
ruddy,948,1824,774,829,2116,6491,4
attry,1698,403,1048,1225,2116,6490,4
idled,473,245,1603,3252,917,6490,4
libby,1046,2239,664,423,2116,6488,4
ardor,1698,1543,774,1282,1190,6487,4
lippy,1046,2239,560,526,2116,6487,4
ocala,532,338,1959,1295,2362,6486,4
pharr,1184,927,1959,1225,1190,6485,4
affer,1698,73,271,3252,1190,6484,4
cumic,1512,1824,885,1963,300,6484,4
lummy,1046,1824,885,612,2116,6483,4
korff,789,3069,2201,278,145,6482,4
orlon,532,1543,1603,1282,1522,6482,4
ssort,2206,341,1426,1225,1284,6482,4
alarm,1698,1193,1959,1225,406,6481,4
wheep,596,927,1421,3252,285,6481,4
frett,847,1543,1421,1385,1284,6480,4
tetum,1264,2863,1048,899,406,6480,4
theah,1264,927,1421,2214,654,6480,4
volow,404,3069,1603,1282,122,6480,4
weesh,596,2863,1421,945,654,6479,4
ascan,1698,341,701,2214,1522,6476,4
spill,2206,336,1668,1295,971,6476,4
bhoot,1555,927,1426,1282,1284,6474,4
husha,844,1824,1021,423,2362,6474,4
kicky,789,2239,701,628,2116,6473,4
plott,1184,1193,1426,1385,1284,6472,4
dixil,1128,2239,170,1963,971,6471,4
rotow,948,3069,1048,1282,122,6469,4
anent,1698,671,1421,1391,1284,6465,4
iliad,473,1193,1668,2214,917,6465,4
ezana,693,59,1959,1391,2362,6464,4
niolo,647,2239,1426,1295,857,6464,4
alyda,1698,1193,381,829,2362,6463,4
dryly,1128,1543,381,1295,2116,6463,4
ellga,693,1193,1603,612,2362,6463,4
awalt,1698,226,1959,1295,1284,6462,4
pepsi,1184,2863,560,945,910,6462,4
glaab,965,1193,1959,2214,129,6460,4
anett,1698,671,1421,1385,1284,6459,4
biffy,1555,2239,271,278,2116,6459,4
avant,1698,126,1959,1391,1284,6458,4
cohog,1512,3069,334,1282,261,6458,4
dyann,1128,458,1959,1391,1522,6458,4
durum,1128,1824,2201,899,406,6458,4
uncus,420,671,701,899,3767,6458,4
raffo,948,4103,271,278,857,6457,4
trest,1264,1543,1421,945,1284,6457,4
wraaf,596,1543,1959,2214,145,6457,4
asoka,1698,341,1426,628,2362,6455,4
orfeo,532,1543,271,3252,857,6455,4
octet,532,338,1048,3252,1284,6454,4
repro,948,2863,560,1225,857,6453,4
thatd,1264,927,1959,1385,917,6452,4
vulva,404,1824,1603,259,2362,6452,4
idite,473,245,1668,1385,2679,6450,4
abura,1698,172,990,1225,2362,6447,4
ariki,1698,1543,1668,628,910,6447,4
llano,1046,1193,1959,1391,857,6446,4
begob,1555,2863,616,1282,129,6445,4
grill,965,1543,1668,1295,971,6442,4
spoor,2206,336,1426,1282,1190,6440,4
acoma,1698,338,1426,612,2362,6436,4
ivied,473,126,1668,3252,917,6436,4
topog,1264,3069,560,1282,261,6436,4
snash,2206,671,1959,945,654,6435,4
ecole,693,338,1426,1295,2679,6431,4
yetti,225,2863,1048,1385,910,6431,4
figgy,847,2239,616,612,2116,6430,4
osset,532,341,1021,3252,1284,6430,4
lezzy,1046,2863,217,186,2116,6428,4
skirr,2206,137,1668,1225,1190,6426,4
amban,1698,327,664,2214,1522,6425,4
coeff,1512,3069,1421,278,145,6425,4
otter,532,403,1048,3252,1190,6425,4
shahi,2206,927,1959,423,910,6425,4
unpen,420,671,560,3252,1522,6425,4
slosh,2206,1193,1426,945,654,6424,4
tweeg,1264,226,1421,3252,261,6424,4
hullo,844,1824,1603,1295,857,6423,4
thoon,1264,927,1426,1282,1522,6421,4
exile,693,83,1668,1295,2679,6418,4
pombo,1184,3069,885,423,857,6418,4
fytte,847,458,1048,1385,2679,6417,4
anova,1698,671,1426,259,2362,6416,4
trout,1264,1543,1426,899,1284,6416,4
agura,1698,139,990,1225,2362,6414,4
tiffa,1264,2239,271,278,2362,6414,4
polyp,1184,3069,1603,271,285,6412,4
succi,2206,1824,701,770,910,6411,4
gibby,965,2239,664,423,2116,6407,4
aftra,1698,73,1048,1225,2362,6406,4
gippy,965,2239,560,526,2116,6406,4
pukka,1184,1824,406,628,2362,6404,4
axman,1698,83,885,2214,1522,6402,4
evase,693,126,1959,945,2679,6402,4
gummy,965,1824,885,612,2116,6402,4
ngala,647,139,1959,1295,2362,6402,4
dubba,1128,1824,664,423,2362,6401,4
duppa,1128,1824,560,526,2362,6400,4
cisco,1512,2239,1021,770,857,6399,4
proto,1184,1543,1426,1385,857,6395,4
dusun,1128,1824,1021,899,1522,6394,4
muggy,1225,1824,616,612,2116,6393,4
brynn,1555,1543,381,1391,1522,6392,4
sloop,2206,1193,1426,1282,285,6392,4
ribby,948,2239,664,423,2116,6390,4
shull,2206,927,990,1295,971,6389,4
alaki,1698,1193,1959,628,910,6388,4
huddy,844,1824,774,829,2116,6387,4
gigot,965,2239,616,1282,1284,6386,4
nessi,647,2863,1021,945,910,6386,4
essay,693,341,1021,2214,2116,6385,4
hotch,844,3069,1048,770,654,6385,4
rummy,948,1824,885,612,2116,6385,4
elude,693,1193,990,829,2679,6384,4
sushi,2206,1824,1021,423,910,6384,4
avoca,1698,126,1426,770,2362,6382,4
cecum,1512,2863,701,899,406,6381,4
artur,1698,1543,1048,899,1190,6378,4
arbor,1698,1543,664,1282,1190,6377,4
ogata,532,139,1959,1385,2362,6377,4
equus,693,25,990,899,3767,6374,4
blood,1555,1193,1426,1282,917,6373,4
chill,1512,927,1668,1295,971,6373,4
yoong,225,3069,1426,1391,261,6372,4
nyasa,647,458,1959,945,2362,6371,4
didst,1128,2239,774,945,1284,6370,4
osone,532,341,1426,1391,2679,6369,4
thirt,1264,927,1668,1225,1284,6368,4
swill,2206,226,1668,1295,971,6366,4
pinup,1184,2239,1757,899,285,6364,4
culch,1512,1824,1603,770,654,6363,4
droll,1128,1543,1426,1295,971,6363,4
bekki,1555,2863,406,628,910,6362,4
ocote,532,338,1426,1385,2679,6360,4
bhili,1555,927,1668,1295,910,6355,4
puggy,1184,1824,616,612,2116,6352,4
putti,1184,1824,1048,1385,910,6351,4
drool,1128,1543,1426,1282,971,6350,4
byrri,1555,458,2201,1225,910,6349,4
atilt,1698,403,1668,1295,1284,6348,4
pokom,1184,3069,406,1282,406,6347,4
pobox,1184,3069,664,1282,144,6343,4
shook,2206,927,1426,1282,502,6343,4
kleve,789,1193,1421,259,2679,6341,4
sikko,2206,2239,406,628,857,6336,4
skoot,2206,137,1426,1282,1284,6335,4
gazzo,965,4103,217,186,857,6328,4
yechy,225,2863,701,423,2116,6328,4
cohob,1512,3069,334,1282,129,6326,4
yabbi,225,4103,664,423,910,6325,4
frill,847,1543,1668,1295,971,6324,4
inken,473,671,406,3252,1522,6324,4
glali,965,1193,1959,1295,910,6322,4
johor,446,3069,334,1282,1190,6321,4
obala,532,172,1959,1295,2362,6320,4
alamo,1698,1193,1959,612,857,6319,4
cohow,1512,3069,334,1282,122,6319,4
lubba,1046,1824,664,423,2362,6319,4
entre,693,671,1048,1225,2679,6316,4
stith,2206,403,1668,1385,654,6316,4
utter,420,403,1048,3252,1190,6313,4
chili,1512,927,1668,1295,910,6312,4
crull,1512,1543,990,1295,971,6311,4
ivana,473,126,1959,1391,2362,6311,4
kotow,789,3069,1048,1282,122,6310,4
bekko,1555,2863,406,628,857,6309,4
brook,1555,1543,1426,1282,502,6308,4
ilima,473,1193,1668,612,2362,6308,4
khaya,789,927,1959,271,2362,6308,4
ateba,1698,403,1421,423,2362,6307,4
usara,420,341,1959,1225,2362,6307,4
estel,693,341,1048,3252,971,6305,4
ubana,420,172,1959,1391,2362,6304,4
stoll,2206,403,1426,1295,971,6301,4
shedd,2206,927,1421,829,917,6300,4
lytta,1046,458,1048,1385,2362,6299,4
altaf,1698,1193,1048,2214,145,6298,4
enode,693,671,1426,829,2679,6298,4
ezara,693,59,1959,1225,2362,6298,4
jimmy,446,2239,885,612,2116,6298,4
putto,1184,1824,1048,1385,857,6298,4
chuah,1512,927,990,2214,654,6297,4
stell,2206,403,1421,1295,971,6296,4
ellon,693,1193,1603,1282,1522,6293,4
jammu,446,4103,885,612,247,6293,4
amand,1698,327,1959,1391,917,6292,4
tubby,1264,1824,664,423,2116,6291,4
buffa,1555,1824,271,278,2362,6290,4
gough,965,3069,990,612,654,6290,4
shluh,2206,927,1603,899,654,6289,4
akiba,1698,137,1668,423,2362,6288,4
stool,2206,403,1426,1282,971,6288,4
allyn,1698,1193,1603,271,1522,6287,4
crack,1512,1543,1959,770,502,6286,4
evade,693,126,1959,829,2679,6286,4
amani,1698,327,1959,1391,910,6285,4
dhoon,1128,927,1426,1282,1522,6285,4
hippy,844,2239,560,526,2116,6285,4
tript,1264,1543,1668,526,1284,6285,4
amati,1698,327,1959,1385,910,6279,4
ryann,948,458,1959,1391,1522,6278,4
skill,2206,137,1668,1295,971,6277,4
irani,473,1543,1959,1391,910,6276,4
junno,446,1824,1757,1391,857,6275,4
nintu,647,2239,1757,1385,247,6275,4
rigor,948,2239,616,1282,1190,6275,4
stunt,2206,403,990,1391,1284,6274,4
ileal,473,1193,1421,2214,971,6272,4
troth,1264,1543,1426,1385,654,6272,4
sfoot,2206,73,1426,1282,1284,6271,4
unken,420,671,406,3252,1522,6271,4
aboma,1698,172,1426,612,2362,6270,4
codcf,1512,3069,774,770,145,6270,4
pyatt,1184,458,1959,1385,1284,6270,4
unona,420,671,1426,1391,2362,6270,4
aptal,1698,336,1048,2214,971,6267,4
cozmo,1512,3069,217,612,857,6267,4
hoshi,844,3069,1021,423,910,6267,4
exter,693,83,1048,3252,1190,6266,4
idden,473,245,774,3252,1522,6266,4
krill,789,1543,1668,1295,971,6266,4
lyery,1046,458,1421,1225,2116,6266,4
crook,1512,1543,1426,1282,502,6265,4
hinch,844,2239,1757,770,654,6264,4
cubic,1512,1824,664,1963,300,6263,4
aslam,1698,341,1603,2214,406,6262,4
kursk,789,1824,2201,945,502,6261,4
ogeed,532,139,1421,3252,917,6261,4
etape,693,403,1959,526,2679,6260,4
kiack,789,2239,1959,770,502,6259,4
enure,693,671,990,1225,2679,6258,4
nynex,647,458,1757,3252,144,6258,4
nisdn,647,2239,1021,829,1522,6258,4
quitt,93,1824,1668,1385,1284,6254,4
viuva,404,2239,990,259,2362,6254,4
vivda,404,2239,417,829,2362,6251,4
obara,532,172,1959,1225,2362,6250,4
india,473,671,774,1963,2362,6243,4
petuu,1184,2863,1048,899,247,6241,4
alpha,1698,1193,560,423,2362,6236,4
stood,2206,403,1426,1282,917,6234,4
ameba,1698,327,1421,423,2362,6231,4
kippy,789,2239,560,526,2116,6230,4
fezzy,847,2863,217,186,2116,6229,4
noddi,647,3069,774,829,910,6229,4
spell,2206,336,1421,1295,971,6229,4
augur,1698,1824,616,899,1190,6227,4
amato,1698,327,1959,1385,857,6226,4
meggi,1225,2863,616,612,910,6226,4
nullo,647,1824,1603,1295,857,6226,4
acast,1698,338,1959,945,1284,6224,4
kmmel,789,327,885,3252,971,6224,4
enver,693,671,417,3252,1190,6223,4
apast,1698,336,1959,945,1284,6222,4
unnew,420,671,1757,3252,122,6222,4
anton,1698,671,1048,1282,1522,6221,4
spool,2206,336,1426,1282,971,6221,4
bedub,1555,2863,774,899,129,6220,4
heddi,844,2863,774,829,910,6220,4
smell,2206,327,1421,1295,971,6220,4
ossia,532,341,1021,1963,2362,6219,4
stout,2206,403,1426,899,1284,6218,4
ician,473,338,1668,2214,1522,6215,4
broom,1555,1543,1426,1282,406,6212,4
bundu,1555,1824,1757,829,247,6212,4
lyndy,1046,458,1757,829,2116,6206,4
engel,693,671,616,3252,971,6203,4
scutt,2206,338,990,1385,1284,6203,4
ataxy,1698,403,1959,26,2116,6202,4
oppen,532,336,560,3252,1522,6202,4
erdda,693,1543,774,829,2362,6201,4
gombo,965,3069,885,423,857,6199,4
adati,1698,245,1959,1385,910,6197,4
cymry,1512,458,885,1225,2116,6196,4
prepn,1184,1543,1421,526,1522,6196,4
thanh,1264,927,1959,1391,654,6195,4
anson,1698,671,1021,1282,1522,6194,4
obote,532,172,1426,1385,2679,6194,4
knoke,789,671,1426,628,2679,6193,4
smalm,2206,327,1959,1295,406,6193,4
vigil,404,2239,616,1963,971,6193,4
exdie,693,83,774,1963,2679,6192,4
inkie,473,671,406,1963,2679,6192,4
nuddy,647,1824,774,829,2116,6190,4
mphps,1225,336,334,526,3767,6188,4
pizza,1184,2239,217,186,2362,6188,4
jessi,446,2863,1021,945,910,6185,4
peggi,1184,2863,616,612,910,6185,4
wuppe,596,1824,560,526,2679,6185,4
dryad,1128,1543,381,2214,917,6183,4
edsel,693,245,1021,3252,971,6182,4
asoak,1698,341,1426,2214,502,6181,4
kizil,789,2239,217,1963,971,6179,4
wiggy,596,2239,616,612,2116,6179,4
niabi,647,2239,1959,423,910,6178,4
alvah,1698,1193,417,2214,654,6176,4
neffy,647,2863,271,278,2116,6175,4
tcsec,1264,338,1021,3252,300,6175,4
odele,532,245,1421,1295,2679,6172,4
apeak,1698,336,1421,2214,502,6171,4
croom,1512,1543,1426,1282,406,6169,4
hough,844,3069,990,612,654,6169,4
slapp,2206,1193,1959,526,285,6169,4
tiffy,1264,2239,271,278,2116,6168,4
amaut,1698,327,1959,899,1284,6167,4
stash,2206,403,1959,945,654,6167,4
dibri,1128,2239,664,1225,910,6166,4
turku,1264,1824,2201,628,247,6164,4
poyou,1184,3069,381,1282,247,6163,4
uvala,420,126,1959,1295,2362,6162,4
croci,1512,1543,1426,770,910,6161,4
dyked,1128,458,406,3252,917,6161,4
ahwal,1698,927,349,2214,971,6159,4
cusso,1512,1824,1021,945,857,6159,4
divvy,1128,2239,417,259,2116,6159,4
uapdu,420,4103,560,829,247,6159,4
igara,473,139,1959,1225,2362,6158,4
ikara,473,137,1959,1225,2362,6156,4
dubby,1128,1824,664,423,2116,6155,4
trici,1264,1543,1668,770,910,6155,4
duppy,1128,1824,560,526,2116,6154,4
nihil,647,2239,334,1963,971,6154,4
greig,965,1543,1421,1963,261,6153,4
onaka,532,671,1959,628,2362,6152,4
ardri,1698,1543,774,1225,910,6150,4
akpek,1698,137,560,3252,502,6149,4
chadd,1512,927,1959,829,917,6144,4
roydd,948,3069,381,829,917,6144,4
stedt,2206,403,1421,829,1284,6143,4
abdat,1698,172,774,2214,1284,6142,4
litui,1046,2239,1048,899,910,6142,4
urdar,420,1543,774,2214,1190,6141,4
isere,473,341,1421,1225,2679,6139,4
recco,948,2863,701,770,857,6139,4
ilion,473,1193,1668,1282,1522,6138,4
aband,1698,172,1959,1391,917,6137,4
onaga,532,671,1959,612,2362,6136,4
accoy,1698,338,701,1282,2116,6135,4
ewder,693,226,774,3252,1190,6135,4
jibba,446,2239,664,423,2362,6134,4
gutti,965,1824,1048,1385,910,6132,4
khoka,789,927,1426,628,2362,6132,4
wroot,596,1543,1426,1282,1284,6131,4
acari,1698,338,1959,1225,910,6130,4
anniv,1698,671,1757,1963,41,6130,4
jumma,446,1824,885,612,2362,6129,4
miffy,1225,2239,271,278,2116,6129,4
rumor,948,1824,885,1282,1190,6129,4
ember,693,327,664,3252,1190,6126,4
shoop,2206,927,1426,1282,285,6126,4
thort,1264,927,1426,1225,1284,6126,4
omasa,532,327,1959,945,2362,6125,4
thill,1264,927,1668,1295,971,6125,4
aswan,1698,341,349,2214,1522,6124,4
littm,1046,2239,1048,1385,406,6124,4
twant,1264,226,1959,1391,1284,6124,4
smarm,2206,327,1959,1225,406,6123,4
zokor,176,3069,406,1282,1190,6123,4
alack,1698,1193,1959,770,502,6122,4
heuch,844,2863,990,770,654,6121,4
amari,1698,327,1959,1225,910,6119,4
swell,2206,226,1421,1295,971,6119,4
ytter,225,403,1048,3252,1190,6118,4
hubba,844,1824,664,423,2362,6117,4
ruggy,948,1824,616,612,2116,6116,4
hecht,844,2863,701,423,1284,6115,4
hilch,844,2239,1603,770,654,6110,4
lipic,1046,2239,560,1963,300,6108,4
sturt,2206,403,990,1225,1284,6108,4
adali,1698,245,1959,1295,910,6107,4
achan,1698,338,334,2214,1522,6106,4
obole,532,172,1426,1295,2679,6104,4
aboon,1698,172,1426,1282,1522,6100,4
anend,1698,671,1421,1391,917,6098,4
khaja,789,927,1959,61,2362,6098,4
nikon,647,2239,406,1282,1522,6096,4
awald,1698,226,1959,1295,917,6095,4
mecum,1225,2863,701,899,406,6094,4
ambar,1698,327,664,2214,1190,6093,4
byrrh,1555,458,2201,1225,654,6093,4
smash,2206,327,1959,945,654,6091,4
chanc,1512,927,1959,1391,300,6089,4
nibby,647,2239,664,423,2116,6089,4
clach,1512,1193,1959,770,654,6088,4
nippy,647,2239,560,526,2116,6088,4
ozone,532,59,1426,1391,2679,6087,4
snook,2206,671,1426,1282,502,6087,4
suppl,2206,1824,560,526,971,6087,4
libri,1046,2239,664,1225,910,6084,4
myoma,1225,458,1426,612,2362,6083,4
mokpo,1225,3069,406,526,857,6083,4
unzen,420,671,217,3252,1522,6082,4
nuque,647,1824,32,899,2679,6081,4
vinci,404,2239,1757,770,910,6080,4
eyoty,693,458,1426,1385,2116,6078,4
asyla,1698,341,381,1295,2362,6077,4
livvy,1046,2239,417,259,2116,6077,4
gibli,965,2239,664,1295,910,6073,4
adyta,1698,245,381,1385,2362,6071,4
ninox,647,2239,1757,1282,144,6069,4
disci,1128,2239,1021,770,910,6068,4
sstor,2206,341,1048,1282,1190,6067,4
howso,844,3069,349,945,857,6064,4
trull,1264,1543,990,1295,971,6063,4
khayy,789,927,1959,271,2116,6062,4
kubba,789,1824,664,423,2362,6062,4
fogou,847,3069,616,1282,247,6061,4
luigi,1046,1824,1668,612,910,6060,4
udele,420,245,1421,1295,2679,6060,4
aramu,1698,1543,1959,612,247,6059,4
urari,420,1543,1959,1225,910,6057,4
apgar,1698,336,616,2214,1190,6054,4
azusa,1698,59,990,945,2362,6054,4
gyatt,965,458,1959,1385,1284,6051,4
phill,1184,927,1668,1295,971,6045,4
buffy,1555,1824,271,278,2116,6044,4
blynn,1555,1193,381,1391,1522,6042,4
jubbe,446,1824,664,423,2679,6036,4
nikky,647,2239,406,628,2116,6036,4
elegy,693,1193,1421,612,2116,6035,4
hecco,844,2863,701,770,857,6035,4
thorr,1264,927,1426,1225,1190,6032,4
vezza,404,2863,217,186,2362,6032,4
gobbi,965,3069,664,423,910,6031,4
ashla,1698,341,334,1295,2362,6030,4
skell,2206,137,1421,1295,971,6030,4
attid,1698,403,1048,1963,917,6029,4
jiggy,446,2239,616,612,2116,6029,4
emera,693,327,1421,1225,2362,6028,4
twalt,1264,226,1959,1295,1284,6028,4
zimmy,176,2239,885,612,2116,6028,4
dyfed,1128,458,271,3252,917,6026,4
trust,1264,1543,990,945,1284,6026,4
agast,1698,139,1959,945,1284,6025,4
award,1698,226,1959,1225,917,6025,4
chaco,1512,927,1959,770,857,6025,4
uzara,420,59,1959,1225,2362,6025,4
kroll,789,1543,1426,1295,971,6024,4
nihon,647,2239,334,1282,1522,6024,4
tizzy,1264,2239,217,186,2116,6022,4
ajiva,1698,32,1668,259,2362,6019,4
krell,789,1543,1421,1295,971,6019,4
cholo,1512,927,1426,1295,857,6017,4
fuggy,847,1824,616,612,2116,6015,4
robbi,948,3069,664,423,910,6014,4
mucic,1225,1824,701,1963,300,6013,4
vizir,404,2239,217,1963,1190,6013,4
avast,1698,126,1959,945,1284,6012,4
quott,93,1824,1426,1385,1284,6012,4
gnarr,965,671,1959,1225,1190,6010,4
egide,693,139,1668,829,2679,6008,4
acini,1698,338,1668,1391,910,6005,4
apply,1698,336,560,1295,2116,6005,4
mokum,1225,3069,406,899,406,6005,4
usnin,420,341,1757,1963,1522,6003,4
cuffy,1512,1824,271,278,2116,6001,4
ruffe,948,1824,271,278,2679,6000,4
akali,1698,137,1959,1295,910,5999,4
hajji,844,4103,81,61,910,5999,4
inial,473,671,1668,2214,971,5997,4
annul,1698,671,1757,899,971,5996,4
edger,693,245,616,3252,1190,5996,4
crick,1512,1543,1668,770,502,5995,4
amini,1698,327,1668,1391,910,5994,4
ifrit,473,73,2201,1963,1284,5994,4
bromo,1555,1543,1426,612,857,5993,4
mhorr,1225,927,1426,1225,1190,5993,4
odder,532,245,774,3252,1190,5993,4
ejasa,693,32,1959,945,2362,5991,4
guppy,965,1824,560,526,2116,5991,4
ajani,1698,32,1959,1391,910,5990,4
arkab,1698,1543,406,2214,129,5990,4
cynic,1512,458,1757,1963,300,5990,4
swash,2206,226,1959,945,654,5990,4
mbaya,1225,172,1959,271,2362,5989,4
debbi,1128,2863,664,423,910,5988,4
slush,2206,1193,990,945,654,5988,4
woomp,596,3069,1426,612,285,5988,4
estre,693,341,1048,1225,2679,5986,4
tmema,1264,327,1421,612,2362,5986,4
cusco,1512,1824,1021,770,857,5984,4
emule,693,327,990,1295,2679,5984,4
mizzy,1225,2239,217,186,2116,5983,4
vullo,404,1824,1603,1295,857,5983,4
icity,473,338,1668,1385,2116,5980,4
imide,473,327,1668,829,2679,5976,4
angka,1698,671,616,628,2362,5975,4
rubby,948,1824,664,423,2116,5975,4
jeffy,446,2863,271,278,2116,5974,4
mymar,1225,458,885,2214,1190,5972,4
ijmaa,473,32,885,2214,2362,5966,4
abott,1698,172,1426,1385,1284,5965,4
rhett,948,927,1421,1385,1284,5965,4
zudda,176,1824,774,829,2362,5965,4
ensue,693,671,1021,899,2679,5963,4
epode,693,336,1426,829,2679,5963,4
heugh,844,2863,990,612,654,5963,4
edyie,693,245,381,1963,2679,5961,4
rstse,948,341,1048,945,2679,5961,4
bimbo,1555,2239,885,423,857,5959,4
hutto,844,1824,1048,1385,857,5958,4
aphra,1698,336,334,1225,2362,5955,4
proso,1184,1543,1426,945,857,5955,4
engle,693,671,616,1295,2679,5954,4
alawi,1698,1193,1959,192,910,5952,4
szell,2206,59,1421,1295,971,5952,4
reggi,948,2863,616,612,910,5949,4
ecafe,693,338,1959,278,2679,5947,4
cdiac,1512,245,1668,2214,300,5939,4
floor,847,1193,1426,1282,1190,5938,4
lumut,1046,1824,885,899,1284,5938,4
smurr,2206,327,990,1225,1190,5938,4
clack,1512,1193,1959,770,502,5936,4
yeech,225,2863,1421,770,654,5933,4
equel,693,25,990,3252,971,5931,4
wryly,596,1543,381,1295,2116,5931,4
bragg,1555,1543,1959,612,261,5930,4
hyatt,844,458,1959,1385,1284,5930,4
eleva,693,1193,1421,259,2362,5928,4
orton,532,1543,1048,1282,1522,5927,4
royou,948,3069,381,1282,247,5927,4
ummps,420,327,885,526,3767,5925,4
adowa,1698,245,1426,192,2362,5923,4
oyama,532,458,1959,612,2362,5923,4
aldol,1698,1193,774,1282,971,5918,4
irvin,473,1543,417,1963,1522,5918,4
primi,1184,1543,1668,612,910,5917,4
droud,1128,1543,1426,899,917,5913,4
abeam,1698,172,1421,2214,406,5911,4
yesso,225,2863,1021,945,857,5911,4
ccoya,1512,338,1426,271,2362,5909,4
abyla,1698,172,381,1295,2362,5908,4
myall,1225,458,1959,1295,971,5908,4
nunci,647,1824,1757,770,910,5908,4
rubor,948,1824,664,1282,1190,5908,4
aghan,1698,139,334,2214,1522,5907,4
apili,1698,336,1668,1295,910,5907,4
skink,2206,137,1668,1391,502,5904,4
akbar,1698,137,664,2214,1190,5903,4
tzaam,1264,59,1959,2214,406,5902,4
enlil,693,671,1603,1963,971,5901,4
kiosk,789,2239,1426,945,502,5901,4
orson,532,1543,1021,1282,1522,5900,4
cheth,1512,927,1421,1385,654,5899,4
prodd,1184,1543,1426,829,917,5899,4
allow,1698,1193,1603,1282,122,5898,4
buzzy,1555,1824,217,186,2116,5898,4
alibi,1698,1193,1668,423,910,5892,4
elyse,693,1193,381,945,2679,5891,4
icily,473,338,1668,1295,2116,5890,4
jibby,446,2239,664,423,2116,5888,4
dizzy,1128,2239,217,186,2116,5886,4
rebob,948,2863,664,1282,129,5886,4
dekko,1128,2863,406,628,857,5882,4
esker,693,341,406,3252,1190,5882,4
yucca,225,1824,701,770,2362,5882,4
ahull,1698,927,990,1295,971,5881,4
udder,420,245,774,3252,1190,5881,4
ology,532,1193,1426,612,2116,5879,4
truro,1264,1543,990,1225,857,5879,4
xwsds,36,226,1021,829,3767,5879,4
asarh,1698,341,1959,1225,654,5877,4
autum,1698,1824,1048,899,406,5875,4
ancon,1698,671,701,1282,1522,5874,4
fubby,847,1824,664,423,2116,5874,4
ether,693,403,334,3252,1190,5872,4
omora,532,327,1426,1225,2362,5872,4
tythe,1264,458,1048,423,2679,5872,4
hubby,844,1824,664,423,2116,5871,4
cufic,1512,1824,271,1963,300,5870,4
snoop,2206,671,1426,1282,285,5870,4
giffy,965,2239,271,278,2116,5869,4
ssing,2206,341,1668,1391,261,5867,4
tokyo,1264,3069,406,271,857,5867,4
stull,2206,403,990,1295,971,5865,4
bloom,1555,1193,1426,1282,406,5862,4
kwapa,789,226,1959,526,2362,5862,4
nixon,647,2239,170,1282,1522,5860,4
troco,1264,1543,1426,770,857,5860,4
whitt,596,927,1668,1385,1284,5860,4
ancha,1698,671,701,423,2362,5855,4
embed,693,327,664,3252,917,5853,4
spasm,2206,336,1959,945,406,5852,4
quill,93,1824,1668,1295,971,5851,4
irwin,473,1543,349,1963,1522,5850,4
askar,1698,341,406,2214,1190,5849,4
hunch,844,1824,1757,770,654,5849,4
iliac,473,1193,1668,2214,300,5848,4
duomo,1128,1824,1426,612,857,5847,4
imsvs,473,327,1021,259,3767,5847,4
littb,1046,2239,1048,1385,129,5847,4
stopt,2206,403,1426,526,1284,5845,4
churr,1512,927,990,1225,1190,5844,4
wilow,596,2239,1603,1282,122,5842,4
stept,2206,403,1421,526,1284,5840,4
athar,1698,403,334,2214,1190,5839,4
truth,1264,1543,990,1385,654,5836,4
lucic,1046,1824,701,1963,300,5834,4
twint,1264,226,1668,1391,1284,5833,4
lyssa,1046,458,1021,945,2362,5832,4
dredi,1128,1543,1421,829,910,5831,4
ssbam,2206,341,664,2214,406,5831,4
abdal,1698,172,774,2214,971,5829,4
gring,965,1543,1668,1391,261,5828,4
tight,1264,2239,616,423,1284,5826,4
ajari,1698,32,1959,1225,910,5824,4
sposi,2206,336,1426,945,910,5823,4
osaka,532,341,1959,628,2362,5822,4
stook,2206,403,1426,1282,502,5819,4
afoam,1698,73,1426,2214,406,5817,4
vmcms,404,327,701,612,3767,5811,4
esher,693,341,334,3252,1190,5810,4
yssel,225,341,1021,3252,971,5810,4
alpax,1698,1193,560,2214,144,5809,4
cutch,1512,1824,1048,770,654,5808,4
lizzy,1046,2239,217,186,2116,5804,4
cycad,1512,458,701,2214,917,5802,4
scull,2206,338,990,1295,971,5800,4
troop,1264,1543,1426,1282,285,5800,4
clich,1512,1193,1668,770,654,5797,4
ibada,473,172,1959,829,2362,5795,4
iliau,473,1193,1668,2214,247,5795,4
troft,1264,1543,1426,278,1284,5795,4
aggry,1698,139,616,1225,2116,5794,4
atoll,1698,403,1426,1295,971,5793,4
vikky,404,2239,406,628,2116,5793,4
micco,1225,2239,701,770,857,5792,4
obola,532,172,1426,1295,2362,5787,4
phono,1184,927,1426,1391,857,5785,4
glood,965,1193,1426,1282,917,5783,4
emery,693,327,1421,1225,2116,5782,4
luffa,1046,1824,271,278,2362,5781,4
kucik,789,1824,701,1963,502,5779,4
photo,1184,927,1426,1385,857,5779,4
achar,1698,338,334,2214,1190,5774,4
gwinn,965,226,1668,1391,1522,5772,4
ozona,532,59,1426,1391,2362,5770,4
jeddo,446,2863,774,829,857,5769,4
suffr,2206,1824,271,278,1190,5769,4
inrun,473,671,2201,899,1522,5766,4
nunki,647,1824,1757,628,910,5766,4
inman,473,671,885,2214,1522,5765,4
afoot,1698,73,1426,1282,1284,5763,4
amhar,1698,327,334,2214,1190,5763,4
myrrh,1225,458,2201,1225,654,5763,4
rohob,948,3069,334,1282,129,5762,4
algol,1698,1193,616,1282,971,5760,4
enema,693,671,1421,612,2362,5759,4
upper,420,336,560,3252,1190,5758,4
adoxa,1698,245,1426,26,2362,5757,4
zullo,176,1824,1603,1295,857,5755,4
crock,1512,1543,1426,770,502,5753,4
spook,2206,336,1426,1282,502,5752,4
lrecl,1046,1543,1421,770,971,5751,4
myopy,1225,458,1426,526,2116,5751,4
picco,1184,2239,701,770,857,5751,4
enzed,693,671,217,3252,917,5750,4
skidi,2206,137,1668,829,910,5750,4
obese,532,172,1421,945,2679,5749,4
pgntt,1184,139,1757,1385,1284,5749,4
emesa,693,327,1421,945,2362,5748,4
whall,596,927,1959,1295,971,5748,4
lussi,1046,1824,1021,945,910,5746,4
aloof,1698,1193,1426,1282,145,5744,4
smook,2206,327,1426,1282,502,5743,4
bloop,1555,1193,1426,1282,285,5741,4
djinn,1128,32,1668,1391,1522,5741,4
twilt,1264,226,1668,1295,1284,5737,4
ruelu,948,1824,1421,1295,247,5735,4
chico,1512,927,1668,770,857,5734,4
giuki,965,2239,990,628,910,5732,4
aspca,1698,341,560,770,2362,5731,4
bezzi,1555,2863,217,186,910,5731,4
kebob,789,2863,664,1282,129,5727,4
amadi,1698,327,1959,829,910,5723,4
cresc,1512,1543,1421,945,300,5721,4
gekko,965,2863,406,628,857,5719,4
stymy,2206,403,381,612,2116,5718,4
endue,693,671,774,899,2679,5716,4
onawa,532,671,1959,192,2362,5716,4
tissu,1264,2239,1021,945,247,5716,4
acool,1698,338,1426,1282,971,5715,4
ammon,1698,327,885,1282,1522,5714,4
muffy,1225,1824,271,278,2116,5714,4
adapt,1698,245,1959,526,1284,5712,4
unman,420,671,885,2214,1522,5712,4
erect,693,1543,1421,770,1284,5711,4
exode,693,83,1426,829,2679,5710,4
leupp,1046,2863,990,526,285,5710,4
akili,1698,137,1668,1295,910,5708,4
bucco,1555,1824,701,770,857,5707,4
aberr,1698,172,1421,1225,1190,5706,4
unuse,420,671,990,945,2679,5705,4
micki,1225,2239,701,628,910,5703,4
jocko,446,3069,701,628,857,5701,4
excel,693,83,701,3252,971,5700,4
swish,2206,226,1668,945,654,5699,4
thoro,1264,927,1426,1225,857,5699,4
cloop,1512,1193,1426,1282,285,5698,4
admah,1698,245,885,2214,654,5696,4
elexa,693,1193,1421,26,2362,5695,4
exeat,693,83,1421,2214,1284,5695,4
hulch,844,1824,1603,770,654,5695,4
ajuga,1698,32,990,612,2362,5694,4
wolff,596,3069,1603,278,145,5691,4
thurt,1264,927,990,1225,1284,5690,4
elche,693,1193,701,423,2679,5689,4
empeo,693,327,560,3252,857,5689,4
wyatt,596,458,1959,1385,1284,5682,4
ewery,693,226,1421,1225,2116,5681,4
abkar,1698,172,406,2214,1190,5680,4
bezzo,1555,2863,217,186,857,5678,4
geoff,965,2863,1426,278,145,5677,4
nubby,647,1824,664,423,2116,5674,4
puffy,1184,1824,271,278,2116,5673,4
nllst,647,1193,1603,945,1284,5672,4
amado,1698,327,1959,829,857,5670,4
chack,1512,927,1959,770,502,5670,4
lithi,1046,2239,1048,423,910,5666,4
oomph,532,3069,885,526,654,5666,4
pouff,1184,3069,990,278,145,5666,4
eneid,693,671,1421,1963,917,5665,4
flood,847,1193,1426,1282,917,5665,4
gussi,965,1824,1021,945,910,5665,4
droop,1128,1543,1426,1282,285,5664,4
mccoy,1225,338,701,1282,2116,5662,4
eckel,693,338,406,3252,971,5660,4
spoom,2206,336,1426,1282,406,5656,4
usure,420,341,990,1225,2679,5655,4
indan,473,671,774,2214,1522,5654,4
ethel,693,403,334,3252,971,5653,4
nunch,647,1824,1757,770,654,5652,4
clerc,1512,1193,1421,1225,300,5651,4
yuruk,225,1824,2201,899,502,5651,4
offen,532,73,271,3252,1522,5650,4
chook,1512,927,1426,1282,502,5649,4
dramm,1128,1543,1959,612,406,5648,4
russi,948,1824,1021,945,910,5648,4
snapp,2206,671,1959,526,285,5647,4
click,1512,1193,1668,770,502,5645,4
brigg,1555,1543,1668,612,261,5639,4
engem,693,671,616,3252,406,5638,4
stacc,2206,403,1959,770,300,5638,4
obama,532,172,1959,612,2362,5637,4
trooz,1264,1543,1426,1282,122,5637,4
amang,1698,327,1959,1391,261,5636,4
buddh,1555,1824,774,829,654,5636,4
stosh,2206,403,1426,945,654,5634,4
scadc,2206,338,1959,829,300,5632,4
adell,1698,245,1421,1295,971,5630,4
assot,1698,341,1021,1282,1284,5626,4
untin,420,671,1048,1963,1522,5624,4
enmew,693,671,885,3252,122,5623,4
yfere,225,73,1421,1225,2679,5623,4
groom,965,1543,1426,1282,406,5622,4
promo,1184,1543,1426,612,857,5622,4
athal,1698,403,334,2214,971,5620,4
butsu,1555,1824,1048,945,247,5619,4
obiit,532,172,1668,1963,1284,5619,4
anyah,1698,671,381,2214,654,5618,4
duffy,1128,1824,271,278,2116,5617,4
zippy,176,2239,560,526,2116,5617,4
adawn,1698,245,1959,192,1522,5616,4
irbil,473,1543,664,1963,971,5614,4
ascii,1698,341,701,1963,910,5613,4
shipp,2206,927,1668,526,285,5612,4
anabo,1698,671,1959,423,857,5608,4
eleni,693,1193,1421,1391,910,5608,4
mitzi,1225,2239,1048,186,910,5608,4
whirr,596,927,1668,1225,1190,5606,4
fizzy,847,2239,217,186,2116,5605,4
ahouh,1698,927,1426,899,654,5604,4
quell,93,1824,1421,1295,971,5604,4
omaha,532,327,1959,423,2362,5603,4
stoop,2206,403,1426,1282,285,5602,4
anack,1698,671,1959,770,502,5600,4
skull,2206,137,990,1295,971,5599,4
unsin,420,671,1021,1963,1522,5597,4
russo,948,1824,1021,945,857,5595,4
etude,693,403,990,829,2679,5594,4
pmirr,1184,327,1668,1225,1190,5594,4
prepd,1184,1543,1421,526,917,5591,4
plook,1184,1193,1426,1282,502,5587,4
ollav,532,1193,1603,2214,41,5583,4
smasf,2206,327,1959,945,145,5582,4
every,693,126,1421,1225,2116,5581,4
incan,473,671,701,2214,1522,5581,4
orrum,532,1543,2201,899,406,5581,4
blagg,1555,1193,1959,612,261,5580,4
pryor,1184,1543,381,1282,1190,5580,4
proof,1184,1543,1426,1282,145,5580,4
olton,532,1193,1048,1282,1522,5577,4
wysty,596,458,1021,1385,2116,5576,4
adpao,1698,245,560,2214,857,5574,4
ekaha,693,137,1959,423,2362,5574,4
thach,1264,927,1959,770,654,5574,4
vuggy,404,1824,616,612,2116,5572,4
kokum,789,3069,406,899,406,5569,4
cutup,1512,1824,1048,899,285,5568,4
muzzy,1225,1824,217,186,2116,5568,4
sposh,2206,336,1426,945,654,5567,4
crabb,1512,1543,1959,423,129,5566,4
ecize,693,338,1668,186,2679,5564,4
union,420,671,1668,1282,1522,5563,4
irbid,473,1543,664,1963,917,5560,4
animi,1698,671,1668,612,910,5559,4
expel,693,83,560,3252,971,5559,4
cloof,1512,1193,1426,1282,145,5558,4
abell,1698,172,1421,1295,971,5557,4
hitch,844,2239,1048,770,654,5555,4
knott,789,671,1426,1385,1284,5555,4
bpdpa,1555,336,774,526,2362,5553,4
choom,1512,927,1426,1282,406,5553,4
evoke,693,126,1426,628,2679,5552,4
alkol,1698,1193,406,1282,971,5550,4
olson,532,1193,1021,1282,1522,5550,4
floro,847,1193,1426,1225,857,5548,4
bumbo,1555,1824,885,423,857,5544,4
imvia,473,327,417,1963,2362,5542,4
rishi,948,2239,1021,423,910,5541,4
amalg,1698,327,1959,1295,261,5540,4
tsort,1264,341,1426,1225,1284,5540,4
addio,1698,245,774,1963,857,5537,4
enorn,693,671,1426,1225,1522,5537,4
scoop,2206,338,1426,1282,285,5537,4
etzel,693,403,217,3252,971,5536,4
eched,693,338,334,3252,917,5534,4
inaja,473,671,1959,61,2362,5526,4
gwenn,965,226,1421,1391,1522,5525,4
ineye,473,671,1421,271,2679,5515,4
shaff,2206,927,1959,278,145,5515,4
whoot,596,927,1426,1282,1284,5515,4
enemy,693,671,1421,612,2116,5513,4
iraki,473,1543,1959,628,910,5513,4
tugui,1264,1824,616,899,910,5513,4
endew,693,671,774,3252,122,5512,4
nylon,647,458,1603,1282,1522,5512,4
avell,1698,126,1421,1295,971,5511,4
usphs,420,341,560,423,3767,5511,4
abaci,1698,172,1959,770,910,5509,4
amarc,1698,327,1959,1225,300,5509,4
droob,1128,1543,1426,1282,129,5508,4
rimpi,948,2239,885,526,910,5508,4
nuadu,647,1824,1959,829,247,5506,4
ovapa,532,126,1959,526,2362,5505,4
froom,847,1543,1426,1282,406,5504,4
limbi,1046,2239,885,423,910,5503,4
achad,1698,338,334,2214,917,5501,4
groop,965,1543,1426,1282,285,5501,4
michi,1225,2239,701,423,910,5498,4
ingan,473,671,616,2214,1522,5496,4
yucky,225,1824,701,628,2116,5494,4
hicht,844,2239,701,423,1284,5491,4
eleut,693,1193,1421,899,1284,5490,4
isaak,473,341,1959,2214,502,5489,4
kiddo,789,2239,774,829,857,5488,4
aduwa,1698,245,990,192,2362,5487,4
upped,420,336,560,3252,917,5485,4
abbye,1698,172,664,271,2679,5484,4
awash,1698,226,1959,945,654,5482,4
agsam,1698,139,1021,2214,406,5478,4
shojo,2206,927,1426,61,857,5477,4
clapp,1512,1193,1959,526,285,5475,4
ysaye,225,341,1959,271,2679,5475,4
kymry,789,458,885,1225,2116,5473,4
khalk,789,927,1959,1295,502,5472,4
lydda,1046,458,774,829,2362,5469,4
ajhar,1698,32,334,2214,1190,5468,4
erept,693,1543,1421,526,1284,5467,4
engin,693,671,616,1963,1522,5465,4
stoof,2206,403,1426,1282,145,5462,4
uneye,420,671,1421,271,2679,5462,4
fulup,847,1824,1603,899,285,5458,4
pichi,1184,2239,701,423,910,5457,4
swosh,2206,226,1426,945,654,5457,4
whill,596,927,1668,1295,971,5457,4
abaco,1698,172,1959,770,857,5456,4
guffy,965,1824,271,278,2116,5454,4
nohow,647,3069,334,1282,122,5454,4
glynn,965,1193,381,1391,1522,5452,4
ozzie,532,59,217,1963,2679,5450,4
evatt,693,126,1959,1385,1284,5447,4
tippo,1264,2239,560,526,857,5446,4
zemmi,176,2863,885,612,910,5446,4
awaft,1698,226,1959,278,1284,5445,4
flurr,847,1193,990,1225,1190,5445,4
smoko,2206,327,1426,628,857,5444,4
undue,420,671,774,899,2679,5443,4
stagg,2206,403,1959,612,261,5441,4
kusso,789,1824,1021,945,857,5436,4
huzza,844,1824,217,186,2362,5433,4
nyssa,647,458,1021,945,2362,5433,4
choop,1512,927,1426,1282,285,5432,4
annum,1698,671,1757,899,406,5431,4
abash,1698,172,1959,945,654,5428,4
ricki,948,2239,701,628,910,5426,4
swoop,2206,226,1426,1282,285,5425,4
twill,1264,226,1668,1295,971,5424,4
nific,647,2239,271,1963,300,5420,4
vivax,404,2239,417,2214,144,5418,4
tryst,1264,1543,381,945,1284,5417,4
chamm,1512,927,1959,612,406,5416,4
vibix,404,2239,664,1963,144,5414,4
issue,473,341,1021,899,2679,5413,4
attic,1698,403,1048,1963,300,5412,4
trixi,1264,1543,1668,26,910,5411,4
vizza,404,2239,217,186,2362,5408,4
hight,844,2239,616,423,1284,5406,4
uvver,420,126,417,3252,1190,5405,4
clock,1512,1193,1426,770,502,5403,4
scifi,2206,338,1668,278,910,5400,4
cleck,1512,1193,1421,770,502,5398,4
grego,965,1543,1421,612,857,5398,4
fifth,847,2239,271,1385,654,5396,4
husht,844,1824,1021,423,1284,5396,4
spoof,2206,336,1426,1282,145,5395,4
abaft,1698,172,1959,278,1284,5391,4
ipava,473,336,1959,259,2362,5389,4
oncin,532,671,701,1963,1522,5389,4
ottar,532,403,1048,2214,1190,5387,4
twist,1264,226,1668,945,1284,5387,4
emove,693,327,1426,259,2679,5384,4
kimmo,789,2239,885,612,857,5382,4
kishi,789,2239,1021,423,910,5382,4
inuit,473,671,990,1963,1284,5381,4
chick,1512,927,1668,770,502,5379,4
ahvaz,1698,927,417,2214,122,5378,4
uprun,420,336,2201,899,1522,5378,4
educe,693,245,990,770,2679,5377,4
ortol,532,1543,1048,1282,971,5376,4
emyle,693,327,381,1295,2679,5375,4
amici,1698,327,1668,770,910,5373,4
encke,693,671,701,628,2679,5372,4
adamo,1698,245,1959,612,857,5371,4
irido,473,1543,1668,829,857,5370,4
qubba,93,1824,664,423,2362,5366,4
shepp,2206,927,1421,526,285,5365,4
uigur,420,2239,616,899,1190,5364,4
elect,693,1193,1421,770,1284,5361,4
groof,965,1543,1426,1282,145,5361,4
usafa,420,341,1959,278,2362,5360,4
artcc,1698,1543,1048,770,300,5359,4
orosi,532,1543,1426,945,910,5356,4
heygh,844,2863,381,612,654,5354,4
choko,1512,927,1426,628,857,5350,4
isiah,473,341,1668,2214,654,5350,4
jiffy,446,2239,271,278,2116,5350,4
exsec,693,83,1021,3252,300,5349,4
ition,473,403,1668,1282,1522,5348,4
mezzo,1225,2863,217,186,857,5348,4
upaya,420,336,1959,271,2362,5348,4
isize,473,341,1668,186,2679,5347,4
groow,965,1543,1426,1282,122,5338,4
iring,473,1543,1668,1391,261,5336,4
flynn,847,1193,381,1391,1522,5334,4
edema,693,245,1421,612,2362,5333,4
huffy,844,1824,271,278,2116,5333,4
asabi,1698,341,1959,423,910,5331,4
asahi,1698,341,1959,423,910,5331,4
astto,1698,341,1048,1385,857,5329,4
ddpex,1128,245,560,3252,144,5329,4
csect,1512,341,1421,770,1284,5328,4
isawa,473,341,1959,192,2362,5327,4
mukul,1225,1824,406,899,971,5325,4
hewgh,844,2863,349,612,654,5322,4
lichi,1046,2239,701,423,910,5319,4
agami,1698,139,1959,612,910,5318,4
offer,532,73,271,3252,1190,5318,4
cruck,1512,1543,990,770,502,5317,4
dufur,1128,1824,271,899,1190,5312,4
ahwaz,1698,927,349,2214,122,5310,4
stsci,2206,403,1021,770,910,5310,4
gnawn,965,671,1959,192,1522,5309,4
sttng,2206,403,1048,1391,261,5309,4
illth,473,1193,1603,1385,654,5308,4
thoom,1264,927,1426,1282,406,5305,4
ayllu,1698,458,1603,1295,247,5301,4
knorr,789,671,1426,1225,1190,5301,4
thymy,1264,927,381,612,2116,5300,4
eddra,693,245,774,1225,2362,5299,4
klenk,789,1193,1421,1391,502,5296,4
iclid,473,338,1603,1963,917,5294,4
hurff,844,1824,2201,278,145,5292,4
primp,1184,1543,1668,612,285,5292,4
odawa,532,245,1959,192,2362,5290,4
isaac,473,341,1959,2214,300,5287,4
tripp,1264,1543,1668,526,285,5286,4
irish,473,1543,1668,945,654,5283,4
ellyn,693,1193,1603,271,1522,5282,4
abidi,1698,172,1668,829,910,5277,4
quauk,93,1824,1959,899,502,5277,4
abask,1698,172,1959,945,502,5276,4
exude,693,83,990,829,2679,5274,4
freyr,847,1543,1421,271,1190,5272,4
gloom,965,1193,1426,1282,406,5272,4
provo,1184,1543,1426,259,857,5269,4
unorn,420,671,1426,1225,1522,5264,4
embue,693,327,664,899,2679,5262,4
edveh,693,245,417,3252,654,5261,4
wrawl,596,1543,1959,192,971,5261,4
snaff,2206,671,1959,278,145,5259,4
gueux,965,1824,1421,899,144,5253,4
flook,847,1193,1426,1282,502,5250,4
tipup,1264,2239,560,899,285,5247,4
orlop,532,1543,1603,1282,285,5245,4
vnern,404,671,1421,1225,1522,5243,4
nishi,647,2239,1021,423,910,5240,4
ascap,1698,341,701,2214,285,5239,4
rycca,948,458,701,770,2362,5239,4
inari,473,671,1959,1225,910,5238,4
omarr,532,327,1959,1225,1190,5233,4
atavi,1698,403,1959,259,910,5229,4
hofuf,844,3069,271,899,145,5228,4
skunk,2206,137,990,1391,502,5226,4
shiff,2206,927,1668,278,145,5224,4
quitu,93,1824,1668,1385,247,5217,4
reffo,948,2863,271,278,857,5217,4
awabi,1698,226,1959,423,910,5216,4
wholl,596,927,1426,1295,971,5215,4
ahush,1698,927,990,945,654,5214,4
mumbo,1225,1824,885,423,857,5214,4
yecch,225,2863,701,770,654,5213,4
khaki,789,927,1959,628,910,5213,4
anaxo,1698,671,1959,26,857,5211,4
obaza,532,172,1959,186,2362,5211,4
izaak,473,59,1959,2214,502,5207,4
uprip,420,336,2201,1963,285,5205,4
grimm,965,1543,1668,612,406,5194,4
hokku,844,3069,406,628,247,5194,4
uvula,420,126,990,1295,2362,5193,4
fuzzy,847,1824,217,186,2116,5190,4
idion,473,245,1668,1282,1522,5190,4
huzzy,844,1824,217,186,2116,5187,4
acmic,1698,338,885,1963,300,5184,4
ogawa,532,139,1959,192,2362,5184,4
cuzco,1512,1824,217,770,857,5180,4
thoft,1264,927,1426,278,1284,5179,4
asaph,1698,341,1959,526,654,5178,4
kheth,789,927,1421,1385,654,5176,4
obion,532,172,1668,1282,1522,5176,4
unwan,420,671,349,2214,1522,5176,4
theft,1264,927,1421,278,1284,5174,4
mbuba,1225,172,990,423,2362,5172,4
numud,647,1824,885,899,917,5172,4
sntsc,2206,671,1048,945,300,5170,4
hipmi,844,2239,560,612,910,5165,4
vizzy,404,2239,217,186,2116,5162,4
frapp,847,1543,1959,526,285,5160,4
fouqu,847,3069,990,5,247,5158,4
aging,1698,139,1668,1391,261,5157,4
kukri,789,1824,406,1225,910,5154,4
emmit,693,327,885,1963,1284,5152,4
knoll,789,671,1426,1295,971,5152,4
assur,1698,341,1021,899,1190,5149,4
gippo,965,2239,560,526,857,5147,4
knell,789,671,1421,1295,971,5147,4
espec,693,341,560,3252,300,5146,4
jussi,446,1824,1021,945,910,5146,4
knark,789,671,1959,1225,502,5146,4
puggi,1184,1824,616,612,910,5146,4
ewall,693,226,1959,1295,971,5144,4
hutch,844,1824,1048,770,654,5140,4
chock,1512,927,1426,770,502,5137,4
unpin,420,671,560,1963,1522,5136,4
check,1512,927,1421,770,502,5132,4
blaff,1555,1193,1959,278,145,5130,4
skulk,2206,137,990,1295,502,5130,4
fricc,847,1543,1668,770,300,5128,4
intil,473,671,1048,1963,971,5126,4
nicki,647,2239,701,628,910,5125,4
thigh,1264,927,1668,612,654,5125,4
atypy,1698,403,381,526,2116,5124,4
smush,2206,327,990,945,654,5122,4
enfin,693,671,271,1963,1522,5120,4
avahi,1698,126,1959,423,910,5116,4
aspac,1698,341,560,2214,300,5113,4
husch,844,1824,1021,770,654,5113,4
nimbi,647,2239,885,423,910,5104,4
uhllo,420,927,1603,1295,857,5102,4
aback,1698,172,1959,770,502,5101,4
abbot,1698,172,664,1282,1284,5100,4
anzac,1698,671,217,2214,300,5100,4
enweb,693,671,349,3252,129,5094,4
tucum,1264,1824,701,899,406,5094,4
thowt,1264,927,1426,192,1284,5093,4
blurb,1555,1193,990,1225,129,5092,4
usury,420,341,990,1225,2116,5092,4
bukum,1555,1824,406,899,406,5090,4
outdo,532,1824,1048,829,857,5090,4
elayl,693,1193,1959,271,971,5087,4
ultun,420,1193,1048,899,1522,5082,4
erech,693,1543,1421,770,654,5081,4
addnl,1698,245,774,1391,971,5079,4
ossal,532,341,1021,2214,971,5079,4
usaaf,420,341,1959,2214,145,5079,4
amoco,1698,327,1426,770,857,5078,4
oribi,532,1543,1668,423,910,5076,4
brizz,1555,1543,1668,186,122,5074,4
flacc,847,1193,1959,770,300,5069,4
vroom,404,1543,1426,1282,406,5061,4
immew,473,327,885,3252,122,5059,4
egall,693,139,1959,1295,971,5057,4
draff,1128,1543,1959,278,145,5053,4
jhool,446,927,1426,1282,971,5052,4
izawa,473,59,1959,192,2362,5045,4
offed,532,73,271,3252,917,5045,4
zingg,176,2239,1757,612,261,5045,4
gypsy,965,458,560,945,2116,5044,4
dwell,1128,226,1421,1295,971,5041,4
itali,473,403,1959,1295,910,5040,4
ohelo,532,927,1421,1295,857,5032,4
krock,789,1543,1426,770,502,5030,4
limmu,1046,2239,885,612,247,5029,4
ixion,473,83,1668,1282,1522,5028,4
agasp,1698,139,1959,945,285,5026,4
hippo,844,2239,560,526,857,5026,4
etuve,693,403,990,259,2679,5024,4
vithi,404,2239,1048,423,910,5024,4
uzzia,420,59,217,1963,2362,5021,4
widow,596,2239,774,1282,122,5013,4
ghoom,965,927,1426,1282,406,5006,4
odeon,532,245,1421,1282,1522,5002,4
orlov,532,1543,1603,1282,41,5001,4
junji,446,1824,1757,61,910,4998,4
isiac,473,341,1668,2214,300,4996,4
husum,844,1824,1021,899,406,4994,4
staff,2206,403,1959,278,145,4991,4
iddat,473,245,774,2214,1284,4990,4
scomm,2206,338,1426,612,406,4988,4
oxeye,532,83,1421,271,2679,4986,4
pygmy,1184,458,616,612,2116,4986,4
rhymy,948,927,381,612,2116,4984,4
unkin,420,671,406,1963,1522,4982,4
sheff,2206,927,1421,278,145,4977,4
vicco,404,2239,701,770,857,4971,4
husho,844,1824,1021,423,857,4969,4
sniff,2206,671,1668,278,145,4968,4
cluck,1512,1193,990,770,502,4967,4
ovoid,532,126,1426,1963,917,4964,4
oddly,532,245,774,1295,2116,4962,4
flyby,847,1193,381,423,2116,4960,4
bucku,1555,1824,701,628,247,4955,4
idiot,473,245,1668,1282,1284,4952,4
idaic,473,245,1959,1963,300,4940,4
kusum,789,1824,1021,899,406,4939,4
wuzzy,596,1824,217,186,2116,4939,4
usual,420,341,990,2214,971,4936,4
prepg,1184,1543,1421,526,261,4935,4
frigg,847,1543,1668,612,261,4931,4
ripup,948,2239,560,899,285,4931,4
bcdic,1555,338,774,1963,300,4930,4
ennui,693,671,1757,899,910,4930,4
musgu,1225,1824,1021,612,247,4929,4
iroko,473,1543,1426,628,857,4927,4
scaff,2206,338,1959,278,145,4926,4
klick,789,1193,1668,770,502,4922,4
unson,420,671,1021,1282,1522,4916,4
event,693,126,1421,1391,1284,4915,4
kyoto,789,458,1426,1385,857,4915,4
ulund,420,1193,990,1391,917,4911,4
emyde,693,327,381,829,2679,4909,4
adham,1698,245,334,2214,406,4897,4
apptd,1698,336,560,1385,917,4896,4
dubbo,1128,1824,664,423,857,4896,4
kkyra,789,137,381,1225,2362,4894,4
emili,693,327,1668,1295,910,4893,4
apepi,1698,336,1421,526,910,4891,4
cumbu,1512,1824,885,423,247,4891,4
graff,965,1543,1959,278,145,4890,4
iraqi,473,1543,1959,5,910,4890,4
udall,420,245,1959,1295,971,4890,4
byssi,1555,458,1021,945,910,4889,4
ifint,473,73,1668,1391,1284,4889,4
vicki,404,2239,701,628,910,4882,4
inurn,473,671,990,1225,1522,4881,4
nummi,647,1824,885,612,910,4878,4
odont,532,245,1426,1391,1284,4878,4
guzul,965,1824,217,899,971,4876,4
outgo,532,1824,1048,612,857,4873,4
flagg,847,1193,1959,612,261,4872,4
mnium,1225,671,1668,899,406,4869,4
askja,1698,341,406,61,2362,4868,4
lubbi,1046,1824,664,423,910,4867,4
klunk,789,1193,990,1391,502,4865,4
ibiza,473,172,1668,186,2362,4861,4
khaph,789,927,1959,526,654,4855,4
lloyd,1046,1193,1426,271,917,4853,4
eggar,693,139,616,2214,1190,4852,4
ochoa,532,338,334,1282,2362,4848,4
buffi,1555,1824,271,278,910,4838,4
tibbu,1264,2239,664,423,247,4837,4
kloof,789,1193,1426,1282,145,4835,4
fromm,847,1543,1426,612,406,4834,4
elemi,693,1193,1421,612,910,4829,4
accur,1698,338,701,899,1190,4826,4
cyclo,1512,458,701,1295,857,4823,4
skipp,2206,137,1668,526,285,4822,4
chaff,1512,927,1959,278,145,4821,4
didym,1128,2239,774,271,406,4818,4
uball,420,172,1959,1295,971,4817,4
iviza,473,126,1668,186,2362,4815,4
sluff,2206,1193,990,278,145,4812,4
olavo,532,1193,1959,259,857,4800,4
cliff,1512,1193,1668,278,145,4796,4
unadd,420,671,1959,829,917,4796,4
ebert,693,172,1421,1225,1284,4795,4
akeki,1698,137,1421,628,910,4794,4
whish,596,927,1668,945,654,4790,4
buffo,1555,1824,271,278,857,4785,4
scopp,2206,338,1426,526,285,4781,4
lysol,1046,458,1021,1282,971,4778,4
nikko,647,2239,406,628,857,4777,4
ovalo,532,126,1959,1295,857,4769,4
acapu,1698,338,1959,526,247,4768,4
phyll,1184,927,381,1295,971,4758,4
iznik,473,59,1757,1963,502,4754,4
jtunn,446,403,990,1391,1522,4752,4
klapp,789,1193,1959,526,285,4752,4
whoso,596,927,1426,945,857,4751,4
buchu,1555,1824,701,423,247,4750,4
emend,693,327,1421,1391,917,4749,4
evert,693,126,1421,1225,1284,4749,4
ovett,532,126,1421,1385,1284,4748,4
thokk,1264,927,1426,628,502,4747,4
undid,420,671,774,1963,917,4745,4
inwit,473,671,349,1963,1284,4740,4
indio,473,671,774,1963,857,4738,4
acock,1698,338,1426,770,502,4734,4
gubbo,965,1824,664,423,857,4733,4
humph,844,1824,885,526,654,4733,4
zebub,176,2863,664,899,129,4731,4
abamp,1698,172,1959,612,285,4726,4
skaff,2206,137,1959,278,145,4725,4
blizz,1555,1193,1668,186,122,4724,4
ashab,1698,341,334,2214,129,4716,4
iyyar,473,458,381,2214,1190,4716,4
imino,473,327,1668,1391,857,4716,4
achab,1698,338,334,2214,129,4713,4
oryol,532,1543,381,1282,971,4709,4
youff,225,3069,990,278,145,4707,4
achaz,1698,338,334,2214,122,4706,4
exert,693,83,1421,1225,1284,4706,4
chuck,1512,927,990,770,502,4701,4
ineri,473,671,1421,1225,910,4700,4
stiff,2206,403,1668,278,145,4700,4
knack,789,671,1959,770,502,4691,4
ivett,473,126,1421,1385,1284,4689,4
howff,844,3069,349,278,145,4685,4
rcmac,948,338,885,2214,300,4685,4
oxboy,532,83,664,1282,2116,4677,4
appro,1698,336,560,1225,857,4676,4
essam,693,341,1021,2214,406,4675,4
undon,420,671,774,1282,1522,4669,4
islip,473,341,1603,1963,285,4665,4
izmit,473,59,885,1963,1284,4664,4
infit,473,671,271,1963,1284,4662,4
troff,1264,1543,1426,278,145,4656,4
adobo,1698,245,1426,423,857,4649,4
hucho,844,1824,701,423,857,4649,4
shufu,2206,927,990,278,247,4648,4
hypha,844,458,560,423,2362,4647,4
esque,693,341,32,899,2679,4644,4
assoc,1698,341,1021,1282,300,4642,4
ilium,473,1193,1668,899,406,4639,4
spiff,2206,336,1668,278,145,4633,4
zimbi,176,2239,885,423,910,4633,4
abebi,1698,172,1421,423,910,4624,4
idist,473,245,1668,945,1284,4615,4
which,596,927,1668,770,654,4615,4
nyoro,647,458,1426,1225,857,4613,4
known,789,671,1426,192,1522,4600,4
griff,965,1543,1668,278,145,4599,4
odilo,532,245,1668,1295,857,4597,4
aggri,1698,139,616,1225,910,4588,4
sspru,2206,341,560,1225,247,4579,4
iloko,473,1193,1426,628,857,4577,4
izmir,473,59,885,1963,1190,4570,4
sybyl,2206,458,664,271,971,4570,4
ewest,693,226,1421,945,1284,4569,4
dhabb,1128,927,1959,423,129,4566,4
akyab,1698,137,381,2214,129,4559,4
nufud,647,1824,271,899,917,4558,4
cloff,1512,1193,1426,278,145,4554,4
intnl,473,671,1048,1391,971,4554,4
nudum,647,1824,774,899,406,4550,4
umiri,420,327,1668,1225,910,4550,4
shuff,2206,927,990,278,145,4546,4
agoho,1698,139,1426,423,857,4543,4
aggur,1698,139,616,899,1190,4542,4
alkyl,1698,1193,406,271,971,4539,4
ghyll,965,927,381,1295,971,4539,4
aggro,1698,139,616,1225,857,4535,4
iceni,473,338,1421,1391,910,4533,4
jiqui,446,2239,32,899,910,4526,4
assyr,1698,341,1021,271,1190,4521,4
whoop,596,927,1426,1282,285,4516,4
achoo,1698,338,334,1282,857,4509,4
onmun,532,671,885,899,1522,4509,4
hlhsr,844,1193,334,945,1190,4506,4
adjag,1698,245,81,2214,261,4499,4
appmt,1698,336,560,612,1284,4490,4
eleph,693,1193,1421,526,654,4487,4
gwynn,965,226,381,1391,1522,4485,4
egest,693,139,1421,945,1284,4482,4
agung,1698,139,990,1391,261,4479,4
kyack,789,458,1959,770,502,4478,4
yusuk,225,1824,1021,899,502,4471,4
twixt,1264,226,1668,26,1284,4468,4
trubu,1264,1543,990,423,247,4467,4
odell,532,245,1421,1295,971,4464,4
stoff,2206,403,1426,278,145,4458,4
hichu,844,2239,701,423,247,4454,4
steff,2206,403,1421,278,145,4453,4
rizzo,948,2239,217,186,857,4447,4
otero,532,403,1421,1225,857,4438,4
upbuy,420,336,664,899,2116,4435,4
skiff,2206,137,1668,278,145,4434,4
schuh,2206,338,334,899,654,4431,4
klemm,789,1193,1421,612,406,4421,4
whewt,596,927,1421,192,1284,4420,4
czech,1512,59,1421,770,654,4416,4
chizz,1512,927,1668,186,122,4415,4
stupp,2206,403,990,526,285,4410,4
tcpip,1264,338,560,1963,285,4410,4
swizz,2206,226,1668,186,122,4408,4
bbxrt,1555,172,170,1225,1284,4406,4
idell,473,245,1421,1295,971,4405,4
appui,1698,336,560,899,910,4403,4
ortho,532,1543,1048,423,857,4403,4
dpnph,1128,336,1757,526,654,4401,4
knick,789,671,1668,770,502,4400,4
icaco,473,338,1959,770,857,4397,4
bruzz,1555,1543,990,186,122,4396,4
scoff,2206,338,1426,278,145,4393,4
iispb,473,2239,1021,526,129,4388,4
ursuk,420,1543,1021,899,502,4385,4
whoof,596,927,1426,1282,145,4376,4
usque,420,341,32,899,2679,4371,4
nusku,647,1824,1021,628,247,4367,4
frizz,847,1543,1668,186,122,4366,4
omero,532,327,1421,1225,857,4362,4
quipu,93,1824,1668,526,247,4358,4
groff,965,1543,1426,278,145,4357,4
ehudd,693,927,990,829,917,4356,4
igloo,473,139,1603,1282,857,4354,4
greff,965,1543,1421,278,145,4352,4
udell,420,245,1421,1295,971,4352,4
xylol,36,458,1603,1282,971,4350,4
mckim,1225,338,406,1963,406,4338,4
yumuk,225,1824,885,899,502,4335,4
oboli,532,172,1426,1295,910,4335,4
oketo,532,137,1421,1385,857,4332,4
utrum,420,403,2201,899,406,4329,4
zucco,176,1824,701,770,857,4328,4
gwawl,965,226,1959,192,971,4313,4
onymy,532,671,381,612,2116,4312,4
quaff,93,1824,1959,278,145,4299,4
odour,532,245,1426,899,1190,4292,4
snuff,2206,671,990,278,145,4290,4
ovoli,532,126,1426,1295,910,4289,4
inigo,473,671,1668,612,857,4281,4
essig,693,341,1021,1963,261,4279,4
uvrou,420,126,2201,1282,247,4276,4
kumyk,789,1824,885,271,502,4271,4
epopt,693,336,1426,526,1284,4265,4
plump,1184,1193,990,612,285,4264,4
exect,693,83,1421,770,1284,4251,4
oneco,532,671,1421,770,857,4251,4
ffrdc,847,73,2201,829,300,4250,4
gliff,965,1193,1668,278,145,4249,4
ogdon,532,139,774,1282,1522,4249,4
clubb,1512,1193,990,423,129,4247,4
izzat,473,59,217,2214,1284,4247,4
kluck,789,1193,990,770,502,4244,4
unwon,420,671,349,1282,1522,4244,4
ongun,532,671,616,899,1522,4240,4
ephah,693,336,334,2214,654,4231,4
ruffi,948,1824,271,278,910,4231,4
unown,420,671,1426,192,1522,4231,4
knapp,789,671,1959,526,285,4230,4
truff,1264,1543,990,278,145,4220,4
inonu,473,671,1426,1391,247,4208,4
iberi,473,172,1421,1225,910,4201,4
eject,693,32,1421,770,1284,4200,4
upsun,420,336,1021,899,1522,4198,4
jugum,446,1824,616,899,406,4191,4
occam,532,338,701,2214,406,4191,4
ungag,420,671,616,2214,261,4182,4
indic,473,671,774,1963,300,4181,4
octic,532,338,1048,1963,300,4181,4
ruffo,948,1824,271,278,857,4178,4
yucch,225,1824,701,770,654,4174,4
ofori,532,73,1426,1225,910,4166,4
bluff,1555,1193,990,278,145,4161,4
knock,789,671,1426,770,502,4158,4
imido,473,327,1668,829,857,4154,4
stubb,2206,403,990,423,129,4151,4
affix,1698,73,271,1963,144,4149,4
otkon,532,403,406,1282,1522,4145,4
ossip,532,341,1021,1963,285,4142,4
ising,473,341,1668,1391,261,4134,4
krupp,789,1543,990,526,285,4133,4
icing,473,338,1668,1391,261,4131,4
etacc,693,403,1959,770,300,4125,4
istic,473,341,1048,1963,300,4125,4
cluff,1512,1193,990,278,145,4118,4
whush,596,927,990,945,654,4112,4
whewl,596,927,1421,192,971,4107,4
immun,473,327,885,899,1522,4106,4
abepp,1698,172,1421,526,285,4102,4
onego,532,671,1421,612,857,4093,4
onemo,532,671,1421,612,857,4093,4
nguni,647,139,990,1391,910,4077,4
idiom,473,245,1668,1282,406,4074,4
imaum,473,327,1959,899,406,4064,4
offal,532,73,271,2214,971,4061,4
indri,473,671,774,1225,910,4053,4
grubb,965,1543,990,423,129,4050,4
asdsp,1698,341,774,945,285,4043,4
accum,1698,338,701,899,406,4042,4
nroff,647,1543,1426,278,145,4039,4
plupf,1184,1193,990,526,145,4038,4
stuff,2206,403,990,278,145,4022,4
osmol,532,341,885,1282,971,4011,4
quiff,93,1824,1668,278,145,4008,4
chubb,1512,927,990,423,129,3981,4
eddic,693,245,774,1963,300,3975,4
uncut,420,671,701,899,1284,3975,4
absbh,1698,172,1021,423,654,3968,4
scuff,2206,338,990,278,145,3957,4
uluhi,420,1193,990,423,910,3936,4
indiv,473,671,774,1963,41,3922,4
gruff,965,1543,990,278,145,3921,4
otomi,532,403,1426,612,910,3883,4
epiph,693,336,1668,526,654,3877,4
chuff,1512,927,990,278,145,3852,4
izing,473,59,1668,1391,261,3852,4
ussct,420,341,1021,770,1284,3836,4
unput,420,671,560,899,1284,3834,4
otego,532,403,1421,612,857,3825,4
kudzu,789,1824,774,186,247,3820,4
pluff,1184,1193,990,278,145,3790,4
nuzzi,647,1824,217,186,910,3784,4
addcp,1698,245,774,770,285,3772,4
hyozo,844,458,1426,186,857,3771,4
exxon,693,83,170,1282,1522,3750,4
idism,473,245,1668,945,406,3737,4
espoo,693,341,560,1282,857,3733,4
upolu,420,336,1426,1295,247,3724,4
adccp,1698,245,701,770,285,3699,4
ngoko,647,139,1426,628,857,3697,4
idium,473,245,1668,899,406,3691,4
nkomo,647,137,1426,612,857,3679,4
iwbni,473,226,664,1391,910,3664,4
occur,532,338,701,899,1190,3660,4
owego,532,226,1421,612,857,3648,4
injun,473,671,81,899,1522,3646,4
upcut,420,336,701,899,1284,3640,4
esdud,693,341,774,899,917,3624,4
whiff,596,927,1668,278,145,3614,4
mvssp,1225,126,1021,945,285,3602,4
adfrf,1698,245,271,1225,145,3584,4
unbud,420,671,664,899,917,3571,4
infix,473,671,271,1963,144,3522,4
eveck,693,126,1421,770,502,3512,4
whizz,596,927,1668,186,122,3499,4
gnoff,965,671,1426,278,145,3485,4
izzak,473,59,217,2214,502,3465,4
unfur,420,671,271,899,1190,3451,4
idzik,473,245,217,1963,502,3400,4
gyppo,965,458,560,526,857,3366,4
idyll,473,245,381,1295,971,3365,4
etssp,693,403,1021,945,285,3347,4
ochro,532,338,334,1225,857,3286,4
usurp,420,341,990,1225,285,3261,4
usecc,420,341,1421,770,300,3252,4
utsuk,420,403,1021,899,502,3245,4
khufu,789,927,990,278,247,3231,4
enugu,693,671,990,612,247,3213,4
ichth,473,338,334,1385,654,3184,4
abuzz,1698,172,990,186,122,3168,4
imshi,473,327,1021,423,910,3154,4
hypho,844,458,560,423,857,3142,4
offic,532,73,271,1963,300,3139,4
nssdc,647,341,1021,829,300,3138,4
lwoff,1046,226,1426,278,145,3121,4
edtcc,693,245,1048,770,300,3056,4
izumi,473,59,990,612,910,3044,4
tvtwm,1264,126,1048,192,406,3036,4
undug,420,671,774,899,261,3025,4
ungum,420,671,616,899,406,3012,4
immov,473,327,885,1282,41,3008,4
ddcmp,1128,245,701,612,285,2971,4
ekwok,693,137,349,1282,502,2963,4
uskok,420,341,406,1282,502,2951,4
okubo,532,137,990,423,857,2939,4
whuff,596,927,990,278,145,2936,4
undub,420,671,774,899,129,2893,4
kyzyl,789,458,217,271,971,2706,4
oxbow,532,83,664,1282,122,2683,4
ewhow,693,226,334,1282,122,2657,4
rvsvp,948,126,1021,259,285,2639,4
encyc,693,671,701,271,300,2636,4
nspcc,647,341,560,770,300,2618,4
nspmp,647,341,560,612,285,2445,4
zmudz,176,327,990,829,122,2444,4
uskub,420,341,406,899,129,2195,4
seres,2206,2863,2201,3252,3767,14289,3
salas,2206,4103,1603,2214,3767,13893,3
seree,2206,2863,2201,3252,2679,13201,3
samas,2206,4103,885,2214,3767,13175,3
semes,2206,2863,885,3252,3767,12973,3
sagas,2206,4103,616,2214,3767,12906,3
faaas,847,4103,1959,2214,3767,12890,3
eases,693,4103,1021,3252,3767,12836,3
sanaa,2206,4103,1757,2214,2362,12642,3
casas,1512,4103,1021,2214,3767,12617,3
nanas,647,4103,1757,2214,3767,12488,3
sises,2206,2239,1021,3252,3767,12485,3
siris,2206,2239,2201,1963,3767,12376,3
babas,1555,4103,664,2214,3767,12303,3
cacas,1512,4103,701,2214,3767,12297,3
nenes,647,2863,1757,3252,3767,12286,3
sexes,2206,2863,170,3252,3767,12258,3
mamas,1225,4103,885,2214,3767,12194,3
sarra,2206,4103,2201,1225,2362,12097,3
dadas,1128,4103,774,2214,3767,11986,3
belee,1555,2863,1603,3252,2679,11952,3
cooee,1512,3069,1426,3252,2679,11938,3
aenea,1698,2863,1757,3252,2362,11932,3
sinis,2206,2239,1757,1963,3767,11932,3
solos,2206,3069,1603,1282,3767,11927,3
semee,2206,2863,885,3252,2679,11885,3
soots,2206,3069,1426,1385,3767,11853,3
papas,1184,4103,560,2214,3767,11828,3
sarsa,2206,4103,2201,945,2362,11817,3
lalls,1046,4103,1603,1295,3767,11814,3
sells,2206,2863,1603,1295,3767,11734,3
serer,2206,2863,2201,3252,1190,11712,3
rarer,948,4103,2201,3252,1190,11694,3
melee,1225,2863,1603,3252,2679,11622,3
gagee,965,4103,616,3252,2679,11615,3
lenee,1046,2863,1757,3252,2679,11597,3
pelee,1184,2863,1603,3252,2679,11581,3
seels,2206,2863,1421,1295,3767,11552,3
neses,647,2863,1021,3252,3767,11550,3
renee,948,2863,1757,3252,2679,11499,3
seers,2206,2863,1421,1225,3767,11482,3
barra,1555,4103,2201,1225,2362,11446,3
arras,1698,1543,2201,2214,3767,11423,3
sotos,2206,3069,1048,1282,3767,11372,3
besee,1555,2863,1021,3252,2679,11370,3
gelee,965,2863,1603,3252,2679,11362,3
iasis,473,4103,1021,1963,3767,11327,3
aieee,1698,2239,1421,3252,2679,11289,3
kakas,789,4103,406,2214,3767,11279,3
setts,2206,2863,1048,1385,3767,11269,3
hahas,844,4103,334,2214,3767,11262,3
salsa,2206,4103,1603,945,2362,11219,3
banna,1555,4103,1757,1391,2362,11168,3
tarra,1264,4103,2201,1225,2362,11155,3
yeses,225,2863,1021,3252,3767,11128,3
canna,1512,4103,1757,1391,2362,11125,3
marra,1225,4103,2201,1225,2362,11116,3
sills,2206,2239,1603,1295,3767,11110,3
iaria,473,4103,2201,1963,2362,11102,3
salal,2206,4103,1603,2214,971,11097,3
sooks,2206,3069,1426,628,3767,11096,3
seeds,2206,2863,1421,829,3767,11086,3
lalia,1046,4103,1603,1963,2362,11077,3
parra,1184,4103,2201,1225,2362,11075,3
aapss,1698,4103,560,945,3767,11073,3
sasan,2206,4103,1021,2214,1522,11066,3
maana,1225,4103,1959,1391,2362,11040,3
darra,1128,4103,2201,1225,2362,11019,3
cerer,1512,2863,2201,3252,1190,11018,3
sasse,2206,4103,1021,945,2679,10954,3
sunns,2206,1824,1757,1391,3767,10945,3
balla,1555,4103,1603,1295,2362,10918,3
toots,1264,3069,1426,1385,3767,10911,3
seeks,2206,2863,1421,628,3767,10885,3
tanna,1264,4103,1757,1391,2362,10877,3
calla,1512,4103,1603,1295,2362,10875,3
tanta,1264,4103,1757,1385,2362,10871,3
seems,2206,2863,1421,612,3767,10869,3
tanan,1264,4103,1757,2214,1522,10860,3
yaray,225,4103,2201,2214,2116,10859,3
cabaa,1512,4103,664,2214,2362,10855,3
manna,1225,4103,1757,1391,2362,10838,3
panna,1184,4103,1757,1391,2362,10797,3
seeps,2206,2863,1421,526,3767,10783,3
skees,2206,137,1421,3252,3767,10783,3
lolls,1046,3069,1603,1295,3767,10780,3
seuss,2206,2863,990,945,3767,10771,3
resee,948,2863,1021,3252,2679,10763,3
pedee,1184,2863,774,3252,2679,10752,3
danna,1128,4103,1757,1391,2362,10741,3
tatia,1264,4103,1048,1963,2362,10740,3
farra,847,4103,2201,1225,2362,10738,3
merer,1225,2863,2201,3252,1190,10731,3
lanna,1046,4103,1757,1391,2362,10659,3
selle,2206,2863,1603,1295,2679,10646,3
barba,1555,4103,2201,423,2362,10644,3
cacia,1512,4103,701,1963,2362,10641,3
darda,1128,4103,2201,829,2362,10623,3
tepee,1264,2863,560,3252,2679,10618,3
sausa,2206,4103,990,945,2362,10606,3
debee,1128,2863,664,3252,2679,10586,3
ranna,948,4103,1757,1391,2362,10561,3
harar,844,4103,2201,2214,1190,10552,3
caama,1512,4103,1959,612,2362,10548,3
palla,1184,4103,1603,1295,2362,10547,3
narra,647,4103,2201,1225,2362,10538,3
aarau,1698,4103,2201,2214,247,10463,3
hanna,844,4103,1757,1391,2362,10457,3
batta,1555,4103,1048,1385,2362,10453,3
sense,2206,2863,1757,945,2679,10450,3
hanan,844,4103,1757,2214,1522,10440,3
tenet,1264,2863,1757,3252,1284,10420,3
eerie,693,2863,2201,1963,2679,10399,3
tehee,1264,2863,334,3252,2679,10392,3
sassy,2206,4103,1021,945,2116,10391,3
seise,2206,2863,1668,945,2679,10361,3
caaba,1512,4103,1959,423,2362,10359,3
jarra,446,4103,2201,1225,2362,10337,3
cocos,1512,3069,701,1282,3767,10331,3
galla,965,4103,1603,1295,2362,10328,3
pewee,1184,2863,349,3252,2679,10327,3
noons,647,3069,1426,1391,3767,10300,3
tests,1264,2863,1021,1385,3767,10300,3
sulus,2206,1824,1603,899,3767,10299,3
naara,647,4103,1959,1225,2362,10296,3
titis,1264,2239,1048,1963,3767,10281,3
aalii,1698,4103,1603,1963,910,10277,3
erses,693,1543,1021,3252,3767,10276,3
levee,1046,2863,417,3252,2679,10257,3
benne,1555,2863,1757,1391,2679,10245,3
boobs,1555,3069,1426,423,3767,10240,3
henen,844,2863,1757,3252,1522,10238,3
terre,1264,2863,2201,1225,2679,10232,3
momos,1225,3069,885,1282,3767,10228,3
falla,847,4103,1603,1295,2362,10210,3
wanna,596,4103,1757,1391,2362,10209,3
halla,844,4103,1603,1295,2362,10207,3
banba,1555,4103,1757,423,2362,10200,3
danda,1128,4103,1757,829,2362,10179,3
caeca,1512,4103,1421,770,2362,10168,3
jaala,446,4103,1959,1295,2362,10165,3
lally,1046,4103,1603,1295,2116,10163,3
deess,1128,2863,1421,945,3767,10124,3
matta,1225,4103,1048,1385,2362,10123,3
sasha,2206,4103,1021,423,2362,10115,3
annas,1698,671,1757,2214,3767,10107,3
patta,1184,4103,1048,1385,2362,10082,3
asses,1698,341,1021,3252,3767,10079,3
tutee,1264,1824,1048,3252,2679,10067,3
janna,446,4103,1757,1391,2362,10059,3
cacan,1512,4103,701,2214,1522,10052,3
eulee,693,1824,1603,3252,2679,10051,3
sasak,2206,4103,1021,2214,502,10046,3
ririe,948,2239,2201,1963,2679,10030,3
kapaa,789,4103,560,2214,2362,10028,3
dodos,1128,3069,774,1282,3767,10020,3
vanna,404,4103,1757,1391,2362,10017,3
nanny,647,4103,1757,1391,2116,10014,3
deeds,1128,2863,1421,829,3767,10008,3
belle,1555,2863,1603,1295,2679,9995,3
bassa,1555,4103,1021,945,2362,9986,3
raama,948,4103,1959,612,2362,9984,3
poops,1184,3069,1426,526,3767,9972,3
amaas,1698,327,1959,2214,3767,9965,3
walla,596,4103,1603,1295,2362,9959,3
leler,1046,2863,1603,3252,1190,9954,3
tenne,1264,2863,1757,1391,2679,9954,3
celle,1512,2863,1603,1295,2679,9952,3
latta,1046,4103,1048,1385,2362,9944,3
kosos,789,3069,1021,1282,3767,9928,3
elses,693,1193,1021,3252,3767,9926,3
tatty,1264,4103,1048,1385,2116,9916,3
yarry,225,4103,2201,1225,2116,9870,3
hisis,844,2239,1021,1963,3767,9834,3
kaama,789,4103,1959,612,2362,9825,3
aella,1698,2863,1603,1295,2362,9821,3
yanan,225,4103,1757,2214,1522,9821,3
tatar,1264,4103,1048,2214,1190,9819,3
beele,1555,2863,1421,1295,2679,9813,3
ganga,965,4103,1757,612,2362,9799,3
seege,2206,2863,1421,612,2679,9781,3
vaasa,404,4103,1959,945,2362,9773,3
array,1698,1543,2201,2214,2116,9772,3
arria,1698,1543,2201,1963,2362,9767,3
deled,1128,2863,1603,3252,917,9763,3
peeps,1184,2863,1421,526,3767,9761,3
sabba,2206,4103,664,423,2362,9758,3
hatta,844,4103,1048,1385,2362,9742,3
skiis,2206,137,1668,1963,3767,9741,3
cauca,1512,4103,990,770,2362,9737,3
halal,844,4103,1603,2214,971,9735,3
babar,1555,4103,664,2214,1190,9726,3
wehee,596,2863,334,3252,2679,9724,3
stats,2206,403,1959,1385,3767,9720,3
simms,2206,2239,885,612,3767,9709,3
gogos,965,3069,616,1282,3767,9699,3
nanda,647,4103,1757,829,2362,9698,3
kooks,789,3069,1426,628,3767,9679,3
massa,1225,4103,1021,945,2362,9656,3
jooss,446,3069,1426,945,3767,9653,3
galga,965,4103,1603,612,2362,9645,3
renne,948,2863,1757,1391,2679,9638,3
kaaba,789,4103,1959,423,2362,9636,3
shoos,2206,927,1426,1282,3767,9608,3
kerek,789,2863,2201,3252,502,9607,3
eeler,693,2863,1603,3252,1190,9601,3
yalla,225,4103,1603,1295,2362,9588,3
babua,1555,4103,664,899,2362,9583,3
cence,1512,2863,1757,770,2679,9581,3
delle,1128,2863,1603,1295,2679,9568,3
dodds,1128,3069,774,829,3767,9567,3
rorry,948,3069,2201,1225,2116,9559,3
areae,1698,1543,1421,2214,2679,9555,3
malam,1225,4103,1603,2214,406,9551,3
waapa,596,4103,1959,526,2362,9546,3
natta,647,4103,1048,1385,2362,9545,3
deden,1128,2863,774,3252,1522,9539,3
peene,1184,2863,1421,1391,2679,9538,3
lulls,1046,1824,1603,1295,3767,9535,3
bette,1555,2863,1048,1385,2679,9530,3
bacca,1555,4103,701,770,2362,9491,3
nanga,647,4103,1757,612,2362,9481,3
lassa,1046,4103,1021,945,2362,9477,3
epees,693,336,1421,3252,3767,9469,3
keeks,789,2863,1421,628,3767,9468,3
babai,1555,4103,664,2214,910,9446,3
peele,1184,2863,1421,1295,2679,9442,3
katat,789,4103,1048,2214,1284,9438,3
jerre,446,2863,2201,1225,2679,9414,3
dedie,1128,2863,774,1963,2679,9407,3
sudds,2206,1824,774,829,3767,9400,3
tetel,1264,2863,1048,3252,971,9398,3
sessa,2206,2863,1021,945,2362,9397,3
cacao,1512,4103,701,2214,857,9387,3
eeten,693,2863,1048,3252,1522,9378,3
verre,404,2863,2201,1225,2679,9372,3
naman,647,4103,885,2214,1522,9371,3
lasal,1046,4103,1021,2214,971,9355,3
tebet,1264,2863,664,3252,1284,9327,3
gerge,965,2863,2201,612,2679,9320,3
ceded,1512,2863,774,3252,917,9318,3
deere,1128,2863,1421,1225,2679,9316,3
kokos,789,3069,406,1282,3767,9313,3
babka,1555,4103,664,628,2362,9312,3
nanon,647,4103,1757,1282,1522,9311,3
cacka,1512,4103,701,628,2362,9306,3
bebel,1555,2863,664,3252,971,9305,3
sibbs,2206,2239,664,423,3767,9299,3
helle,844,2863,1603,1295,2679,9284,3
shahs,2206,927,1959,423,3767,9282,3
kaiak,789,4103,1668,2214,502,9276,3
padda,1184,4103,774,829,2362,9252,3
bebed,1555,2863,664,3252,917,9251,3
radar,948,4103,774,2214,1190,9229,3
nonna,647,3069,1757,1391,2362,9226,3
tamma,1264,4103,885,612,2362,9226,3
nanak,647,4103,1757,2214,502,9223,3
kassa,789,4103,1021,945,2362,9220,3
lilia,1046,2239,1603,1963,2362,9213,3
spass,2206,336,1959,945,3767,9213,3
teste,1264,2863,1021,1385,2679,9212,3
tacca,1264,4103,701,770,2362,9200,3
memel,1225,2863,885,3252,971,9196,3
layla,1046,4103,381,1295,2362,9187,3
stets,2206,403,1421,1385,3767,9182,3
arran,1698,1543,2201,2214,1522,9178,3
rfree,948,73,2201,3252,2679,9153,3
keene,789,2863,1421,1391,2679,9143,3
conon,1512,3069,1757,1282,1522,9142,3
lulus,1046,1824,1603,899,3767,9139,3
remer,948,2863,885,3252,1190,9138,3
jenne,446,2863,1757,1391,2679,9136,3
meese,1225,2863,1421,945,2679,9133,3
lolly,1046,3069,1603,1295,2116,9129,3
aurar,1698,1824,2201,2214,1190,9127,3
ssrms,2206,341,2201,612,3767,9127,3
papua,1184,4103,560,899,2362,9108,3
aetat,1698,2863,1048,2214,1284,9107,3
dette,1128,2863,1048,1385,2679,9103,3
estes,693,341,1048,3252,3767,9101,3
torot,1264,3069,2201,1282,1284,9100,3
nelle,647,2863,1603,1295,2679,9087,3
tevet,1264,2863,417,3252,1284,9080,3
nassa,647,4103,1021,945,2362,9078,3
dacca,1128,4103,701,770,2362,9064,3
besse,1555,2863,1021,945,2679,9063,3
pampa,1184,4103,885,526,2362,9060,3
peper,1184,2863,560,3252,1190,9049,3
teety,1264,2863,1421,1385,2116,9049,3
keele,789,2863,1421,1295,2679,9047,3
dagda,1128,4103,616,829,2362,9038,3
feere,847,2863,1421,1225,2679,9035,3
kakan,789,4103,406,2214,1522,9034,3
cacak,1512,4103,701,2214,502,9032,3
papal,1184,4103,560,2214,971,9032,3
lette,1046,2863,1048,1385,2679,9021,3
lemel,1046,2863,885,3252,971,9017,3
waaaf,596,4103,1959,2214,145,9017,3
camac,1512,4103,885,2214,300,9014,3
kelek,789,2863,1603,3252,502,9009,3
smoos,2206,327,1426,1282,3767,9008,3
mamba,1225,4103,885,423,2362,8998,3
teece,1264,2863,1421,770,2679,8997,3
leela,1046,2863,1421,1295,2362,8987,3
lacca,1046,4103,701,770,2362,8982,3
nonny,647,3069,1757,1391,2116,8980,3
moror,1225,3069,2201,1282,1190,8967,3
meece,1225,2863,1421,770,2679,8958,3
leese,1046,2863,1421,945,2679,8954,3
daddy,1128,4103,774,829,2116,8950,3
mammy,1225,4103,885,612,2116,8941,3
cacam,1512,4103,701,2214,406,8936,3
gamma,965,4103,885,612,2362,8927,3
cocoa,1512,3069,701,1282,2362,8926,3
spiss,2206,336,1668,945,3767,8922,3
magma,1225,4103,616,612,2362,8918,3
neele,647,2863,1421,1295,2679,8905,3
kaska,789,4103,1021,628,2362,8903,3
jelle,446,2863,1603,1295,2679,8886,3
totty,1264,3069,1048,1385,2116,8882,3
geese,965,2863,1421,945,2679,8873,3
reger,948,2863,616,3252,1190,8869,3
lille,1046,2239,1603,1295,2679,8862,3
babby,1555,4103,664,423,2116,8861,3
reese,948,2863,1421,945,2679,8856,3
monon,1225,3069,1757,1282,1522,8855,3
leede,1046,2863,1421,829,2679,8838,3
allay,1698,1193,1603,2214,2116,8824,3
dagga,1128,4103,616,612,2362,8821,3
tappa,1264,4103,560,526,2362,8815,3
swiss,2206,226,1668,945,3767,8812,3
nanni,647,4103,1757,1391,910,8808,3
tutus,1264,1824,1048,899,3767,8802,3
assis,1698,341,1021,1963,3767,8790,3
didie,1128,2239,774,1963,2679,8783,3
beeve,1555,2863,1421,259,2679,8777,3
torto,1264,3069,2201,1385,857,8776,3
peeke,1184,2863,1421,628,2679,8775,3
mesem,1225,2863,1021,3252,406,8767,3
kette,789,2863,1048,1385,2679,8764,3
reded,948,2863,774,3252,917,8754,3
laval,1046,4103,417,2214,971,8751,3
stoss,2206,403,1426,945,3767,8747,3
reede,948,2863,1421,829,2679,8740,3
messe,1225,2863,1021,945,2679,8733,3
valva,404,4103,1603,259,2362,8731,3
madam,1225,4103,774,2214,406,8722,3
nadda,647,4103,774,829,2362,8715,3
sttos,2206,403,1048,1282,3767,8706,3
apass,1698,336,1959,945,3767,8705,3
kakar,789,4103,406,2214,1190,8702,3
neven,647,2863,417,3252,1522,8701,3
keese,789,2863,1421,945,2679,8697,3
amass,1698,327,1959,945,3767,8696,3
capac,1512,4103,560,2214,300,8689,3
reece,948,2863,1421,770,2679,8681,3
dabba,1128,4103,664,423,2362,8680,3
tetty,1264,2863,1048,1385,2116,8676,3
rever,948,2863,417,3252,1190,8670,3
bibbs,1555,2239,664,423,3767,8648,3
leeke,1046,2863,1421,628,2679,8637,3
innis,473,671,1757,1963,3767,8631,3
concn,1512,3069,1757,770,1522,8630,3
nette,647,2863,1048,1385,2679,8622,3
zelle,176,2863,1603,1295,2679,8616,3
oolly,532,3069,1603,1295,2116,8615,3
dinin,1128,2239,1757,1963,1522,8609,3
namma,647,4103,885,612,2362,8609,3
bybee,1555,458,664,3252,2679,8608,3
eppes,693,336,560,3252,3767,8608,3
erred,693,1543,2201,3252,917,8606,3
kakke,789,4103,406,628,2679,8605,3
alana,1698,1193,1959,1391,2362,8603,3
mumus,1225,1824,885,899,3767,8600,3
labba,1046,4103,664,423,2362,8598,3
lappa,1046,4103,560,526,2362,8597,3
booby,1555,3069,1426,423,2116,8589,3
zanza,176,4103,1757,186,2362,8584,3
morro,1225,3069,2201,1225,857,8577,3
arere,1698,1543,1421,1225,2679,8566,3
deked,1128,2863,406,3252,917,8566,3
iorio,473,3069,2201,1963,857,8563,3
lusus,1046,1824,1021,899,3767,8557,3
neese,647,2863,1421,945,2679,8555,3
nefen,647,2863,271,3252,1522,8555,3
tatoo,1264,4103,1048,1282,857,8554,3
level,1046,2863,417,3252,971,8549,3
lilla,1046,2239,1603,1295,2362,8545,3
koror,789,3069,2201,1282,1190,8531,3
linin,1046,2239,1757,1963,1522,8527,3
sissy,2206,2239,1021,945,2116,8527,3
caffa,1512,4103,271,278,2362,8526,3
refer,948,2863,271,3252,1190,8524,3
desde,1128,2863,1021,829,2679,8520,3
abbas,1698,172,664,2214,3767,8515,3
jadda,446,4103,774,829,2362,8514,3
dewed,1128,2863,349,3252,917,8509,3
dadap,1128,4103,774,2214,285,8504,3
pappy,1184,4103,560,526,2116,8489,3
maxma,1225,4103,170,612,2362,8472,3
momme,1225,3069,885,612,2679,8470,3
araua,1698,1543,1959,899,2362,8461,3
baboo,1555,4103,664,1282,857,8461,3
annia,1698,671,1757,1963,2362,8451,3
brere,1555,1543,1421,1225,2679,8423,3
rexer,948,2863,170,3252,1190,8423,3
yassy,225,4103,1021,945,2116,8410,3
peeve,1184,2863,1421,259,2679,8406,3
verve,404,2863,2201,259,2679,8406,3
bobbe,1555,3069,664,423,2679,8390,3
greer,965,1543,1421,3252,1190,8371,3
fusus,847,1824,1021,899,3767,8358,3
deedy,1128,2863,1421,829,2116,8357,3
fesse,847,2863,1021,945,2679,8355,3
cocao,1512,3069,701,2214,857,8353,3
hesse,844,2863,1021,945,2679,8352,3
aceae,1698,338,1421,2214,2679,8350,3
csacs,1512,341,1959,770,3767,8349,3
hakka,844,4103,406,628,2362,8343,3
kappa,789,4103,560,526,2362,8340,3
araca,1698,1543,1959,770,2362,8332,3
tonto,1264,3069,1757,1385,857,8332,3
mumms,1225,1824,885,612,3767,8313,3
stuss,2206,403,990,945,3767,8311,3
arrah,1698,1543,2201,2214,654,8310,3
tellt,1264,2863,1603,1295,1284,8309,3
lilly,1046,2239,1603,1295,2116,8299,3
kesse,789,2863,1021,945,2679,8297,3
wagga,596,4103,616,612,2362,8289,3
kooka,789,3069,1426,628,2362,8274,3
kinin,789,2239,1757,1963,1522,8270,3
ellen,693,1193,1603,3252,1522,8263,3
dreed,1128,1543,1421,3252,917,8261,3
freer,847,1543,1421,3252,1190,8253,3
maffa,1225,4103,271,278,2362,8239,3
allan,1698,1193,1603,2214,1522,8230,3
arrha,1698,1543,2201,423,2362,8227,3
ocoee,532,338,1426,3252,2679,8227,3
cecca,1512,2863,701,770,2362,8208,3
nappa,647,4103,560,526,2362,8198,3
papaw,1184,4103,560,2214,122,8183,3
reeve,948,2863,1421,259,2679,8170,3
elwee,693,1193,349,3252,2679,8166,3
yacca,225,4103,701,770,2362,8161,3
kafka,789,4103,271,628,2362,8153,3
momma,1225,3069,885,612,2362,8153,3
ninny,647,2239,1757,1391,2116,8150,3
theet,1264,927,1421,3252,1284,8148,3
alloa,1698,1193,1603,1282,2362,8138,3
tazza,1264,4103,217,186,2362,8132,3
ellie,693,1193,1603,1963,2679,8131,3
birri,1555,2239,2201,1225,910,8130,3
sussy,2206,1824,1021,945,2116,8112,3
peepy,1184,2863,1421,526,2116,8110,3
cirri,1512,2239,2201,1225,910,8087,3
eleen,693,1193,1421,3252,1522,8081,3
aroar,1698,1543,1426,2214,1190,8071,3
arear,1698,1543,1421,2214,1190,8066,3
lecce,1046,2863,701,770,2679,8059,3
titty,1264,2239,1048,1385,2116,8052,3
alada,1698,1193,1959,829,2362,8041,3
keefe,789,2863,1421,278,2679,8030,3
kooky,789,3069,1426,628,2116,8028,3
keeve,789,2863,1421,259,2679,8011,3
fifie,847,2239,271,1963,2679,7999,3
feeze,847,2863,1421,186,2679,7996,3
heeze,844,2863,1421,186,2679,7993,3
kayak,789,4103,381,2214,502,7989,3
araba,1698,1543,1959,423,2362,7985,3
iiasa,473,2239,1959,945,2362,7978,3
pawaw,1184,4103,349,2214,122,7972,3
mormo,1225,3069,2201,612,857,7964,3
bajaj,1555,4103,81,2214,10,7963,3
recce,948,2863,701,770,2679,7961,3
vappa,404,4103,560,526,2362,7955,3
habab,844,4103,664,2214,129,7954,3
jesse,446,2863,1021,945,2679,7954,3
hehre,844,2863,334,1225,2679,7945,3
doddy,1128,3069,774,829,2116,7916,3
wawah,596,4103,349,2214,654,7916,3
mommy,1225,3069,885,612,2116,7907,3
arrau,1698,1543,2201,2214,247,7903,3
kabab,789,4103,664,2214,129,7899,3
duded,1128,1824,774,3252,917,7895,3
femme,847,2863,885,612,2679,7886,3
lully,1046,1824,1603,1295,2116,7884,3
binni,1555,2239,1757,1391,910,7852,3
cocot,1512,3069,701,1282,1284,7848,3
tekke,1264,2863,406,628,2679,7840,3
kemme,789,2863,885,612,2679,7828,3
bobby,1555,3069,664,423,2116,7827,3
kazak,789,4103,217,2214,502,7825,3
legge,1046,2863,616,612,2679,7816,3
napap,647,4103,560,2214,285,7809,3
tooth,1264,3069,1426,1385,654,7798,3
neeze,647,2863,1421,186,2679,7796,3
eyrer,693,458,2201,3252,1190,7794,3
keyek,789,2863,381,3252,502,7787,3
teest,1264,2863,1421,945,1284,7777,3
ayala,1698,458,1959,1295,2362,7772,3
rollo,948,3069,1603,1295,857,7772,3
pirri,1184,2239,2201,1225,910,7759,3
arawa,1698,1543,1959,192,2362,7754,3
edmee,693,245,885,3252,2679,7754,3
asana,1698,341,1959,1391,2362,7751,3
acana,1698,338,1959,1391,2362,7748,3
weeze,596,2863,1421,186,2679,7745,3
alapa,1698,1193,1959,526,2362,7738,3
amana,1698,327,1959,1391,2362,7737,3
peell,1184,2863,1421,1295,971,7734,3
amata,1698,327,1959,1385,2362,7731,3
zappa,176,4103,560,526,2362,7727,3
yakka,225,4103,406,628,2362,7724,3
frere,847,1543,1421,1225,2679,7715,3
deddy,1128,2863,774,829,2116,7710,3
vivie,404,2239,417,1963,2679,7702,3
poppa,1184,3069,560,526,2362,7701,3
artar,1698,1543,1048,2214,1190,7693,3
thete,1264,927,1421,1385,2679,7676,3
hollo,844,3069,1603,1295,857,7668,3
lello,1046,2863,1603,1295,857,7664,3
bonbo,1555,3069,1757,423,857,7661,3
adana,1698,245,1959,1391,2362,7655,3
emcee,693,327,701,3252,2679,7652,3
ursus,420,1543,1021,899,3767,7650,3
amala,1698,327,1959,1295,2362,7641,3
yetty,225,2863,1048,1385,2116,7637,3
tutty,1264,1824,1048,1385,2116,7637,3
anasa,1698,671,1959,945,2362,7635,3
annat,1698,671,1757,2214,1284,7624,3
gogga,965,3069,616,612,2362,7624,3
faffy,847,4103,271,278,2116,7615,3
ardra,1698,1543,774,1225,2362,7602,3
billi,1555,2239,1603,1295,910,7602,3
illia,473,1193,1603,1963,2362,7594,3
minim,1225,2239,1757,1963,406,7590,3
araxa,1698,1543,1959,26,2362,7588,3
teeth,1264,2863,1421,1385,654,7587,3
motto,1225,3069,1048,1385,857,7584,3
abana,1698,172,1959,1391,2362,7582,3
acara,1698,338,1959,1225,2362,7582,3
rebbe,948,2863,664,423,2679,7577,3
amara,1698,327,1959,1225,2362,7571,3
nenni,647,2863,1757,1391,910,7568,3
filii,847,2239,1603,1963,910,7562,3
tinni,1264,2239,1757,1391,910,7561,3
adala,1698,245,1959,1295,2362,7559,3
agana,1698,139,1959,1391,2362,7549,3
agata,1698,139,1959,1385,2362,7543,3
potto,1184,3069,1048,1385,857,7543,3
bobol,1555,3069,664,1282,971,7541,3
alula,1698,1193,990,1295,2362,7538,3
rotor,948,3069,1048,1282,1190,7537,3
yabby,225,4103,664,423,2116,7531,3
yappy,225,4103,560,526,2116,7530,3
zorro,176,3069,2201,1225,857,7528,3
minni,1225,2239,1757,1391,910,7522,3
mimir,1225,2239,885,1963,1190,7502,3
adara,1698,245,1959,1225,2362,7489,3
hebbe,844,2863,664,423,2679,7473,3
azana,1698,59,1959,1391,2362,7469,3
oozoa,532,3069,217,1282,2362,7462,3
jaffa,446,4103,271,278,2362,7460,3
poppy,1184,3069,560,526,2116,7455,3
akala,1698,137,1959,1295,2362,7451,3
ninon,647,2239,1757,1282,1522,7447,3
tweet,1264,226,1421,3252,1284,7447,3
potoo,1184,3069,1048,1282,857,7440,3
adnan,1698,245,1757,2214,1522,7436,3
mllly,1225,1193,1603,1295,2116,7432,3
cooch,1512,3069,1426,770,654,7431,3
audad,1698,1824,774,2214,917,7427,3
nitin,647,2239,1048,1963,1522,7419,3
immis,473,327,885,1963,3767,7415,3
lotto,1046,3069,1048,1385,857,7405,3
assay,1698,341,1021,2214,2116,7390,3
vivia,404,2239,417,1963,2362,7385,3
elene,693,1193,1421,1391,2679,7377,3
etwee,693,403,349,3252,2679,7376,3
allah,1698,1193,1603,2214,654,7362,3
afara,1698,73,1959,1225,2362,7317,3
annal,1698,671,1757,2214,971,7311,3
tilli,1264,2239,1603,1295,910,7311,3
tipit,1264,2239,560,1963,1284,7310,3
anama,1698,671,1959,612,2362,7302,3
amasa,1698,327,1959,945,2362,7291,3
siusi,2206,2239,990,945,910,7290,3
eyess,693,458,1421,945,3767,7284,3
pappi,1184,4103,560,526,910,7283,3
needn,647,2863,1421,829,1522,7282,3
bibio,1555,2239,664,1963,857,7278,3
adrad,1698,245,2201,2214,917,7275,3
emmey,693,327,885,3252,2116,7273,3
milli,1225,2239,1603,1295,910,7272,3
ginni,965,2239,1757,1391,910,7262,3
kokka,789,3069,406,628,2362,7254,3
peppy,1184,2863,560,526,2116,7249,3
pipit,1184,2239,560,1963,1284,7230,3
bsbus,1555,341,664,899,3767,7226,3
grege,965,1543,1421,612,2679,7220,3
iodid,473,3069,774,1963,917,7196,3
veuve,404,2863,990,259,2679,7195,3
slyly,2206,1193,381,1295,2116,7191,3
dilli,1128,2239,1603,1295,910,7175,3
llama,1046,1193,1959,612,2362,7172,3
nondo,647,3069,1757,829,857,7159,3
kotto,789,3069,1048,1385,857,7148,3
mosso,1225,3069,1021,945,857,7117,3
gigge,965,2239,616,612,2679,7111,3
akasa,1698,137,1959,945,2362,7101,3
glaga,965,1193,1959,612,2362,7091,3
diddy,1128,2239,774,829,2116,7086,3
kokio,789,3069,406,1963,857,7084,3
cucuy,1512,1824,701,899,2116,7052,3
addia,1698,245,774,1963,2362,7042,3
lillo,1046,2239,1603,1295,857,7040,3
mmete,1225,327,1421,1385,2679,7037,3
ottos,532,403,1048,1282,3767,7032,3
abada,1698,172,1959,829,2362,7020,3
jujus,446,1824,81,899,3767,7017,3
gilli,965,2239,1603,1295,910,7012,3
bibby,1555,2239,664,423,2116,6997,3
agada,1698,139,1959,829,2362,6987,3
bozoo,1555,3069,217,1282,857,6980,3
arhar,1698,1543,334,2214,1190,6979,3
cocom,1512,3069,701,1282,406,6970,3
apama,1698,336,1959,612,2362,6967,3
cocci,1512,3069,701,770,910,6962,3
abaca,1698,172,1959,770,2362,6961,3
amaga,1698,327,1959,612,2362,6958,3
zizia,176,2239,217,1963,2362,6957,3
miami,1225,2239,1959,612,910,6945,3
hoosh,844,3069,1426,945,654,6938,3
commo,1512,3069,885,612,857,6935,3
appay,1698,336,560,2214,2116,6924,3
appia,1698,336,560,1963,2362,6919,3
pipil,1184,2239,560,1963,971,6917,3
queue,93,1824,1421,899,2679,6916,3
error,693,1543,2201,1282,1190,6909,3
sussi,2206,1824,1021,945,910,6906,3
gogol,965,3069,616,1282,971,6903,3
noyon,647,3069,381,1282,1522,6901,3
amann,1698,327,1959,1391,1522,6897,3
winni,596,2239,1757,1391,910,6893,3
added,1698,245,774,3252,917,6886,3
emeer,693,327,1421,3252,1190,6883,3
inine,473,671,1668,1391,2679,6882,3
adama,1698,245,1959,612,2362,6876,3
amapa,1698,327,1959,526,2362,6872,3
pippa,1184,2239,560,526,2362,6871,3
ddene,1128,245,1421,1391,2679,6864,3
pipid,1184,2239,560,1963,917,6863,3
enone,693,671,1426,1391,2679,6860,3
susso,2206,1824,1021,945,857,6853,3
amram,1698,327,2201,2214,406,6846,3
essen,693,341,1021,3252,1522,6829,3
jnana,446,671,1959,1391,2362,6829,3
bubba,1555,1824,664,423,2362,6828,3
abaka,1698,172,1959,628,2362,6819,3
abama,1698,172,1959,612,2362,6803,3
hssds,844,341,1021,829,3767,6802,3
troot,1264,1543,1426,1282,1284,6799,3
adapa,1698,245,1959,526,2362,6790,3
bombo,1555,3069,885,423,857,6789,3
ettie,693,403,1048,1963,2679,6786,3
agama,1698,139,1959,612,2362,6770,3
hooch,844,3069,1426,770,654,6763,3
engen,693,671,616,3252,1522,6754,3
annam,1698,671,1757,2214,406,6746,3
jinni,446,2239,1757,1391,910,6743,3
ninib,647,2239,1757,1963,129,6735,3
bilbi,1555,2239,1603,423,910,6730,3
stott,2206,403,1426,1385,1284,6704,3
mommi,1225,3069,885,612,910,6701,3
vinni,404,2239,1757,1391,910,6701,3
essie,693,341,1021,1963,2679,6697,3
algal,1698,1193,616,2214,971,6692,3
noxon,647,3069,170,1282,1522,6690,3
adaha,1698,245,1959,423,2362,6687,3
emmen,693,327,885,3252,1522,6679,3
lulli,1046,1824,1603,1295,910,6678,3
araru,1698,1543,1959,1225,247,6672,3
duddy,1128,1824,774,829,2116,6671,3
divid,1128,2239,417,1963,917,6664,3
mummy,1225,1824,885,612,2116,6662,3
sissu,2206,2239,1021,945,247,6658,3
loulu,1046,3069,990,1295,247,6647,3
amman,1698,327,885,2214,1522,6646,3
willi,596,2239,1603,1295,910,6643,3
anand,1698,671,1959,1391,917,6636,3
alloo,1698,1193,1603,1282,857,6633,3
pippy,1184,2239,560,526,2116,6625,3
bobbi,1555,3069,664,423,910,6621,3
amaya,1698,327,1959,271,2362,6617,3
mimic,1225,2239,885,1963,300,6612,3
butut,1555,1824,1048,899,1284,6610,3
mneme,1225,671,1421,612,2679,6608,3
hoogh,844,3069,1426,612,654,6605,3
stoot,2206,403,1426,1282,1284,6601,3
eleme,693,1193,1421,612,2679,6598,3
bubby,1555,1824,664,423,2116,6582,3
akaba,1698,137,1959,423,2362,6579,3
inina,473,671,1668,1391,2362,6565,3
kikai,789,2239,406,2214,910,6558,3
attar,1698,403,1048,2214,1190,6553,3
emmie,693,327,885,1963,2679,6547,3
nunni,647,1824,1757,1391,910,6529,3
kiaki,789,2239,1959,628,910,6525,3
ilial,473,1193,1668,2214,971,6519,3
issus,473,341,1021,899,3767,6501,3
fpsps,847,336,1021,526,3767,6497,3
adead,1698,245,1421,2214,917,6495,3
ennew,693,671,1757,3252,122,6495,3
jilli,446,2239,1603,1295,910,6493,3
issie,473,341,1021,1963,2679,6477,3
entte,693,671,1048,1385,2679,6476,3
aqaba,1698,25,1959,423,2362,6467,3
villi,404,2239,1603,1295,910,6451,3
emmet,693,327,885,3252,1284,6441,3
civic,1512,2239,417,1963,300,6431,3
tutti,1264,1824,1048,1385,910,6431,3
kodok,789,3069,774,1282,502,6416,3
shish,2206,927,1668,945,654,6400,3
tutto,1264,1824,1048,1385,857,6378,3
limli,1046,2239,885,1295,910,6375,3
kitti,789,2239,1048,1385,910,6371,3
oopod,532,3069,560,1282,917,6360,3
esere,693,341,1421,1225,2679,6359,3
eddie,693,245,774,1963,2679,6354,3
emmer,693,327,885,3252,1190,6347,3
rocco,948,3069,701,770,857,6345,3
missi,1225,2239,1021,945,910,6340,3
attal,1698,403,1048,2214,971,6334,3
accra,1698,338,701,1225,2362,6324,3
wynny,596,458,1757,1391,2116,6318,3
ajava,1698,32,1959,259,2362,6310,3
evene,693,126,1421,1391,2679,6310,3
ended,693,671,774,3252,917,6307,3
doggo,1128,3069,616,612,857,6282,3
trmtr,1264,1543,885,1385,1190,6267,3
eleve,693,1193,1421,259,2679,6245,3
hocco,844,3069,701,770,857,6241,3
moppo,1225,3069,560,526,857,6237,3
eppie,693,336,560,1963,2679,6231,3
nitti,647,2239,1048,1385,910,6229,3
essed,693,341,1021,3252,917,6224,3
akiak,1698,137,1668,2214,502,6219,3
puppy,1184,1824,560,526,2116,6210,3
euell,693,1824,1421,1295,971,6204,3
volvo,404,3069,1603,259,857,6192,3
assad,1698,341,1021,2214,917,6191,3
ccitt,1512,338,1668,1385,1284,6187,3
anjan,1698,671,81,2214,1522,6186,3
assai,1698,341,1021,2214,910,6184,3
ebbie,693,172,664,1963,2679,6171,3
adall,1698,245,1959,1295,971,6168,3
lissi,1046,2239,1021,945,910,6161,3
edder,693,245,774,3252,1190,6154,3
popov,1184,3069,560,1282,41,6136,3
ettle,693,403,1048,1295,2679,6118,3
aviva,1698,126,1668,259,2362,6113,3
ebbet,693,172,664,3252,1284,6065,3
peppi,1184,2863,560,526,910,6043,3
boffo,1555,3069,271,278,857,6030,3
gigli,965,2239,616,1295,910,6025,3
attah,1698,403,1048,2214,654,6017,3
osseo,532,341,1021,3252,857,6003,3
appar,1698,336,560,2214,1190,5998,3
issei,473,341,1021,3252,910,5997,3
aziza,1698,59,1668,186,2362,5973,3
umaua,420,327,1959,899,2362,5967,3
tefft,1264,2863,271,278,1284,5960,3
ibbie,473,172,664,1963,2679,5951,3
iappp,473,4103,560,526,285,5947,3
vivid,404,2239,417,1963,917,5940,3
kioko,789,2239,1426,628,857,5939,3
timmi,1264,2239,885,612,910,5910,3
egger,693,139,616,3252,1190,5890,3
zizit,176,2239,217,1963,1284,5879,3
evvie,693,126,417,1963,2679,5878,3
iggie,473,139,616,1963,2679,5870,3
propr,1184,1543,1426,526,1190,5869,3
accad,1698,338,701,2214,917,5868,3
evese,693,126,1421,945,2679,5864,3
hoppo,844,3069,560,526,857,5856,3
annwn,1698,671,1757,192,1522,5840,3
akkra,1698,137,406,1225,2362,5828,3
twitt,1264,226,1668,1385,1284,5827,3
appal,1698,336,560,2214,971,5779,3
exlex,693,83,1603,3252,144,5775,3
egede,693,139,1421,829,2679,5761,3
orono,532,1543,1426,1391,857,5749,3
cippi,1512,2239,560,526,910,5747,3
allyl,1698,1193,1603,271,971,5736,3
lyall,1046,458,1959,1295,971,5729,3
edged,693,245,616,3252,917,5723,3
shush,2206,927,990,945,654,5722,3
unrun,420,671,2201,899,1522,5713,3
exede,693,83,1421,829,2679,5705,3
aruru,1698,1543,990,1225,247,5703,3
ebbed,693,172,664,3252,917,5698,3
nyaya,647,458,1959,271,2362,5697,3
kurku,789,1824,2201,628,247,5689,3
assam,1698,341,1021,2214,406,5680,3
orrow,532,1543,2201,1282,122,5680,3
effie,693,73,271,1963,2679,5679,3
onion,532,671,1668,1282,1522,5675,3
uninn,420,671,1668,1391,1522,5672,3
yummy,225,1824,885,612,2116,5662,3
abbai,1698,172,664,2214,910,5658,3
thoth,1264,927,1426,1385,654,5656,3
affra,1698,73,271,1225,2362,5629,3
kikoi,789,2239,406,1282,910,5626,3
yocco,225,3069,701,770,857,5622,3
egged,693,139,616,3252,917,5617,3
inion,473,671,1668,1282,1522,5616,3
icica,473,338,1668,770,2362,5611,3
yezzy,225,2863,217,186,2116,5607,3
bussu,1555,1824,1021,945,247,5592,3
effet,693,73,271,3252,1284,5573,3
zocco,176,3069,701,770,857,5573,3
ricci,948,2239,701,770,910,5568,3
feoff,847,2863,1426,278,145,5559,3
djaja,1128,32,1959,61,2362,5542,3
chich,1512,927,1668,770,654,5531,3
choco,1512,927,1426,770,857,5492,3
enent,693,671,1421,1391,1284,5460,3
essex,693,341,1021,3252,144,5451,3
kimmi,789,2239,885,612,910,5435,3
mrsrm,1225,1543,1021,1225,406,5420,3
cctac,1512,338,1048,2214,300,5412,3
indin,473,671,774,1963,1522,5403,3
akkad,1698,137,406,2214,917,5372,3
jujuy,446,1824,81,899,2116,5366,3
pippo,1184,2239,560,526,857,5366,3
addam,1698,245,774,2214,406,5337,3
fuffy,847,1824,271,278,2116,5336,3
ullur,420,1193,1603,899,1190,5305,3
libbi,1046,2239,664,423,910,5282,3
lippi,1046,2239,560,526,910,5281,3
emmew,693,327,885,3252,122,5279,3
yobbo,225,3069,664,423,857,5238,3
ebeye,693,172,1421,271,2679,5236,3
gibbi,965,2239,664,423,910,5201,3
lyell,1046,458,1421,1295,971,5191,3
oruro,532,1543,990,1225,857,5147,3
imitt,473,327,1668,1385,1284,5137,3
rikki,948,2239,406,628,910,5131,3
atacc,1698,403,1959,770,300,5130,3
hippi,844,2239,560,526,910,5079,3
addax,1698,245,774,2214,144,5075,3
apoop,1698,336,1426,1282,285,5027,3
afcac,1698,73,701,2214,300,4986,3
lludd,1046,1193,990,829,917,4975,3
oromo,532,1543,1426,612,857,4970,3
tiffi,1264,2239,271,278,910,4962,3
immit,473,327,885,1963,1284,4932,3
lccln,1046,338,701,1295,1522,4902,3
infin,473,671,271,1963,1522,4900,3
csacc,1512,341,1959,770,300,4882,3
livvi,1046,2239,417,259,910,4871,3
emmye,693,327,885,271,2679,4855,3
chuch,1512,927,990,770,654,4853,3
nikki,647,2239,406,628,910,4830,3
kukui,789,1824,406,899,910,4828,3
unurn,420,671,990,1225,1522,4828,3
urdur,420,1543,774,899,1190,4826,3
zimmi,176,2239,885,612,910,4822,3
gregg,965,1543,1421,612,261,4802,3
indii,473,671,774,1963,910,4791,3
brubu,1555,1543,990,423,247,4758,3
xviii,36,126,1668,1963,910,4703,3
awiwi,1698,226,1668,192,910,4694,3
riffi,948,2239,271,278,910,4646,3
upupa,420,336,990,526,2362,4634,3
afifi,1698,73,1668,278,910,4627,3
ewell,693,226,1421,1295,971,4606,3
vikki,404,2239,406,628,910,4587,3
urutu,420,1543,990,1385,247,4585,3
lcloc,1046,338,1603,1282,300,4569,3
abwab,1698,172,349,2214,129,4562,3
nihhi,647,2239,334,423,910,4553,3
fyffe,847,458,271,278,2679,4533,3
unsun,420,671,1021,899,1522,4533,3
rizzi,948,2239,217,186,910,4500,3
ifill,473,73,1668,1295,971,4480,3
glogg,965,1193,1426,612,261,4457,3
flaff,847,1193,1959,278,145,4422,3
phpht,1184,927,560,423,1284,4378,3
iddio,473,245,774,1963,857,4312,3
abaff,1698,172,1959,278,145,4252,3
ovolo,532,126,1426,1295,857,4236,3
kuksu,789,1824,406,945,247,4211,3
ictic,473,338,1048,1963,300,4122,3
ishii,473,341,334,1963,910,4021,3
effye,693,73,271,271,2679,3987,3
hufuf,844,1824,271,899,145,3983,3
urucu,420,1543,990,770,247,3970,3
odoom,532,245,1426,1282,406,3891,3
uhuru,420,927,990,1225,247,3809,3
immix,473,327,885,1963,144,3792,3
iliff,473,1193,1668,278,145,3757,3
rsfsr,948,341,271,945,1190,3695,3
ayuyu,1698,458,990,271,247,3664,3
pfaff,1184,73,1959,278,145,3639,3
urubu,420,1543,990,423,247,3623,3
fluff,847,1193,990,278,145,3453,3
xylyl,36,458,1603,271,971,3339,3
mttff,1225,403,1048,278,145,3099,3
ujiji,420,32,1668,61,910,3091,3
upsup,420,336,1021,899,285,2961,3
uppop,420,336,560,1282,285,2883,3
iddhi,473,245,774,423,910,2825,3
icccm,473,338,701,770,406,2688,3
aeaea,1698,2863,1959,3252,2362,12134,2
reree,948,2863,2201,3252,2679,11943,2
taata,1264,4103,1959,1385,2362,11073,2
lalla,1046,4103,1603,1295,2362,10409,2
nanna,647,4103,1757,1391,2362,10260,2
tatta,1264,4103,1048,1385,2362,10162,2
mamma,1225,4103,885,612,2362,9187,2
esses,693,341,1021,3252,3767,9074,2
beebe,1555,2863,1421,423,2679,8941,2
arara,1698,1543,1959,1225,2362,8787,2
alala,1698,1193,1959,1295,2362,8507,2
anana,1698,671,1959,1391,2362,8081,2
essee,693,341,1021,3252,2679,7986,2
lilli,1046,2239,1603,1295,910,7093,2
poopo,1184,3069,1426,526,857,7062,2
cocco,1512,3069,701,770,857,6909,2
ababa,1698,172,1959,423,2362,6614,2
poppo,1184,3069,560,526,857,6196,2
ajaja,1698,32,1959,61,2362,6112,2
addda,1698,245,774,829,2362,5908,2
kikki,789,2239,406,628,910,4972,2
xxiii,36,83,1668,1963,910,4660,2
ululu,420,1193,990,1295,247,4145,2
igigi,473,139,1668,612,910,3802,2
ccccm,1512,338,701,770,406,3727,2
